file,orig,tranbase,tranprog,trandiff,tran,tranopt,mozbase,mozprog,mozdiff,moz
1,2269,2236,2436,-200,2236,2236,2233,2239,-6,2239
2,2827,2138,2369,-231,2138,2138,2138,2205,-67,2205
3,51264,52092,51245,847,51245,51245,52111,50379,1732,50379
4,5293,5290,5238,52,5238,5238,5293,5123,170,5123
5,34578,34580,33224,1356,33224,33224,34594,32773,1821,32773
6,140938,149157,142234,6923,142234,140938,149194,140316,8878,140316
7,16391,16401,16712,-311,16401,16391,16396,16287,109,16287
8,13939,11497,11002,495,11002,11002,11504,10551,953,10551
9,3550,3165,3351,-186,3165,3165,3168,3187,-19,3187
10,19974,19406,19531,-125,19406,19406,19418,19352,66,19352
11,10280,10069,10278,-209,10069,10069,10068,10048,20,10048
12,1573,1573,1845,-272,1573,1573,1573,1603,-30,1573
13,96194,103520,96475,7045,96475,96194,103505,96236,7269,96194
14,32895,33681,32524,1157,32524,32524,33684,32273,1411,32273
15,36161,34652,34624,28,34624,34624,34658,34188,470,34188
16,59769,59127,58612,515,58612,58612,59155,57280,1875,57280
17,107662,111828,107622,4206,107622,107622,111850,107465,4385,107465
18,3722,3678,3834,-156,3678,3678,3680,3685,-5,3685
19,45783,47051,45763,1288,45763,45763,47051,45559,1492,45559
20,5013,4412,4616,-204,4412,4412,4411,4391,20,4391
21,37640,7677,7572,105,7572,7572,7682,6954,728,6954
22,26953,26824,26865,-41,26824,26824,26837,26331,506,26331
23,192919,197765,193524,4241,193524,192919,197799,192991,4808,192919
24,25589,25540,24850,690,24850,24850,25552,24696,856,24696
25,37132,39660,38201,1459,38201,37132,39675,37124,2551,37124
26,17776,16928,16402,526,16402,16402,16931,15873,1058,15873
27,39392,38377,38276,101,38276,38276,38390,37331,1059,37331
28,12756,12333,11997,336,11997,11997,12332,11834,498,11834
29,4597,3754,3853,-99,3754,3754,3757,3640,117,3640
30,479459,441297,420865,20432,420865,420865,441238,417530,23708,417530
31,8206,7565,7364,201,7364,7364,7564,7272,292,7272
32,97802,97760,93115,4645,93115,93115,97802,92604,5198,92604
33,337300,336473,323361,13112,323361,323361,336390,319707,16683,319707
34,55830,52212,49369,2843,49369,49369,52272,47093,5179,47093
35,18958,19355,18951,404,18951,18951,19357,18743,614,18743
36,15863,15700,15534,166,15534,15534,15698,14646,1052,14646
37,3182,2814,2990,-176,2814,2814,2813,2801,12,2801
38,102792,97842,98074,-232,97842,97842,97863,96452,1411,96452
39,2917,2801,2917,-116,2801,2801,2800,2804,-4,2804
40,6143,5723,5890,-167,5723,5723,5729,5668,61,5668
41,925037,969315,924821,44494,924821,924821,969534,916858,52676,916858
42,690,690,791,-101,690,690,690,701,-11,690
43,2676,2547,2616,-69,2547,2547,2549,2435,114,2435
44,15899,15217,14806,411,14806,14806,15210,14632,578,14632
45,315005,329205,314957,14248,314957,314957,329310,312436,16874,312436
46,24226,24614,23840,774,23840,23840,24609,23604,1005,23604
47,913,914,1139,-225,914,913,913,973,-60,913
48,30488,32866,30444,2422,30444,30444,32865,28488,4377,28488
49,73493,76644,73456,3188,73456,73456,76671,72742,3929,72742
50,34620,32967,31372,1595,31372,31372,32966,31112,1854,31112
51,34373,33446,33477,-31,33446,33446,33470,32203,1267,32203
52,153979,151337,144044,7293,144044,144044,151457,143995,7462,143995
53,141861,108713,105515,3198,105515,105515,108723,105201,3522,105201
54,5096,4966,5037,-71,4966,4966,4967,4899,68,4899
55,45031,42159,39798,2361,39798,39798,42185,39635,2550,39635
56,285521,285141,277285,7856,277285,277285,285168,270689,14479,270689
57,8700,7969,8069,-100,7969,7969,7972,7725,247,7725
58,141534,140657,135609,5048,135609,135609,140635,135397,5238,135397
59,20930,20925,20010,915,20010,20010,20930,19394,1536,19394
60,3573,3569,3697,-128,3569,3569,3573,3561,12,3561
61,185498,190907,185467,5440,185467,185467,190915,183969,6946,183969
62,12224,10741,10077,664,10077,10077,10743,9443,1300,9443
63,7354,6925,6905,20,6905,6905,6925,6757,168,6757
64,9252,9597,9398,199,9398,9252,9597,9252,345,9252
65,13319,13314,12928,386,12928,12928,13319,12551,768,12551
66,152792,157665,152793,4872,152793,152792,157732,151856,5876,151856
67,18331,19640,20430,-790,19640,18331,19637,18331,1306,18331
68,106848,106816,105148,1668,105148,105148,106848,104224,2624,104224
69,13651,13723,13641,82,13641,13641,13738,13304,434,13304
70,17226,15867,16050,-183,15867,15867,15868,15064,804,15064
71,37330,37283,36399,884,36399,36399,37282,36052,1230,36052
72,3535,3148,3272,-124,3148,3148,3152,3138,14,3138
73,42366,43610,42763,847,42763,42366,43618,42364,1254,42364
74,117916,62956,60828,2128,60828,60828,62979,58480,4499,58480
75,7038,7160,7036,124,7036,7036,7160,6794,366,6794
76,12923,13120,12866,254,12866,12866,13115,12500,615,12500
77,10327,9569,9457,112,9457,9457,9575,9371,204,9371
78,20320,16639,16836,-197,16639,16639,16663,16684,-21,16684
79,8456,7626,7496,130,7496,7496,7625,7378,247,7378
80,5021,5024,4800,224,4800,4800,5021,4375,646,4375
81,8069,8071,8033,38,8033,8033,8069,7872,197,7872
82,12720,12313,12102,211,12102,12102,12312,11948,364,11948
83,26821,26842,25963,879,25963,25963,26840,25898,942,25898
84,109070,106004,104000,2004,104000,104000,105948,102890,3058,102890
85,30875,44111,46121,-2010,44111,30875,44111,30867,13244,30867
86,300168,301145,300087,1058,300087,300087,301107,294522,6585,294522
87,12833,1170,1469,-299,1170,1170,1170,1239,-69,1239
88,61052,59788,56843,2945,56843,56843,59832,56734,3098,56734
89,878,637,878,-241,637,637,638,680,-42,680
90,32044,31543,30629,914,30629,30629,31550,30419,1131,30419
91,37389,25213,24723,490,24723,24723,25198,24163,1035,24163
92,188094,195484,195247,237,195247,188094,195450,188086,7364,188086
93,6556,6538,6544,-6,6538,6538,6535,6411,124,6411
94,78893,78031,77034,997,77034,77034,78044,76019,2025,76019
95,92876,92820,90061,2759,90061,90061,92839,89554,3285,89554
96,19630,19058,18702,356,18702,18702,19054,18603,451,18603
97,2419,2043,2289,-246,2043,2043,2044,2100,-56,2100
98,94817,94812,91178,3634,91178,91178,94807,90957,3850,90957
99,2301,2082,2304,-222,2082,2082,2082,2133,-51,2133
100,29102,14998,14560,438,14560,14560,14993,14255,738,14255
101,1942934,1923993,1820557,103436,1820557,1820557,1924588,1808686,115902,1808686
102,8107,7430,7387,43,7387,7387,7434,7259,175,7259
103,16462,16481,16398,83,16398,16398,16484,16038,446,16038
104,3550,3553,3549,4,3549,3549,3553,3398,155,3398
105,132375,131459,125535,5924,125535,125535,131393,124225,7168,124225
106,65565,59951,54852,5099,54852,54852,59922,54422,5500,54422
107,290474,254961,258311,-3350,254961,254961,255036,246947,8089,246947
108,41054,39003,37670,1333,37670,37670,38996,37591,1405,37591
109,23875,23690,23619,71,23619,23619,23701,23253,448,23253
110,8215,8214,8430,-216,8214,8214,8215,7990,225,7990
111,14048,5303,5479,-176,5303,5303,5303,4974,329,4974
112,41598,41040,40386,654,40386,40386,41040,39990,1050,39990
113,3308,2841,3029,-188,2841,2841,2841,2859,-18,2859
114,33238,33237,32127,1110,32127,32127,33238,31995,1243,31995
115,8986,7519,7434,85,7434,7434,7525,7367,158,7367
116,17854,17255,16882,373,16882,16882,17274,16748,526,16748
117,184518,196348,184502,11846,184502,184502,196364,182431,13933,182431
118,86260,66806,65728,1078,65728,65728,66814,65395,1419,65395
119,13948,13904,13944,-40,13904,13904,13905,13682,223,13682
120,1955,1365,1626,-261,1365,1365,1366,1406,-40,1406
121,128285,127439,121978,5461,121978,121978,127481,121267,6214,121267
122,26363,5025,5121,-96,5025,5025,5024,4958,66,4958
123,133579,109698,106487,3211,106487,106487,109670,105997,3673,105997
124,787242,716891,695899,20992,695899,695899,717004,682050,34954,682050
125,96735,83975,85451,-1476,83975,83975,83978,73087,10891,73087
126,23766,20595,20594,1,20594,20594,20604,19909,695,19909
127,26988,26464,25431,1033,25431,25431,26465,25308,1157,25308
128,24851,25692,24789,903,24789,24789,25707,24711,996,24711
129,191427,191538,187920,3618,187920,187920,191427,185296,6131,185296
130,26366,26367,25484,883,25484,25484,26366,25380,986,25380
131,56359,55800,53148,2652,53148,53148,55805,52670,3135,52670
132,18869,16836,15603,1233,15603,15603,16835,15506,1329,15506
133,28197,32400,31479,921,31479,28197,32385,28189,4196,28189
134,34422,28309,27194,1115,27194,27194,28320,26896,1424,26896
135,13962,14298,14033,265,14033,13962,14297,13941,356,13941
136,708213,739174,709332,29842,709332,708213,739119,708548,30571,708213
137,15455,13545,13423,122,13423,13423,13548,12472,1076,12472
138,238843,221147,212815,8332,212815,212815,221145,210463,10682,210463
139,341,322,556,-234,322,322,322,368,-46,341
140,7802,7852,7746,106,7746,7746,7855,7509,346,7509
141,1270,1172,1415,-243,1172,1172,1171,1227,-56,1227
142,173717,171190,169138,2052,169138,169138,171241,167440,3801,167440
143,49085,49043,46840,2203,46840,46840,49029,46767,2262,46767
144,9621,8751,8831,-80,8751,8751,8749,8581,168,8581
145,231624,249706,236896,12810,236896,231624,249629,232428,17201,231624
146,1499,1515,1825,-310,1515,1499,1515,1533,-18,1499
147,21755,18201,18150,51,18150,18150,18197,17785,412,17785
148,49669,41962,40574,1388,40574,40574,41969,40369,1600,40369
149,13505,12827,12958,-131,12827,12827,12841,12633,208,12633
150,678,695,962,-267,695,678,696,738,-42,678
151,37663,35205,33705,1500,33705,33705,35206,33125,2081,33125
152,30850,30814,29910,904,29910,29910,30813,28788,2025,28788
153,420030,423878,419910,3968,419910,419910,423761,411865,11896,411865
154,6783,6760,7027,-267,6760,6760,6761,6794,-33,6783
155,24192,24203,23791,412,23791,23791,24192,23605,587,23605
156,24611,24622,23782,840,23782,23782,24611,23646,965,23646
157,47620,47536,47609,-73,47536,47536,47536,46562,974,46562
158,10532,9612,9649,-37,9612,9612,9610,9443,167,9443
159,4712,4664,4595,69,4595,4595,4665,4453,212,4453
160,288495,287446,274879,12567,274879,274879,287574,271173,16401,271173
161,2018,2020,2261,-241,2020,2018,2018,2061,-43,2018
162,43125,39473,37571,1902,37571,37571,39425,37413,2012,37413
163,63446,59378,57622,1756,57622,57622,59361,57331,2030,57331
164,39067,29415,28776,639,28776,28776,29426,28698,728,28698
165,62708,37840,37348,492,37348,37348,37851,36154,1697,36154
166,30049,28150,26276,1874,26276,26276,28144,25962,2182,25962
167,14037,10166,9969,197,9969,9969,10165,9864,301,9864
168,28682,16890,16269,621,16269,16269,16886,16023,863,16023
169,170261,169443,168648,795,168648,168648,169434,166724,2710,166724
170,11807,11812,11644,168,11644,11644,11807,11594,213,11594
171,41393,40704,38758,1946,38758,38758,40697,38429,2268,38429
172,75341,78662,75261,3401,75261,75261,78647,74721,3926,74721
173,22491,21935,21042,893,21042,21042,21937,20818,1119,20818
174,9595,9594,9478,116,9478,9478,9595,9164,431,9164
175,11508,11453,11694,-241,11453,11453,11462,11508,-46,11508
176,11129,10184,9921,263,9921,9921,10187,9850,337,9850
177,22821,19336,18750,586,18750,18750,19331,18667,664,18667
178,1051,823,1052,-229,823,823,823,874,-51,874
179,975,596,836,-240,596,596,595,640,-45,640
180,5097,4708,4828,-120,4708,4708,4706,4681,25,4681
181,28590,26669,27018,-349,26669,26669,26679,26217,462,26217
182,1292,831,1089,-258,831,831,831,853,-22,853
183,61836,46702,45185,1517,45185,45185,46711,43435,3276,43435
184,104777,110596,104772,5824,104772,104772,110592,98954,11638,98954
185,13594,13588,13216,372,13216,13216,13594,12934,660,12934
186,20019,19809,19388,421,19388,19388,19814,19397,417,19397
187,169198,169204,160811,8393,160811,160811,169198,159540,9658,159540
188,1373429,1253811,1188242,65569,1188242,1188242,1254284,1162582,91702,1162582
189,623,503,752,-249,503,503,505,544,-39,544
190,35368,34424,33518,906,33518,33518,34413,33278,1135,33278
191,595308,19482,18206,1276,18206,18206,19488,17472,2016,17472
192,225783,219080,204646,14434,204646,204646,219125,202272,16853,202272
193,451295,463104,451173,11931,451173,451173,463214,447872,15342,447872
194,365191,323233,306894,16339,306894,306894,323271,301882,21389,301882
195,3003,356,590,-234,356,356,356,367,-11,367
196,11707,11451,11520,-69,11451,11451,11447,11181,266,11181
197,266483,271781,268977,2804,268977,266483,271798,265861,5937,265861
198,11697,11709,11632,77,11632,11632,11715,11445,270,11445
199,21552,21538,20624,914,20624,20624,21538,20218,1320,20218
200,33481,33445,32427,1018,32427,32427,33455,32329,1126,32329
201,27926,26696,26254,442,26254,26254,26694,25983,711,25983
202,209174,199599,192841,6758,192841,192841,199560,192788,6772,192788
203,53802,54806,54760,46,54760,53802,54818,54113,705,53802
204,23361,24273,23351,922,23351,23351,24279,23303,976,23303
205,37743,36476,36629,-153,36476,36476,36497,36068,429,36068
206,9058,8994,8868,126,8868,8868,8996,8713,283,8713
207,192600,185258,181112,4146,181112,181112,185203,176775,8428,176775
208,26239,26232,26096,136,26096,26096,26239,25750,489,25750
209,20527,15384,15874,-490,15384,15384,15391,15420,-29,15420
210,3751,3940,4174,-234,3940,3751,3939,3682,257,3682
211,13294,12451,12415,36,12415,12415,12450,12226,224,12226
212,30189,23359,23020,339,23020,23020,23356,22372,984,22372
213,7490,7487,7493,-6,7487,7487,7490,7331,159,7331
214,403047,401930,382929,19001,382929,382929,402062,382441,19621,382441
215,70411,58334,56259,2075,56259,56259,58351,56108,2243,56108
216,127272,126236,124200,2036,124200,124200,126290,121054,5236,121054
217,182074,179500,176491,3009,176491,176491,179585,175207,4378,175207
218,56494,58018,56510,1508,56510,56494,58027,56417,1610,56417
219,2370,2186,2371,-185,2186,2186,2187,2218,-31,2218
220,15219,15949,15207,742,15207,15207,15955,14491,1464,14491
221,93444,92573,89570,3003,89570,89570,92581,89442,3139,89442
222,8749,7914,7603,311,7603,7603,7917,7324,593,7324
223,29723,28790,28540,250,28540,28540,28802,28229,573,28229
224,102149,81360,77707,3653,77707,77707,81363,76214,5149,76214
225,84038,85158,85901,-743,85158,84038,85169,84771,398,84038
226,22252,2758,3121,-363,2758,2758,2759,2699,60,2699
227,531384,542284,514407,27877,514407,514407,542226,512089,30137,512089
228,5016,5595,5674,-79,5595,5016,5607,5079,528,5016
229,10377,9728,9492,236,9492,9492,9724,9302,422,9302
230,663,663,890,-227,663,663,663,710,-47,663
231,28697,27583,27773,-190,27583,27583,27611,24981,2630,24981
232,49867,48682,47280,1402,47280,47280,48698,47030,1668,47030
233,66963,66216,63710,2506,63710,63710,66231,63511,2720,63511
234,16388,15552,15937,-385,15552,15552,15544,15561,-17,15561
235,6116,5213,5348,-135,5213,5213,5213,5226,-13,5226
236,2028,2028,2287,-259,2028,2028,2028,2038,-10,2028
237,8307,8307,8146,161,8146,8146,8309,8047,262,8047
238,1855,923,1166,-243,923,923,923,979,-56,979
239,7977,6941,6882,59,6882,6882,6940,6470,470,6470
240,9658,9666,9611,55,9611,9611,9663,9384,279,9384
241,20198,19059,18367,692,18367,18367,19060,18192,868,18192
242,17109,13873,13904,-31,13873,13873,13876,13341,535,13341
243,144695,151071,146419,4652,146419,144695,151074,144996,6078,144695
244,30781,30770,30054,716,30054,30054,30781,29732,1049,29732
245,8910,8002,7857,145,7857,7857,8003,7696,307,7696
246,346293,323267,313353,9914,313353,313353,323217,309870,13347,309870
247,30108,29255,29055,200,29055,29055,29266,28767,499,28767
248,226852,233266,228040,5226,228040,226852,233300,226844,6456,226844
249,45961,45091,43431,1660,43431,43431,45096,43159,1937,43159
250,6663,6663,6842,-179,6663,6663,6663,6668,-5,6663
251,374827,347275,330994,16281,330994,330994,347353,329500,17853,329500
252,2124,1439,1698,-259,1439,1439,1439,1502,-63,1502
253,13469,13464,13311,153,13311,13311,13469,13096,373,13096
254,441215,440137,422269,17868,422269,422269,440346,420222,20124,420222
255,104826,100678,95713,4965,95713,95713,100668,95735,4933,95735
256,12588,12589,12244,345,12244,12244,12588,12154,434,12154
257,35677,10121,10035,86,10035,10035,10121,9807,314,9807
258,9335,9315,9362,-47,9315,9315,9314,9297,17,9297
259,34841,19412,18790,622,18790,18790,19427,17843,1584,17843
260,10065,6167,6137,30,6137,6137,6168,6043,125,6043
261,39144,39923,39060,863,39060,39060,39932,38385,1547,38385
262,11455,11337,11393,-56,11337,11337,11341,11156,185,11156
263,4368,4365,4485,-120,4365,4365,4367,4331,36,4331
264,57410,53241,53610,-369,53241,53241,53260,52402,858,52402
265,26613,26113,25675,438,25675,25675,26114,25428,686,25428
266,135157,126462,120457,6005,120457,120457,126484,119236,7248,119236
267,219211,185261,182547,2714,182547,182547,185277,180826,4451,180826
268,15769,15225,14843,382,14843,14843,15227,14726,501,14726
269,17957,18668,17894,774,17894,17894,18667,17697,970,17697
270,16917,16913,16862,51,16862,16862,16917,16540,377,16540
271,328562,328395,321776,6619,321776,321776,328597,317194,11403,317194
272,227345,226460,224956,1504,224956,224956,226516,222772,3744,222772
273,2787,2785,2946,-161,2785,2785,2787,2782,5,2782
274,14950,14769,14101,668,14101,14101,14778,14017,761,14017
275,22904,13418,13753,-335,13418,13418,13429,12881,548,12881
276,6329,5392,5419,-27,5392,5392,5390,5134,256,5134
277,19299,19298,19183,115,19183,19183,19299,19011,288,19011
278,10038,10253,10334,-81,10253,10038,10257,10012,245,10012
279,95426,100453,95336,5117,95336,95336,100459,94967,5492,94967
280,34396,27465,28832,-1367,27465,27465,27467,24634,2833,24634
281,261284,260240,251898,8342,251898,251898,260288,245422,14866,245422
282,195988,173531,167390,6141,167390,167390,173534,165124,8410,165124
283,273358,282525,273349,9176,273349,273349,282601,272084,10517,272084
284,24753,24718,24139,579,24139,24139,24721,23818,903,23818
285,4033,3561,3855,-294,3561,3561,3563,3576,-13,3576
286,426492,450493,426416,24077,426416,426416,450512,420818,29694,420818
287,2095,1698,1924,-226,1698,1698,1696,1740,-44,1740
288,163099,162111,155134,6977,155134,155134,162078,153766,8312,153766
289,855769,852272,817709,34563,817709,817709,852607,810713,41894,810713
290,8070,6648,6573,75,6573,6573,6647,5918,729,5918
291,39088,32094,31060,1034,31060,31060,32102,30488,1614,30488
292,46015,45352,43957,1395,43957,43957,45366,43642,1724,43642
293,95820,93524,87670,5854,87670,87670,93529,87602,5927,87602
294,16830,16318,15972,346,15972,15972,16311,15808,503,15808
295,6331,5950,5976,-26,5950,5950,5951,5843,108,5843
296,9322,8521,8338,183,8338,8338,8527,8204,323,8204
297,29124,28592,27351,1241,27351,27351,28570,27307,1263,27307
298,45121,25318,24166,1152,24166,24166,25319,23585,1734,23585
299,61689,61681,59396,2285,59396,59396,61689,59220,2469,59220
300,65647,68211,65581,2630,65581,65581,68216,64571,3645,64571
301,17183,17760,18317,-557,17760,17183,17771,17575,196,17183
302,31004,5163,5158,5,5158,5158,5161,4904,257,4904
303,54059,54058,53383,675,53383,53383,54059,52876,1183,52876
304,20552,19693,19946,-253,19693,19693,19691,19508,183,19508
305,3805,3758,3836,-78,3758,3758,3759,3673,86,3673
306,106114,106124,101302,4822,101302,101302,106114,98825,7289,98825
307,88683,88633,87270,1363,87270,87270,88672,86225,2447,86225
308,33979,34102,33999,103,33999,33979,34138,33483,655,33483
309,281831,278552,263960,14592,263960,263960,278623,255575,23048,255575
310,817358,817052,774380,42672,774380,774380,817738,764661,53077,764661
311,141266,127029,122037,4992,122037,122037,127080,120750,6330,120750
312,2195,2025,2195,-170,2025,2025,2025,1986,39,1986
313,24829,24824,24075,749,24075,24075,24829,23973,856,23973
314,12816,8021,8162,-141,8021,8021,8019,7516,503,7516
315,16669,14151,14326,-175,14151,14151,14143,13058,1085,13058
316,50733,50179,48347,1832,48347,48347,50167,48053,2114,48053
317,582425,568290,542196,26094,542196,542196,568239,539277,28962,539277
318,3147,2756,2879,-123,2756,2756,2755,2761,-6,2761
319,64302,63588,60260,3328,60260,60260,63621,60127,3494,60127
320,2111,1127,1372,-245,1127,1127,1128,1185,-57,1185
321,32382,8265,8235,30,8235,8235,8263,8102,161,8102
322,22341,21436,21475,-39,21436,21436,21438,21206,232,21206
323,4931,6552,7333,-781,6552,4931,6552,4910,1642,4910
324,152086,134782,132549,2233,132549,132549,134816,130796,4020,130796
325,672,688,928,-240,688,672,688,739,-51,672
326,37009,35498,34077,1421,34077,34077,35501,33961,1540,33961
327,1243014,1238940,1172045,66895,1172045,1172045,1238560,1165029,73531,1165029
328,8484,7927,8023,-96,7927,7927,7930,7720,210,7720
329,5040,5039,5176,-137,5039,5039,5040,4955,85,4955
330,16547,5477,5524,-47,5477,5477,5476,5446,30,5446
331,2157,1732,1972,-240,1732,1732,1733,1792,-59,1792
332,5012,4133,4200,-67,4133,4133,4132,3797,335,3797
333,56030,56007,53763,2244,53763,53763,56030,53535,2495,53535
334,10296,10219,10283,-64,10219,10219,10219,9860,359,9860
335,33360,27541,25641,1900,25641,25641,27528,24721,2807,24721
336,692479,686120,674634,11486,674634,674634,686064,669918,16146,669918
337,1287,379,612,-233,379,379,379,425,-46,425
338,2231,1961,2231,-270,1961,1961,1962,1956,6,1956
339,31940,31865,31931,-66,31865,31865,31872,31850,22,31850
340,9321,9268,9388,-120,9268,9268,9267,9209,58,9209
341,511397,441398,439490,1908,439490,439490,441364,437615,3749,437615
342,357800,369449,359425,10024,359425,357800,369476,358501,10975,357800
343,12101,5136,5201,-65,5136,5136,5138,5026,112,5026
344,15121,15131,14941,190,14941,14941,15121,14754,367,14754
345,2843,2843,3093,-250,2843,2843,2843,2901,-58,2843
346,22940,22192,21820,372,21820,21820,22205,21698,507,21698
347,91089,92358,91692,666,91692,91089,92348,90467,1881,90467
348,13576,11717,11151,566,11151,11151,11719,10835,884,10835
349,822,717,822,-105,717,717,716,726,-10,726
350,40950,36624,36345,279,36345,36345,36630,35840,790,35840
351,93437,85429,84405,1024,84405,84405,85397,82733,2664,82733
352,8048,8525,8377,148,8377,8048,8526,8040,486,8040
353,92779,61330,60436,894,60436,60436,61359,59409,1950,59409
354,15292,14959,14673,286,14673,14673,14962,14498,464,14498
355,7922,7035,6917,118,6917,6917,7032,6536,496,6536
356,471989,482175,467378,14797,467378,467378,482179,466277,15902,466277
357,454912,477220,456582,20638,456582,454912,477320,454290,23030,454290
358,13097,13432,13097,335,13097,13097,13432,12899,533,12899
359,96326,94537,97497,-2960,94537,94537,94521,93785,736,93785
360,54424,51806,49638,2168,49638,49638,51804,48922,2882,48922
361,55214,56084,55954,130,55954,55214,56076,55404,672,55214
362,6673,6118,6140,-22,6118,6118,6119,5885,234,5885
363,56358,57159,55767,1392,55767,55767,57139,55308,1831,55308
364,27779,29443,27775,1668,27775,27775,29443,27162,2281,27162
365,99901,95118,91994,3124,91994,91994,95071,91631,3440,91631
366,41388,38216,35862,2354,35862,35862,38245,35723,2522,35723
367,63945,64915,64865,50,64865,63945,64921,63323,1598,63323
368,1308,1326,1560,-234,1326,1308,1326,1378,-52,1308
369,4940,4769,4881,-112,4769,4769,4769,4660,109,4660
370,124795,123950,118026,5924,118026,118026,123920,117492,6428,117492
371,211508,203760,206231,-2471,203760,203760,203777,200594,3183,200594
372,13056,13050,12948,102,12948,12948,13056,12732,324,12732
373,58830,52233,50731,1502,50731,50731,52238,50268,1970,50268
374,4892,4894,5106,-212,4894,4892,4892,4900,-8,4892
375,17221,17622,17268,354,17268,17221,17623,17170,453,17170
376,312349,360741,367532,-6791,360741,312349,360758,312341,48417,312341
377,4113,3516,3793,-277,3516,3516,3518,3541,-23,3541
378,7402,7014,6978,36,6978,6978,7013,6838,175,6838
379,5499,5398,5568,-170,5398,5398,5398,5448,-50,5448
380,78420,77547,75869,1678,75869,75869,77549,75002,2547,75002
381,289495,271525,259819,11706,259819,259819,271559,259275,12284,259275
382,23206,10743,10778,-35,10743,10743,10747,10620,127,10620
383,21862,21589,21639,-50,21589,21589,21592,15183,6409,15183
384,126536,119541,124162,-4621,119541,119541,119566,116390,3176,116390
385,1133,749,987,-238,749,749,750,795,-45,795
386,82548,78820,74808,4012,74808,74808,78822,73560,5262,73560
387,163007,175350,163026,12324,163026,163007,175386,161580,13806,161580
388,5809,4956,5060,-104,4956,4956,4959,4882,77,4882
389,35401,35418,33717,1701,33717,33717,35401,33630,1771,33630
390,2357,2197,2358,-161,2197,2197,2196,2207,-11,2207
391,125823,121314,125787,-4473,121314,121314,121305,114216,7089,114216
392,11796,11793,12182,-389,11793,11793,11796,11797,-1,11796
393,28165,2888,3080,-192,2888,2888,2885,2896,-11,2896
394,7642,7639,7658,-19,7639,7639,7642,7418,224,7418
395,4775,4776,4866,-90,4776,4775,4775,4726,49,4726
396,22390,21541,20881,660,20881,20881,21538,20187,1351,20187
397,192914,125970,137029,-11059,125970,125970,125981,122592,3389,122592
398,22805,21597,21071,526,21071,21071,21591,20816,775,20816
399,370272,352313,333544,18769,333544,333544,352324,332688,19636,332688
400,617312,596493,571365,25128,571365,571365,596855,566745,30110,566745
401,521,521,769,-248,521,521,521,568,-47,521
402,7900,6170,6105,65,6105,6105,6173,5877,296,5877
403,42866,42194,41367,827,41367,41367,42182,41102,1080,41102
404,9840,9783,9900,-117,9783,9783,9778,9686,92,9686
405,139343,135357,127060,8297,127060,127060,135318,126490,8828,126490
406,61695,61641,58040,3601,58040,58040,61659,56935,4724,56935
407,17405,16969,16541,428,16541,16541,16961,16403,558,16403
408,72318,22107,21581,526,21581,21581,22108,21251,857,21251
409,57383,59587,58314,1273,58314,57383,59601,57800,1801,57383
410,720318,712968,670004,42964,670004,670004,712808,667065,45743,667065
411,33068,29874,28467,1407,28467,28467,29906,27629,2277,27629
412,14165,14408,14163,245,14163,14163,14420,13786,634,13786
413,8596,8328,8591,-263,8328,8328,8332,8343,-11,8343
414,25720,25676,24950,726,24950,24950,25674,24745,929,24745
415,90552,90363,86581,3782,86581,86581,90400,86458,3942,86458
416,121985,121953,114683,7270,114683,114683,121985,114519,7466,114519
417,33008,33776,33142,634,33142,33008,33779,32992,787,32992
418,31697,29204,28167,1037,28167,28167,29204,26824,2380,26824
419,135321,94771,90775,3996,90775,90775,94795,90590,4205,90590
420,171684,137106,136275,831,136275,136275,137116,133492,3624,133492
421,26206,26528,25651,877,25651,25651,26546,25570,976,25570
422,42707,45720,42368,3352,42368,42368,45720,36017,9703,36017
423,8125,8127,7938,189,7938,7938,8125,7844,281,7844
424,244654,258611,244941,13670,244941,244654,258671,244646,14025,244646
425,450,450,705,-255,450,450,450,505,-55,450
426,128662,123003,119686,3317,119686,119686,123096,118383,4713,118383
427,24200,23664,23111,553,23111,23111,23673,23005,668,23005
428,4003,3616,3693,-77,3616,3616,3616,3561,55,3561
429,40472,38993,37626,1367,37626,37626,39006,36962,2044,36962
430,145307,150752,148056,2696,148056,145307,150746,145307,5439,145307
431,20417,21437,20412,1025,20412,20412,21436,20163,1273,20163
432,3199,3199,3407,-208,3199,3199,3199,3254,-55,3199
433,4781390,4234906,4010995,223911,4010995,4010995,4235508,3969821,265687,3969821
434,17466,16608,16827,-219,16608,16608,16617,15701,916,15701
435,48862,48782,47341,1441,47341,47341,48785,46919,1866,46919
436,23497,22188,21022,1166,21022,21022,22203,20920,1283,20920
437,15535,16064,15532,532,15532,15532,16064,15471,593,15471
438,3354,3335,3490,-155,3335,3335,3335,3303,32,3303
439,48151,49650,48624,1026,48624,48151,49633,48237,1396,48151
440,5762297,190809,181842,8967,181842,181842,190892,180320,10572,180320
441,5267,4724,4756,-32,4724,4724,4724,4498,226,4498
442,9420,9312,9292,20,9292,9292,9319,8798,521,8798
443,16013,4856,4929,-73,4856,4856,4856,4780,76,4780
444,8642,8073,8127,-54,8073,8073,8078,7815,263,7815
445,32747,31901,30716,1185,30716,30716,31903,30317,1586,30317
446,441619,441792,420604,21188,420604,420604,441619,419087,22532,419087
447,64286,42366,42854,-488,42366,42366,42362,42090,272,42090
448,2438,2440,2620,-180,2440,2438,2438,2389,49,2389
449,66480,65481,64935,546,64935,64935,65476,63757,1719,63757
450,28840,28177,27710,467,27710,27710,28194,27411,783,27411
451,96666,95432,91262,4170,91262,91262,95457,90852,4605,90852
452,37286,36794,34737,2057,34737,34737,36807,34343,2464,34343
453,17937,17834,17367,467,17367,17367,17850,17315,535,17315
454,62363,61526,58802,2724,58802,58802,61510,58592,2918,58592
455,67327,70295,67320,2975,67320,67320,70270,66721,3549,66721
456,27498,26612,25966,646,25966,25966,26607,25783,824,25783
457,19779,19778,19811,-33,19778,19778,19779,19285,494,19285
458,168068,175233,170798,4435,170798,168068,175236,169201,6035,168068
459,1917625,1197973,1201805,-3832,1197973,1197973,1197936,1134490,63446,1134490
460,21227,18266,17833,433,17833,17833,18258,17763,495,17763
461,73998,2321,2496,-175,2321,2321,2318,2346,-28,2346
462,180,180,300,-120,180,180,180,181,-1,180
463,4520,4393,4460,-67,4393,4393,4393,4279,114,4279
464,1060,680,924,-244,680,680,680,728,-48,728
465,7200,6710,6632,78,6632,6632,6705,6551,154,6551
466,9411,8765,8540,225,8540,8540,8769,8451,318,8451
467,159914,158960,153254,5706,153254,153254,158967,152237,6730,152237
468,169753,167957,163440,4517,163440,163440,167936,162095,5841,162095
469,17383,16532,16598,-66,16532,16532,16533,16338,195,16338
470,8582,8582,8493,89,8493,8493,8582,8337,245,8337
471,206303,206340,198039,8301,198039,198039,206361,197771,8590,197771
472,225761,233670,227733,5937,227733,225761,233604,225712,7892,225712
473,44564,42813,40598,2215,40598,40598,42829,40405,2424,40405
474,259586,258970,254064,4906,254064,254064,259044,252602,6442,252602
475,1699,1605,1831,-226,1605,1605,1604,1653,-49,1653
476,13390,12799,12542,257,12542,12542,12812,12486,326,12486
477,9711,8858,8910,-52,8858,8858,8857,8509,348,8509
478,59231,48401,46000,2401,46000,46000,48391,45626,2765,45626
479,10653,9809,9716,93,9716,9716,9810,9520,290,9520
480,260979,206236,201824,4412,201824,201824,206151,199948,6203,199948
481,24233,23773,23312,461,23312,23312,23777,23047,730,23047
482,278571,277693,264107,13586,264107,264107,277698,261922,15776,261922
483,17260,16719,16469,250,16469,16469,16713,16328,385,16328
484,64675,64648,59540,5108,59540,59540,64675,56994,7681,56994
485,4418,4418,4651,-233,4418,4418,4415,4394,21,4394
486,577905,576234,551253,24981,551253,551253,576234,546796,29438,546796
487,48591,50073,48567,1506,48567,48567,50076,47452,2624,47452
488,64930,64051,62569,1482,62569,62569,64062,62118,1944,62118
489,1100,704,946,-242,704,704,704,754,-50,754
490,7426,6976,6892,84,6892,6892,6980,6786,194,6786
491,2578,2488,2576,-88,2488,2488,2488,2437,51,2437
492,39304,40505,39232,1273,39232,39232,40504,38998,1506,38998
493,365765,336127,333042,3085,333042,333042,336106,329933,6173,329933
494,29001,11542,11500,42,11500,11500,11540,11421,119,11421
495,144735,125877,120540,5337,120540,120540,125910,118333,7577,118333
496,153271,153291,141884,11407,141884,141884,153271,140405,12866,140405
497,39134,39081,38444,637,38444,38444,39087,37946,1141,37946
498,12208,12094,12428,-334,12094,12094,12094,12130,-36,12130
499,7651,7646,7693,-47,7646,7646,7651,7357,294,7357
500,7848,7981,7784,197,7784,7784,7982,7582,400,7582
501,98581,93766,88466,5300,88466,88466,93779,86912,6867,86912
502,22925,22329,21593,736,21593,21593,22334,21421,913,21421
503,103527,103482,99178,4304,99178,99178,103503,98067,5436,98067
504,17617,17031,16455,576,16455,16455,17025,16087,938,16087
505,2777,2375,2545,-170,2375,2375,2375,2392,-17,2392
506,528885,529139,500714,28425,500714,500714,528885,497023,31862,497023
507,4556,3892,4078,-186,3892,3892,3892,3934,-42,3934
508,358937,332107,303379,28728,303379,303379,332239,292201,40038,292201
509,28069,27235,26055,1180,26055,26055,27233,25921,1312,25921
510,34378,30373,29926,447,29926,29926,30369,29680,689,29680
511,48667,52870,49857,3013,49857,48667,52918,49052,3866,48667
512,342777,346057,352099,-6042,346057,342777,346133,342769,3364,342769
513,11906,12142,11905,237,11905,11905,12135,11792,343,11792
514,16828,15978,15728,250,15728,15728,15980,15566,414,15566
515,4288,4124,4286,-162,4124,4124,4127,4171,-44,4171
516,3100,2688,2924,-236,2688,2688,2690,2727,-37,2727
517,85452,83915,79571,4344,79571,79571,83924,79214,4710,79214
518,1838,982,1192,-210,982,982,982,1025,-43,1025
519,296169,296153,281675,14478,281675,281675,296175,280135,16040,280135
520,8956,8523,8364,159,8364,8364,8523,8264,259,8264
521,176087,173600,166448,7152,166448,166448,173575,165407,8168,165407
522,3600,3599,3692,-93,3599,3599,3600,3542,58,3542
523,290565,290385,272769,17616,272769,272769,290565,272090,18475,272090
524,616931,579503,555133,24370,555133,555133,579452,547718,31734,547718
525,48208,35370,34265,1105,34265,34265,35363,33860,1503,33860
526,13434,12940,12789,151,12789,12789,12931,12555,376,12555
527,41534,41515,41023,492,41023,41023,41513,40194,1319,40194
528,429321,394685,379321,15364,379321,379321,394706,377370,17336,377370
529,7805,8108,7805,303,7805,7805,8112,7404,708,7404
530,7345,6408,6865,-457,6408,6408,6407,6207,200,6207
531,1562,1562,1819,-257,1562,1562,1562,1571,-9,1562
532,1030,812,1030,-218,812,812,812,857,-45,857
533,7799,7800,7710,90,7710,7710,7799,7614,185,7614
534,7987,7985,7826,159,7826,7826,7987,7778,209,7778
535,4054,3232,3457,-225,3232,3232,3229,3254,-25,3254
536,49691,45248,42429,2819,42429,42429,45230,41402,3828,41402
537,628800,612763,588970,23793,588970,588970,612859,585217,27642,585217
538,83839,70066,66239,3827,66239,66239,70038,65964,4074,65964
539,1100,1098,1313,-215,1098,1098,1100,1148,-48,1100
540,12190,12991,12347,644,12347,12190,12994,11568,1426,11568
541,17207,17594,17139,455,17139,17139,17597,16905,692,16905
542,36373,35999,34185,1814,34185,34185,35976,33896,2080,33896
543,44255,44913,44344,569,44344,44255,44910,44255,655,44255
544,21131,21350,21141,209,21141,21131,21354,20714,640,20714
545,9313,8825,8666,159,8666,8666,8822,8509,313,8509
546,53782,53217,51285,1932,51285,51285,53226,50929,2297,50929
547,42990,45670,46259,-589,45670,42990,45694,42948,2746,42948
548,58792,53229,48982,4247,48982,48982,53249,47825,5424,47825
549,561,333,574,-241,333,333,333,381,-48,381
550,7143,6900,6923,-23,6900,6900,6901,6521,380,6521
551,575088,571745,564782,6963,564782,564782,571688,554797,16891,554797
552,7741,6895,7026,-131,6895,6895,6893,6696,197,6696
553,71054,70163,71209,-1046,70163,70163,70146,67660,2486,67660
554,35678,34767,33946,821,33946,33946,34770,33911,859,33911
555,38534,37675,37097,578,37097,37097,37673,36070,1603,36070
556,8129,5079,5136,-57,5079,5079,5081,5004,77,5004
557,8124,7689,7639,50,7639,7639,7692,7539,153,7539
558,2187,1303,1510,-207,1303,1303,1303,1361,-58,1361
559,78166,78951,80507,-1556,78951,78166,78953,78770,183,78166
560,68088,70396,68075,2321,68075,68075,70364,67915,2449,67915
561,13014,9668,9836,-168,9668,9668,9661,8487,1174,8487
562,59610,58685,55549,3136,55549,55549,58714,53221,5493,53221
563,93054,91784,87460,4324,87460,87460,91800,87135,4665,87135
564,3081,2253,2414,-161,2253,2253,2253,2141,112,2141
565,127196,1288,1533,-245,1288,1288,1289,1329,-40,1329
566,41642,40792,39476,1316,39476,39476,40813,39290,1523,39290
567,42101,13131,12891,240,12891,12891,13127,12800,327,12800
568,121197,124385,121684,2701,121684,121197,124388,121197,3191,121197
569,8410,7555,7299,256,7299,7299,7557,7086,471,7086
570,402,402,646,-244,402,402,402,451,-49,402
571,41336,26528,26148,380,26148,26148,26517,25812,705,25812
572,82770,82747,77978,4769,77978,77978,82771,77263,5508,77263
573,278354,261481,249948,11533,249948,249948,261478,247429,14049,247429
574,8899,8902,9241,-339,8902,8899,8899,8618,281,8618
575,5716,5122,5272,-150,5122,5122,5126,5055,71,5055
576,50339,50341,48864,1477,48864,48864,50339,48484,1855,48484
577,301719,300744,288277,12467,288277,288277,300957,287337,13620,287337
578,115998,112442,107142,5300,107142,107142,112443,106306,6137,106306
579,448109,461359,447622,13737,447622,447622,461486,445078,16408,445078
580,823803,819918,795311,24607,795311,795311,819642,793265,26377,793265
581,51888,51835,50889,946,50889,50889,51847,50365,1482,50365
582,52358,48464,46960,1504,46960,46960,48448,46280,2168,46280
583,299,315,552,-237,315,299,315,362,-47,299
584,254395,252148,245201,6947,245201,245201,252273,240461,11812,240461
585,8480,7996,7854,142,7854,7854,7998,7575,423,7575
586,41634,39731,38144,1587,38144,38144,39737,37243,2494,37243
587,3665,3674,3887,-213,3674,3665,3674,3687,-13,3665
588,76554,75270,74900,370,74900,74900,75265,74042,1223,74042
589,5249,5250,5475,-225,5250,5249,5249,5205,44,5205
590,135172,135156,132955,2201,132955,132955,135172,131850,3322,131850
591,85498,84292,80188,4104,80188,80188,84311,78699,5612,78699
592,200554,200544,195427,5117,195427,195427,200554,189055,11499,189055
593,67527,74713,73362,1351,73362,67527,74757,66739,8018,66739
594,913630,173618,164910,8708,164910,164910,173682,163315,10367,163315
595,11048,10521,10227,294,10227,10227,10520,10064,456,10064
596,1095768,1034277,973331,60946,973331,973331,1034050,964614,69436,964614
597,23739,16921,16577,344,16577,16577,16927,16438,489,16438
598,2897,2900,2997,-97,2900,2897,2897,2877,20,2877
599,14005,14010,13749,261,13749,13749,14005,13722,283,13722
600,17558,17707,17478,229,17478,17478,17710,16936,774,16936
601,74590,62919,60592,2327,60592,60592,62953,60191,2762,60191
602,416443,397292,376265,21027,376265,376265,397256,372692,24564,372692
603,19171,19166,18440,726,18440,18440,19171,18102,1069,18102
604,611039,607641,615005,-7364,607641,607641,607877,582779,25098,582779
605,24558,25785,24655,1130,24655,24558,25778,24584,1194,24558
606,172925,172973,164519,8454,164519,164519,172925,163724,9201,163724
607,16083,16069,15872,197,15872,15872,16072,15744,328,15744
608,13705,13709,13623,86,13623,13623,13705,13400,305,13400
609,26652,25815,25342,473,25342,25342,25839,25166,673,25166
610,1105,893,1133,-240,893,893,893,948,-55,948
611,1037,1053,1316,-263,1053,1037,1053,1106,-53,1037
612,17470,17923,17492,431,17492,17470,17923,16848,1075,16848
613,13010,12931,13014,-83,12931,12931,12933,12782,151,12782
614,34152,33244,32466,778,32466,32466,33260,32350,910,32350
615,32494,37008,37030,-22,37008,32494,37020,34404,2616,32494
616,118117,122444,118088,4356,118088,118088,122435,117787,4648,117787
617,8015,7202,6990,212,6990,6990,7205,6823,382,6823
618,42307,42232,40673,1559,40673,40673,42239,40430,1809,40430
619,9298,8867,8780,87,8780,8780,8869,8609,260,8609
620,16228,16215,16016,199,16016,16016,16228,15849,379,15849
621,23731,23721,23449,272,23449,23449,23731,23250,481,23250
622,10092,9433,9480,-47,9433,9433,9427,9339,88,9339
623,3009,2877,3009,-132,2877,2877,2878,2802,76,2802
624,38992,11307,11311,-4,11307,11307,11309,11154,155,11154
625,15396,15736,15386,350,15386,15386,15733,15229,504,15229
626,1653,1653,1844,-191,1653,1653,1653,1679,-26,1653
627,145811,148221,145788,2433,145788,145788,148200,145000,3200,145000
628,1317,409,659,-250,409,409,409,439,-30,439
629,338304,307893,295888,12005,295888,295888,307890,263644,44246,263644
630,19274,20565,19208,1357,19208,19208,20560,18829,1731,18829
631,12975,13298,12968,330,12968,12968,13294,12823,471,12823
632,86822,90135,92958,-2823,90135,86822,90158,86814,3344,86814
633,5683,5046,5125,-79,5046,5046,5043,4995,48,4995
634,21908,21265,20759,506,20759,20759,21266,20547,719,20547
635,10608,10608,10837,-229,10608,10608,10608,10566,42,10566
636,5340,5171,5266,-95,5171,5171,5168,5178,-10,5178
637,157471,155634,149003,6631,149003,149003,155638,148640,6998,148640
638,9910,9866,9844,22,9844,9844,9869,9533,336,9533
639,6745,6586,6682,-96,6586,6586,6591,6357,234,6357
640,3809,3807,4199,-392,3807,3807,3809,3913,-104,3809
641,65399,68224,65978,2246,65978,65399,68230,65352,2878,65352
642,581563,563988,541369,22619,541369,541369,563791,536792,26999,536792
643,209318,205871,201343,4528,201343,201343,205844,197538,8306,197538
644,13229,2519,3044,-525,2519,2519,2525,3001,-476,3001
645,22914,22439,21985,454,21985,21985,22443,21836,607,21836
646,79660,64024,60403,3621,60403,60403,64024,59321,4703,59321
647,9866,9248,9363,-115,9248,9248,9252,9244,8,9244
648,76398,76380,73851,2529,73851,73851,76398,73281,3117,73281
649,107400,111593,107339,4254,107339,107339,111636,107284,4352,107284
650,9157,7883,7730,153,7730,7730,7882,7624,258,7624
651,5450,5130,5393,-263,5130,5130,5130,4886,244,4886
652,3871,3753,3812,-59,3753,3753,3757,3526,231,3526
653,174978,174129,172575,1554,172575,172575,174049,169786,4263,169786
654,141703,117477,111577,5900,111577,111577,117442,110927,6515,110927
655,18830,18722,19394,-672,18722,18722,18722,18658,64,18658
656,64863,63399,64271,-872,63399,63399,63437,63185,252,63185
657,25538,25538,24732,806,24732,24732,25544,24292,1252,24292
658,5500,5495,5843,-348,5495,5495,5500,5574,-74,5500
659,1744,1366,1622,-256,1366,1366,1369,1415,-46,1415
660,1463,1229,1462,-233,1229,1229,1229,1229,0,1229
661,853,570,792,-222,570,570,570,619,-49,619
662,7103,7103,7337,-234,7103,7103,7103,7112,-9,7103
663,21640,21347,21642,-295,21347,21347,21365,20897,468,20897
664,16999,16976,16829,147,16829,16829,16982,16697,285,16697
665,2206,1980,2144,-164,1980,1980,1981,1978,3,1978
666,29225,30061,29219,842,29219,29219,30061,28926,1135,28926
667,5843,5207,5372,-165,5207,5207,5210,5061,149,5061
668,59978,59980,58402,1578,58402,58402,59978,58084,1894,58084
669,69736,7844,7647,197,7647,7647,7847,7528,319,7528
670,37192,39053,37134,1919,37134,37134,39057,34881,4176,34881
671,79214,78513,76169,2344,76169,76169,78514,75872,2642,75872
672,8234,8235,8468,-233,8235,8234,8234,8224,10,8224
673,33787,34584,33994,590,33994,33787,34589,33838,751,33787
674,134858,133971,131074,2897,131074,131074,133973,130083,3890,130083
675,49721,51416,49662,1754,49662,49662,51416,49481,1935,49481
676,346302,294728,277932,16796,277932,277932,294843,274892,19951,274892
677,37703,24493,23504,989,23504,23504,24485,23221,1264,23221
678,25441,24920,24624,296,24624,24624,24913,24355,558,24355
679,3398,3408,3650,-242,3408,3398,3408,3357,51,3357
680,11739,11740,11385,355,11385,11385,11739,11289,450,11289
681,36725,36729,34733,1996,34733,34733,36725,34721,2004,34721
682,59614,58811,57678,1133,57678,57678,58787,57303,1484,57303
683,102325,98394,93836,4558,93836,93836,98405,93497,4908,93497
684,81953,78419,73012,5407,73012,73012,78410,72675,5735,72675
685,11799,12051,11791,260,11791,11791,12052,11712,340,11712
686,745,745,984,-239,745,745,745,796,-51,745
687,2518,2206,2398,-192,2206,2206,2205,2230,-25,2230
688,5783,5202,5276,-74,5202,5202,5204,5161,43,5161
689,3422,2945,3100,-155,2945,2945,2945,2968,-23,2968
690,27442,26588,26162,426,26162,26162,26619,25911,708,25911
691,11177,10265,9973,292,9973,9973,10269,9534,735,9534
692,126519,123561,117958,5603,117958,117958,123596,117587,6009,117587
693,1239,648,901,-253,648,648,648,697,-49,697
694,20120,20115,20331,-216,20115,20115,20120,19987,133,19987
695,24499,23301,22636,665,22636,22636,23309,22253,1056,22253
696,135751,134892,129335,5557,129335,129335,134912,128608,6304,128608
697,146160,126104,122952,3152,122952,122952,126069,122171,3898,122171
698,7702,6806,6652,154,6652,6652,6811,6337,474,6337
699,37886,37868,36932,936,36932,36932,37886,36726,1160,36726
700,1735,1432,1638,-206,1432,1432,1430,1480,-50,1480
701,114024,114723,110191,4532,110191,110191,114714,109131,5583,109131
702,97377,96475,95567,908,95567,95567,96429,94467,1962,94467
703,33094,32620,32169,451,32169,32169,32633,31849,784,31849
704,38156,38250,38160,90,38160,38156,38257,37784,473,37784
705,458196,419789,411000,8789,411000,411000,419736,404540,15196,404540
706,11162,10590,10428,162,10428,10428,10594,10165,429,10165
707,40965,29926,28952,974,28952,28952,29926,28617,1309,28617
708,29283,28446,27332,1114,27332,27332,28455,26697,1758,26697
709,4072,4126,4240,-114,4126,4072,4127,4060,67,4060
710,71974,68313,66470,1843,66470,66470,68325,65510,2815,65510
711,19106,7510,7643,-133,7510,7510,7509,7424,85,7424
712,42686,44554,43029,1525,43029,42686,44555,42664,1891,42664
713,120280,118231,117750,481,117750,117750,118278,116013,2265,116013
714,33057,33081,31825,1256,31825,31825,33057,31749,1308,31749
715,94427,96260,94420,1840,94420,94420,96226,93498,2728,93498
716,9946,9948,10041,-93,9948,9946,9946,9785,161,9785
717,726175,726405,687783,38622,687783,687783,726175,685199,40976,685199
718,14438,14381,14296,85,14296,14296,14376,14106,270,14106
719,15521,15518,15363,155,15363,15363,15521,15133,388,15133
720,27390,27399,27448,-49,27399,27390,27390,26832,558,26832
721,10279,9832,9802,30,9802,9802,9832,9567,265,9567
722,4057,4061,4215,-154,4061,4057,4060,4045,15,4045
723,34183,34191,33079,1112,33079,33079,34183,32921,1262,32921
724,66583,66556,63659,2897,63659,63659,66583,63551,3032,63551
725,5612,5709,5562,147,5562,5562,5715,5449,266,5449
726,540715,465494,440272,25222,440272,440272,465622,435642,29980,435642
727,18924,18930,19537,-607,18930,18924,18924,18898,26,18898
728,30361,29658,29296,362,29296,29296,29661,29005,656,29005
729,413286,412319,402589,9730,402589,402589,412203,397289,14914,397289
730,134490,140361,140632,-271,140361,134490,140347,134482,5865,134482
731,26112,26082,25491,591,25491,25491,26076,23239,2837,23239
732,18140,18448,18139,309,18139,18139,18450,17993,457,17993
733,15832,3406,3604,-198,3406,3406,3407,3466,-59,3466
734,463860,194439,190949,3490,190949,190949,194584,188660,5924,188660
735,15201,14178,13911,267,13911,13911,14180,13599,581,13599
736,11647,11225,11013,212,11013,11013,11224,10881,343,10881
737,86093,86056,84176,1880,84176,84176,86070,83057,3013,83057
738,156388,156396,150839,5557,150839,150839,156388,150488,5900,150488
739,1614,1359,1615,-256,1359,1359,1358,1411,-53,1411
740,705762,723283,702530,20753,702530,702530,723436,680024,43412,680024
741,18336,18338,17912,426,17912,17912,18336,17771,565,17771
742,16920,16857,16185,672,16185,16185,16859,15551,1308,15551
743,96080,94349,93671,678,93671,93671,94371,92797,1574,92797
744,15442,14719,14331,388,14331,14331,14714,14199,515,14199
745,2222,1944,2160,-216,1944,1944,1940,2006,-66,2006
746,104611,70162,66026,4136,66026,66026,70159,64884,5275,64884
747,39981,39981,38882,1099,38882,38882,39981,38606,1375,38606
748,32170,31614,30546,1068,30546,30546,31619,30480,1139,30480
749,24913,23235,22393,842,22393,22393,23233,22254,979,22254
750,320561,301157,303812,-2655,301157,301157,301228,290671,10557,290671
751,24688,2150,2287,-137,2150,2150,2151,1950,201,1950
752,496523,496381,486230,10151,486230,486230,496387,481851,14536,481851
753,74855,74647,75408,-761,74647,74647,74696,72167,2529,72167
754,116726,111279,104887,6392,104887,104887,111253,101503,9750,101503
755,5427,4904,4889,15,4889,4889,4902,4819,83,4819
756,32676,34181,31901,2280,31901,31901,34195,31004,3191,31004
757,66145,57321,57228,93,57228,57228,57370,56314,1056,56314
758,12365,12794,12858,-64,12794,12365,12796,12365,431,12365
759,36567,38290,39240,-950,38290,36567,38292,36871,1421,36567
760,47291,47190,46232,958,46232,46232,47174,45898,1276,45898
761,31887,30647,30906,-259,30647,30647,30652,30171,481,30171
762,11284,7739,7932,-193,7739,7739,7741,6854,887,6854
763,146905,145910,138599,7311,138599,138599,145983,135394,10589,135394
764,8226,7665,7745,-80,7665,7665,7661,7521,140,7521
765,18722,19401,18660,741,18660,18660,19400,18611,789,18611
766,10808,9454,9362,92,9362,9362,9451,9054,397,9054
767,41969,41064,39262,1802,39262,39262,41070,37960,3110,37960
768,40371,40296,37860,2436,37860,37860,40309,37565,2744,37565
769,9837,9149,9034,115,9034,9034,9149,8775,374,8775
770,5077,4608,4774,-166,4608,4608,4607,4613,-6,4613
771,20001,20672,19933,739,19933,19933,20672,19842,830,19842
772,65000,68790,64997,3793,64997,64997,68801,64897,3904,64897
773,1236,1234,1471,-237,1234,1234,1236,1283,-47,1236
774,159318,158490,157406,1084,157406,157406,158531,151028,7503,151028
775,217033,206887,193831,13056,193831,193831,206944,191357,15587,191357
776,88523,87751,84578,3173,84578,84578,87771,84273,3498,84273
777,13392,13785,13395,390,13395,13392,13786,13228,558,13228
778,511158,561830,543386,18444,543386,511158,561881,510536,51345,510536
779,13341,12811,12161,650,12161,12161,12813,12074,739,12074
780,50959,49820,50343,-523,49820,49820,49863,49759,104,49759
781,40511,35818,33660,2158,33660,33660,35802,33534,2268,33534
782,3183,2921,3120,-199,2921,2921,2921,2712,209,2712
783,99571,99560,93931,5629,93931,93931,99571,93860,5711,93860
784,986730,949453,901268,48185,901268,901268,949299,896264,53035,896264
785,190335,142695,139872,2823,139872,139872,142647,138647,4000,138647
786,27290,26592,26072,520,26072,26072,26591,25798,793,25798
787,46136,46059,45156,903,45156,45156,46042,44853,1189,44853
788,2063,1931,2235,-304,1931,1931,1932,1956,-24,1956
789,70305,68595,67044,1551,67044,67044,68619,66541,2078,66541
790,85675,81331,79377,1954,79377,79377,81332,77949,3383,77949
791,84260,85402,85392,10,85392,84260,85415,84226,1189,84226
792,3007,2505,2554,-49,2505,2505,2508,2358,150,2358
793,340448,325705,316102,9603,316102,316102,325755,310231,15524,310231
794,10521,1767,2024,-257,1767,1767,1766,1833,-67,1833
795,93081,92936,92571,365,92571,92571,92939,91501,1438,91501
796,25775,7880,8070,-190,7880,7880,7884,7847,37,7847
797,3357,2404,2642,-238,2404,2404,2404,2476,-72,2476
798,3117,3101,3309,-208,3101,3101,3102,3131,-29,3117
799,24099,24081,22127,1954,22127,22127,24099,21416,2683,21416
800,8594,7777,7714,63,7714,7714,7773,7541,232,7541
801,54025,55967,54425,1542,54425,54025,55986,54007,1979,54007
802,1187,1166,1423,-257,1166,1166,1165,1225,-60,1187
803,10378,9785,9761,24,9761,9761,9794,9421,373,9421
804,619449,596446,554076,42370,554076,554076,596739,544716,52023,544716
805,15097,15031,14400,631,14400,14400,15036,14143,893,14143
806,4140,3677,3881,-204,3677,3677,3677,3702,-25,3702
807,11626,11618,11238,380,11238,11238,11626,10356,1270,10356
808,42337,25898,25575,323,25575,25575,25904,25211,693,25211
809,29510,28804,27900,904,27900,27900,28789,27771,1018,27771
810,953,285,519,-234,285,285,285,331,-46,331
811,171306,182024,177749,4275,177749,171306,181994,171298,10696,171298
812,117737,117203,111117,6086,111117,111117,117195,109033,8162,109033
813,14474,13716,13264,452,13264,13264,13714,13240,474,13240
814,59749,66617,62661,3956,62661,59749,66638,59679,6959,59679
815,38592,37490,35845,1645,35845,35845,37487,35690,1797,35690
816,10345,10712,10801,-89,10712,10345,10720,10313,407,10313
817,5813,5826,6081,-255,5826,5813,5829,5727,102,5727
818,30537,28233,27483,750,27483,27483,28256,26602,1654,26602
819,17930,18781,17805,976,17805,17805,18780,17308,1472,17308
820,19426,14153,13882,271,13882,13882,14151,13755,396,13755
821,125106,127469,125079,2390,125079,125079,127462,124725,2737,124725
822,144801,154021,144785,9236,144785,144785,154031,144585,9446,144585
823,53563,52595,50245,2350,50245,50245,52620,49276,3344,49276
824,14701,14202,14118,84,14118,14118,14209,13912,297,13912
825,20623,19693,18946,747,18946,18946,19697,18743,954,18743
826,240381,159652,147315,12337,147315,147315,159659,141717,17942,141717
827,23391,24293,24449,-156,24293,23391,24298,22769,1529,22769
828,6714,6322,6355,-33,6322,6322,6320,6194,126,6194
829,50551,48843,46463,2380,46463,46463,48834,45509,3325,45509
830,930965,915514,875773,39741,875773,875773,915752,869913,45839,869913
831,7384,7380,7498,-118,7380,7380,7384,7083,301,7083
832,28775,25566,25123,443,25123,25123,25556,24807,749,24807
833,45576,37125,36654,471,36654,36654,37119,36449,670,36449
834,5013,5011,5181,-170,5011,5011,5013,5012,1,5012
835,308381,275215,265409,9806,265409,265409,275209,262733,12476,262733
836,134249,134170,132766,1404,132766,132766,134249,130124,4125,130124
837,23945,21094,19722,1372,19722,19722,21105,19566,1539,19566
838,3611,3576,3697,-121,3576,3576,3577,3593,-16,3593
839,13842,13421,13236,185,13236,13236,13427,13046,381,13046
840,79606,72720,70521,2199,70521,70521,72783,68233,4550,68233
841,1120,729,970,-241,729,729,730,783,-53,783
842,6574,4970,5105,-135,4970,4970,4973,4894,79,4894
843,38796,35618,35042,576,35042,35042,35634,33571,2063,33571
844,84120,54873,51118,3755,51118,51118,54877,50019,4858,50019
845,83715,88448,83635,4813,83635,83635,88464,82462,6002,82462
846,194286,181390,175540,5850,175540,175540,181410,172606,8804,172606
847,4339,2616,2841,-225,2616,2616,2616,2660,-44,2660
848,7171,6783,6738,45,6738,6738,6780,6612,168,6612
849,12478,12472,12300,172,12300,12300,12478,12143,335,12143
850,195748,185313,184072,1241,184072,184072,185346,179278,6068,179278
851,159641,106862,97657,9205,97657,97657,106879,93289,13590,93289
852,109868,65880,64264,1616,64264,64264,65896,64130,1766,64130
853,327917,327889,318884,9005,318884,318884,327917,316691,11226,316691
854,20130,21066,20531,535,20531,20130,21076,20255,821,20130
855,8558,7853,7763,90,7763,7763,7858,7576,282,7576
856,37547,35023,34750,273,34750,34750,35014,33387,1627,33387
857,72904,75875,72898,2977,72898,72898,75873,72492,3381,72492
858,63206,63209,60976,2233,60976,60976,63206,60695,2511,60695
859,100997,100946,97526,3420,97526,97526,100938,95386,5552,95386
860,140475,115223,111557,3666,111557,111557,115208,110766,4442,110766
861,115521,122523,121651,872,121651,115521,122591,116972,5619,115521
862,161002,167639,162250,5389,162250,161002,167646,160956,6690,160956
863,5095,4167,4282,-115,4167,4167,4172,4145,27,4145
864,1744,1450,1683,-233,1450,1450,1450,1464,-14,1464
865,74545,77329,74525,2804,74525,74525,77325,73959,3366,73959
866,31476,16268,15344,924,15344,15344,16267,14930,1337,14930
867,32177,26668,26248,420,26248,26248,26669,25556,1113,25556
868,15735,15114,14997,117,14997,14997,15112,14786,326,14786
869,2111,1150,1378,-228,1150,1150,1150,1210,-60,1210
870,6720,6074,6388,-314,6074,6074,6074,6098,-24,6098
871,46594,45975,44164,1811,44164,44164,45983,43970,2013,43970
872,21928,20548,19571,977,19571,19571,20533,19284,1249,19284
873,46484,43988,41328,2660,41328,41328,43991,40626,3365,40626
874,1582,908,1163,-255,908,908,908,960,-52,960
875,8562,5108,5255,-147,5108,5108,5106,5106,0,5106
876,2723,2792,2980,-188,2792,2723,2791,2690,101,2690
877,14630,14630,14555,75,14555,14555,14630,14374,256,14374
878,56098,56127,55321,806,55321,55321,56098,54928,1170,54928
879,124453,97365,92868,4497,92868,92868,97390,92640,4750,92640
880,30716,25941,24229,1712,24229,24229,25947,22332,3615,22332
881,173604,170146,166503,3643,166503,166503,170200,165277,4923,165277
882,5922,4942,5054,-112,4942,4942,4942,4959,-17,4959
883,11870,11081,10552,529,10552,10552,11086,10326,760,10326
884,102697,102715,101359,1356,101359,101359,102713,101094,1619,101094
885,119445,117034,110465,6569,110465,110465,116979,109552,7427,109552
886,25259,26482,25254,1228,25254,25254,26480,24839,1641,24839
887,7283,6872,6778,94,6778,6778,6871,6681,190,6681
888,6760,6327,6306,21,6306,6306,6326,6097,229,6097
889,7520,6565,6479,86,6479,6479,6562,6405,157,6405
890,73358,73235,72494,741,72494,72494,73258,70677,2581,70677
891,16096,16091,16314,-223,16091,16091,16096,15848,248,15848
892,106278,101927,98965,2962,98965,98965,101957,98597,3360,98597
893,57054,37931,37505,426,37505,37505,37937,36026,1911,36026
894,10892,10385,10265,120,10265,10265,10389,10083,306,10083
895,1688,1307,1528,-221,1307,1307,1306,1348,-42,1348
896,24920,22248,20671,1577,20671,20671,22238,20574,1664,20574
897,13480,13866,13474,392,13474,13474,13870,13374,496,13374
898,380365,390840,395453,-4613,390840,380365,391024,387463,3561,380365
899,592940,589601,558682,30919,558682,558682,589957,554505,35452,554505
900,11366,11342,11298,44,11298,11298,11348,11115,233,11115
901,5267,4912,5115,-203,4912,4912,4918,4940,-22,4940
902,15214,15216,14975,241,14975,14975,15214,14882,332,14882
903,29703,3509,3714,-205,3509,3509,3513,3551,-38,3551
904,307533,307458,294483,12975,294483,294483,307461,287656,19805,287656
905,62140,62115,59806,2309,59806,59806,62121,59466,2655,59466
906,958786,905509,861465,44044,861465,861465,905363,851043,54320,851043
907,21020,20157,19211,946,19211,19211,20149,19137,1012,19137
908,128620,127448,123505,3943,123505,123505,127497,122311,5186,122311
909,239149,236446,229670,6776,229670,229670,236498,225779,10719,225779
910,418382,382556,383581,-1025,382556,382556,382657,355470,27187,355470
911,19296,14098,13925,173,13925,13925,14106,13774,332,13774
912,68176,64054,60491,3563,60491,60491,64066,60307,3759,60307
913,57075,47499,51322,-3823,47499,47499,47504,42885,4619,42885
914,21485,21482,21268,214,21268,21268,21485,20930,555,20930
915,782,782,1048,-266,782,782,782,823,-41,782
916,43317,4045,4220,-175,4045,4045,4046,4057,-11,4057
917,69034,71253,69003,2250,69003,69003,71245,68894,2351,68894
918,9187,8764,8874,-110,8764,8764,8765,8610,155,8610
919,44340,23076,22844,232,22844,22844,23087,22678,409,22678
920,23478,21655,20375,1280,20375,20375,21653,20188,1465,20188
921,60652,49821,48413,1408,48413,48413,49802,48016,1786,48016
922,60423,59147,55640,3507,55640,55640,59148,55528,3620,55528
923,130424,127007,120238,6769,120238,120238,126987,119509,7478,119509
924,6607,6750,6826,-76,6750,6607,6747,6629,118,6607
925,10160,10132,10152,-20,10132,10132,10136,10118,18,10118
926,481786,441306,433366,7940,433366,433366,441308,427378,13930,427378
927,12659,11731,11414,317,11414,11414,11732,11301,431,11301
928,23497,22398,21303,1095,21303,21303,22394,21091,1303,21091
929,255721,223529,215836,7693,215836,215836,223618,214207,9411,214207
930,8990,8611,8505,106,8505,8505,8607,8371,236,8371
931,28071,25754,24657,1097,24657,24657,25760,24438,1322,24438
932,20358,19857,19682,175,19682,19682,19854,19432,422,19432
933,18590,18585,18459,126,18459,18459,18590,18237,353,18237
934,14890,14892,14708,184,14708,14708,14890,14463,427,14463
935,20643,20634,20647,-13,20634,20634,20643,20285,358,20285
936,51968,50035,47238,2797,47238,47238,50026,47117,2909,47117
937,2288,1914,2116,-202,1914,1914,1912,1963,-51,1963
938,24787,23133,21868,1265,21868,21868,23141,21147,1994,21147
939,9477,9064,9076,-12,9064,9064,9065,8939,126,8939
940,42254,43695,41489,2206,41489,41489,43718,40959,2759,40959
941,17307,17303,17198,105,17198,17198,17307,16854,453,16854
942,95611,86079,81587,4492,81587,81587,86112,81424,4688,81424
943,10479,10476,10526,-50,10476,10476,10479,10337,142,10337
944,7585,6459,6548,-89,6459,6459,6460,6175,285,6175
945,4824,4832,4788,44,4788,4788,4828,4456,372,4456
946,14835,14831,14876,-45,14831,14831,14835,14618,217,14618
947,23047,23052,22805,247,22805,22805,23047,22566,481,22566
948,30417,30420,29330,1090,29330,29330,30417,28970,1447,28970
949,59549,41356,39595,1761,39595,39595,41374,38790,2584,38790
950,217099,187891,180541,7350,180541,180541,187922,179675,8247,179675
951,3780,2793,2996,-203,2793,2793,2789,2775,14,2775
952,5080,5219,5077,142,5077,5077,5222,4912,310,4912
953,33775,32175,30794,1381,30794,30794,32176,30405,1771,30405
954,3645,3644,3632,12,3632,3632,3645,3572,73,3572
955,405403,388666,371485,17181,371485,371485,388793,370755,18038,370755
956,62661,61816,61265,551,61265,61265,61822,60600,1222,60600
957,5265,4841,4922,-81,4841,4841,4843,4779,64,4779
958,26771,28102,26774,1328,26774,26771,28128,25856,2272,25856
959,6512,5303,5295,8,5295,5295,5306,5203,103,5203
960,1445597,1388607,1278025,110582,1278025,1278025,1388485,1270230,118255,1270230
961,49024,43231,40791,2440,40791,40791,43228,38326,4902,38326
962,133874,132642,127597,5045,127597,127597,132635,127210,5425,127210
963,16433,16427,16742,-315,16427,16427,16433,16368,65,16368
964,123802,123545,116418,7127,116418,116418,123490,114155,9335,114155
965,22450,8070,8178,-108,8070,8070,8063,7753,310,7753
966,204533,203536,199030,4506,199030,199030,203637,197715,5922,197715
967,25313,24791,23463,1328,23463,23463,24785,23319,1466,23319
968,88128,95900,93249,2651,93249,88128,95904,89011,6893,88128
969,36364,33690,31275,2415,31275,31275,33713,30443,3270,30443
970,306,287,521,-234,287,287,287,332,-45,306
971,64957,64104,61684,2420,61684,61684,64119,58978,5141,58978
972,175584,162357,158863,3494,158863,158863,162416,156829,5587,156829
973,34036,31784,32204,-420,31784,31784,31813,31451,362,31451
974,16291,15772,15307,465,15307,15307,15765,15154,611,15154
975,579,579,824,-245,579,579,579,603,-24,579
976,16789,15118,14695,423,14695,14695,15124,14617,507,14617
977,27918,26599,26837,-238,26599,26599,26613,26191,422,26191
978,23973,6601,6429,172,6429,6429,6603,5610,993,5610
979,3636,3635,3777,-142,3635,3635,3635,3617,18,3617
980,8590,8091,7946,145,7946,7946,8089,7766,323,7766
981,52638,54651,52571,2080,52571,52571,54643,52296,2347,52296
982,32371,35041,35766,-725,35041,32371,35048,32554,2494,32371
983,3157150,2685835,2562973,122862,2562973,2562973,2686724,2529830,156894,2529830
984,15059,10654,11254,-600,10654,10654,10653,10800,-147,10800
985,280391,210904,208819,2085,208819,208819,210985,206965,4020,206965
986,48822,48364,47672,692,47672,47672,48380,47251,1129,47251
987,993752,991851,939202,52649,939202,939202,991907,933493,58414,933493
988,82192,82209,80420,1789,80420,80420,82192,80017,2175,80017
989,95802,101875,96810,5065,96810,95802,101885,95794,6091,95794
990,30288,32569,31288,1281,31288,30288,32582,30280,2302,30280
991,34124,34127,33139,988,33139,33139,34122,32506,1616,32506
992,502858,501704,496236,5468,496236,496236,501946,482947,18999,482947
993,170651,169758,166656,3102,166656,166656,169728,164899,4829,164899
994,2524,2527,2724,-197,2527,2524,2524,2599,-75,2524
995,42125,42109,40501,1608,40501,40501,42125,40402,1723,40402
996,197779,202029,199881,2148,199881,197779,202097,199001,3096,197779
997,18879,17826,17236,590,17236,17236,17819,16793,1026,16793
998,11398,11680,11331,349,11331,11331,11684,11053,631,11053
999,430989,412862,391731,21131,391731,391731,412850,391502,21348,391502
1000,9153,9155,9134,21,9134,9134,9153,8969,184,8969
1001,9544,9494,9720,-226,9494,9494,9497,9504,-7,9504
1002,261912,219685,227094,-7409,219685,219685,219730,218165,1565,218165
1003,26934,21560,20842,718,20842,20842,21565,20692,873,20692
1004,54373,53568,54349,-781,53568,53568,53591,53700,-109,53700
1005,200202,179811,174345,5466,174345,174345,179879,173317,6562,173317
1006,167051,140531,137150,3381,137150,137150,140578,136274,4304,136274
1007,25618,6818,6988,-170,6818,6818,6815,6719,96,6719
1008,3609675,3570273,3395627,174646,3395627,3395627,3570399,3367275,203124,3367275
1009,12147,12170,12665,-495,12170,12147,12169,12139,30,12139
1010,23270,23764,23200,564,23200,23200,23776,22744,1032,22744
1011,20706,20696,20142,554,20142,20142,20712,20084,628,20084
1012,35678,36184,35677,507,35677,35677,36186,35056,1130,35056
1013,256685,212773,206967,5806,206967,206967,212832,206342,6490,206342
1014,67812,46574,43662,2912,43662,43662,46566,43022,3544,43022
1015,43848,43824,43621,203,43621,43621,43848,43113,735,43113
1016,12093,12096,11870,226,11870,11870,12093,11672,421,11672
1017,268633,265134,268509,-3375,265134,265134,265241,256744,8497,256744
1018,207702,219854,208147,11707,208147,207702,219967,202266,17701,202266
1019,377,377,611,-234,377,377,377,393,-16,377
1020,88145,87272,85309,1963,85309,85309,87267,84734,2533,84734
1021,18798,14847,14828,19,14828,14828,14868,14600,268,14600
1022,21399,7680,7495,185,7495,7495,7680,7295,385,7295
1023,56292,37565,36146,1419,36146,36146,37577,35986,1591,35986
1024,20992,20176,19835,341,19835,19835,20175,19203,972,19203
1025,13516,13887,14252,-365,13887,13516,13895,13758,137,13516
1026,82696,84350,84397,-47,84350,82696,84387,82688,1699,82688
1027,22666,22135,21597,538,21597,21597,22135,21476,659,21476
1028,31555,31503,30172,1331,30172,30172,31513,29997,1516,29997
1029,3640,3637,3724,-87,3637,3637,3640,3475,165,3475
1030,10290,10262,10324,-62,10262,10262,10271,10097,174,10097
1031,15406,14867,14581,286,14581,14581,14873,14401,472,14401
1032,60594,57617,53704,3913,53704,53704,57645,53569,4076,53569
1033,76828,80616,77109,3507,77109,76828,80636,76206,4430,76206
1034,11399,10548,10146,402,10146,10146,10551,9839,712,9839
1035,64973,64322,63130,1192,63130,63130,64286,62806,1480,62806
1036,30322,31198,30369,829,30369,30322,31212,30256,956,30256
1037,18849,18867,18847,20,18847,18847,18865,18448,417,18448
1038,333738,333726,315666,18060,315666,315666,333738,315119,18619,315119
1039,10893,11154,10893,261,10893,10893,11149,10768,381,10768
1040,45820,32982,33246,-264,32982,32982,32984,32690,294,32690
1041,34470,35586,34460,1126,34460,34460,35583,34255,1328,34255
1042,26302,25521,25402,119,25402,25402,25529,24884,645,24884
1043,787,392,638,-246,392,392,392,433,-41,433
1044,23194,22484,21942,542,21942,21942,22487,21847,640,21847
1045,12958,12400,12038,362,12038,12038,12398,11921,477,11921
1046,75600,73850,72248,1602,72248,72248,73859,70734,3125,70734
1047,103829,100633,98949,1684,98949,98949,100667,98168,2499,98168
1048,27699,10422,10432,-10,10422,10422,10422,10241,181,10241
1049,1075195,1067420,1003600,63820,1003600,1003600,1067645,1001366,66279,1001366
1050,90891,95389,90975,4414,90975,90891,95411,90891,4520,90891
1051,9777,11600,11278,322,11278,9777,11597,9769,1828,9769
1052,28436,28398,29518,-1120,28398,28398,28412,28532,-120,28436
1053,10254,9722,9578,144,9578,9578,9711,9301,410,9301
1054,40599,40073,38769,1304,38769,38769,40074,38592,1482,38592
1055,1441700,1399776,1325582,74194,1325582,1325582,1400041,1309792,90249,1309792
1056,47958,47459,47939,-480,47459,47459,47492,46866,626,46866
1057,1715,1328,1611,-283,1328,1328,1329,1375,-46,1375
1058,19938,19959,19519,440,19519,19519,19956,18483,1473,18483
1059,14350,14437,14353,84,14353,14350,14436,14201,235,14201
1060,14185,7941,7845,96,7845,7845,7944,7777,167,7777
1061,44160,22421,21550,871,21550,21550,22433,21247,1186,21247
1062,111874,116460,111869,4591,111869,111869,116487,111324,5163,111324
1063,2655,2671,2943,-272,2671,2655,2671,2733,-62,2655
1064,19986,19981,19824,157,19824,19824,19986,19530,456,19530
1065,18712,18716,18453,263,18453,18453,18712,18250,462,18250
1066,954,285,519,-234,285,285,285,332,-47,332
1067,4655,5076,5468,-392,5076,4655,5075,4647,428,4647
1068,1530,1145,1367,-222,1145,1145,1145,1202,-57,1202
1069,8903,8008,7984,24,7984,7984,8009,7914,95,7914
1070,158217,158249,151322,6927,151322,151322,158217,150649,7568,150649
1071,39028,39001,37784,1217,37784,37784,39008,37579,1429,37579
1072,12805,11757,11374,383,11374,11374,11760,11356,404,11356
1073,107881,107851,101184,6667,101184,101184,107881,100684,7197,100684
1074,34454,11814,11643,171,11643,11643,11810,11499,311,11499
1075,5061,4638,4872,-234,4638,4638,4641,4638,3,4638
1076,2773,2347,2526,-179,2347,2347,2347,2373,-26,2373
1077,21933,22307,21516,791,21516,21516,22316,21311,1005,21311
1078,16520,16328,16456,-128,16328,16328,16330,16197,133,16197
1079,12180,11596,11323,273,11323,11323,11599,11216,383,11216
1080,42768,26195,26415,-220,26195,26195,26204,25721,483,25721
1081,22871,22869,22436,433,22436,22436,22871,22209,662,22209
1082,155302,161487,156597,4890,156597,155302,161469,155679,5790,155302
1083,14215,14791,14750,41,14750,14215,14792,14325,467,14215
1084,32758,34007,32377,1630,32377,32377,34015,32216,1799,32216
1085,34513,33471,32429,1042,32429,32429,33489,32067,1422,32067
1086,12106,12109,12202,-93,12109,12106,12106,11968,138,11968
1087,6489,6090,6198,-108,6090,6090,6092,5867,225,5867
1088,97441,97474,93754,3720,93754,93754,97441,89382,8059,89382
1089,4410,3971,4090,-119,3971,3971,3966,3912,54,3912
1090,119791,109078,111286,-2208,109078,109078,109092,108299,793,108299
1091,43444,36974,35182,1792,35182,35182,36986,34025,2961,34025
1092,114197,113365,109625,3740,109625,109625,113357,109155,4202,109155
1093,13353,12878,12733,145,12733,12733,12871,12532,339,12532
1094,21866,20564,19657,907,19657,19657,20567,19288,1279,19288
1095,3131,3129,3320,-191,3129,3129,3131,3124,7,3124
1096,6031,5005,5172,-167,5005,5005,5004,5038,-34,5038
1097,1570,1203,1437,-234,1203,1203,1203,1256,-53,1256
1098,115813,97511,96079,1432,96079,96079,97548,93879,3669,93879
1099,71932,49989,47875,2114,47875,47875,50003,47154,2849,47154
1100,66826,47460,46563,897,46563,46563,47469,46201,1268,46201
1101,63502,62642,61739,903,61739,61739,62655,59715,2940,59715
1102,467991,433878,428861,5017,428861,428861,433878,422409,11469,422409
1103,333444,314460,311807,2653,311807,311807,314609,308370,6239,308370
1104,3557,3137,3302,-165,3137,3137,3140,3137,3,3137
1105,10778,9938,9898,40,9898,9898,9944,9707,237,9707
1106,93091,92200,88989,3211,88989,88989,92270,87903,4367,87903
1107,7270,7172,7205,-33,7172,7172,7174,6944,230,6944
1108,13706,12590,12114,476,12114,12114,12586,11732,854,11732
1109,4074502,4039166,3987935,51231,3987935,3987935,4037816,3962526,75290,3962526
1110,6769,6864,6980,-116,6864,6769,6865,6769,96,6769
1111,32089,33077,31856,1221,31856,31856,33065,31714,1351,31714
1112,176937,174801,160567,14234,160567,160567,174909,155201,19708,155201
1113,1588,463,711,-248,463,463,462,504,-42,504
1114,14744,15826,16025,-199,15826,14744,15830,14736,1094,14736
1115,160697,156022,147220,8802,147220,147220,156060,147009,9051,147009
1116,1144,300,533,-233,300,300,300,343,-43,343
1117,8124,8122,7991,131,7991,7991,8121,7740,381,7740
1118,33594,32211,30689,1522,30689,30689,32210,30465,1745,30465
1119,73783,62047,62344,-297,62047,62047,62054,61519,535,61519
1120,50795,49726,46895,2831,46895,46895,49731,46363,3368,46363
1121,63513,63471,67300,-3829,63471,63471,63465,58665,4800,58665
1122,36771,35846,36288,-442,35846,35846,35864,34830,1034,34830
1123,658913,578244,557147,21097,557147,557147,578247,554615,23632,554615
1124,85113,84154,80262,3892,80262,80262,84171,79181,4990,79181
1125,16492,15427,14819,608,14819,14819,15424,14703,721,14703
1126,18893,18873,18556,317,18556,18556,18876,18271,605,18271
1127,21913,21119,20912,207,20912,20912,21111,19957,1154,19957
1128,32679,34115,33038,1077,33038,32679,34107,32057,2050,32057
1129,13279,12401,12195,206,12195,12195,12403,12011,392,12011
1130,30365,24760,23964,796,23964,23964,24768,23849,919,23849
1131,125756,125761,120205,5556,120205,120205,125756,119348,6408,119348
1132,10924,10930,10868,62,10868,10868,10924,10779,145,10779
1133,21217,8452,8534,-82,8452,8452,8454,8133,321,8133
1134,204570,199658,192752,6906,192752,192752,199537,192291,7246,192291
1135,70477,69511,66633,2878,66633,66633,69513,65961,3552,65961
1136,73960,73001,69898,3103,69898,69898,72944,69494,3450,69494
1137,15419,15429,14722,707,14722,14722,15419,14637,782,14637
1138,2411,1759,2060,-301,1759,1759,1760,1789,-29,1789
1139,4908,4906,5078,-172,4906,4906,4908,4896,12,4896
1140,27056,28295,27401,894,27401,27056,28305,27048,1257,27048
1141,25116,24397,23890,507,23890,23890,24411,23538,873,23538
1142,76280,52580,50154,2426,50154,50154,52584,49643,2941,49643
1143,113621,98043,93828,4215,93828,93828,98034,93688,4346,93688
1144,94201,80147,77709,2438,77709,77709,80168,75927,4241,75927
1145,207783,206611,194095,12516,194095,194095,206680,190633,16047,190633
1146,25343,22169,21627,542,21627,21627,22171,20743,1428,20743
1147,11753,11726,12519,-793,11726,11726,11726,8079,3647,8079
1148,10878,10872,10957,-85,10872,10872,10878,10664,214,10664
1149,3524,3051,3109,-58,3051,3051,3054,2902,152,2902
1150,695,285,519,-234,285,285,285,331,-46,331
1151,63836,55629,54261,1368,54261,54261,55624,53738,1886,53738
1152,1343,1288,1520,-232,1288,1288,1288,1343,-55,1343
1153,5077,4246,4421,-175,4246,4246,4247,3783,464,3783
1154,182296,181480,179003,2477,179003,179003,181538,176253,5285,176253
1155,6241,3060,3224,-164,3060,3060,3059,3106,-47,3106
1156,1719,1153,1422,-269,1153,1153,1154,1200,-46,1200
1157,20934,20387,19772,615,19772,19772,20380,19684,696,19684
1158,3228043,3174370,3021137,153233,3021137,3021137,3176666,3008527,168139,3008527
1159,11923,11855,12027,-172,11855,11855,11862,11559,303,11559
1160,53952,53855,53295,560,53295,53295,53887,52549,1338,52549
1161,841,606,841,-235,606,606,605,653,-48,653
1162,17782,18266,17716,550,17716,17716,18269,17240,1029,17240
1163,13542,13537,13484,53,13484,13484,13542,13078,464,13078
1164,7569,7566,7730,-164,7566,7566,7569,7462,107,7462
1165,6006,4903,5053,-150,4903,4903,4903,4921,-18,4921
1166,4912,4075,4242,-167,4075,4075,4074,4020,54,4020
1167,24195,23000,21316,1684,21316,21316,23013,20743,2270,20743
1168,168627,150954,147776,3178,147776,147776,150908,140107,10801,140107
1169,4278,3512,3557,-45,3512,3512,3513,3193,320,3193
1170,7361,7371,7301,70,7301,7301,7368,7140,228,7140
1171,41533,41548,40666,882,40666,40666,41533,40470,1063,40470
1172,11188,11188,11380,-192,11188,11188,11188,11119,69,11119
1173,64610,64641,62225,2416,62225,62225,64610,61885,2725,61885
1174,17911,17907,17671,236,17671,17671,17911,17545,366,17545
1175,20470,21096,20399,697,20399,20399,21102,19863,1239,19863
1176,60226,59397,56919,2478,56919,56919,59385,53683,5702,53683
1177,101166,101662,101139,523,101139,101139,101659,97777,3882,97777
1178,13827,14534,14236,298,14236,13827,14536,13892,644,13827
1179,19462,19460,19039,421,19039,19039,19462,18937,525,18937
1180,22837,22413,21956,457,21956,21956,22416,21796,620,21796
1181,51676,51648,51202,446,51202,51202,51676,50797,879,50797
1182,203417,184271,177177,7094,177177,177177,184224,175164,9060,175164
1183,30991,32082,31025,1057,31025,30991,32084,30911,1173,30911
1184,4565,3643,3832,-189,3643,3643,3642,3610,32,3610
1185,5630,5627,5831,-204,5627,5627,5630,5466,164,5466
1186,245404,244877,229648,15229,229648,229648,244826,227707,17119,227707
1187,3278,3337,3394,-57,3337,3278,3338,3156,182,3156
1188,55194,58445,55134,3311,55134,55134,58470,54511,3959,54511
1189,325345,280929,267359,13570,267359,267359,280908,265889,15019,265889
1190,215183,211689,203426,8263,203426,203426,211569,203044,8525,203044
1191,4384,3875,3955,-80,3875,3875,3869,3738,131,3738
1192,61430,36065,34807,1258,34807,34807,36051,34132,1919,34132
1193,11799,11803,11742,61,11742,11742,11804,11467,337,11467
1194,51820,52436,52095,341,52095,51820,52439,51914,525,51820
1195,62920,66367,65528,839,65528,62920,66407,63474,2933,62920
1196,17215,17221,16570,651,16570,16570,17215,15856,1359,15856
1197,210908,207353,200905,6448,200905,200905,207323,198885,8438,198885
1198,255308,255180,253117,2063,253117,253117,255144,250577,4567,250577
1199,182147,182173,175133,7040,175133,175133,182147,173495,8652,173495
1200,1484,1236,1484,-248,1236,1236,1238,1295,-57,1295
1201,672,379,611,-232,379,379,379,426,-47,426
1202,77711,41501,40827,674,40827,40827,41512,40400,1112,40400
1203,302348,272981,249372,23609,249372,249372,272992,243468,29524,243468
1204,7594,6736,6665,71,6665,6665,6736,6578,158,6578
1205,104758,104620,100049,4571,100049,100049,104624,99538,5086,99538
1206,26482,25882,25710,172,25710,25710,25884,25057,827,25057
1207,4094,3561,3701,-140,3561,3561,3560,3600,-40,3600
1208,12539,12098,11855,243,11855,11855,12102,11735,367,11735
1209,15638,15637,15367,270,15367,15367,15638,15117,521,15117
1210,12002,12006,11859,147,11859,11859,12002,11595,407,11595
1211,18569,18565,17976,589,17976,17976,18569,17827,742,17827
1212,15875,15880,15586,294,15586,15586,15875,15394,481,15394
1213,33088,12575,12755,-180,12575,12575,12579,12464,115,12464
1214,10686,10691,10758,-67,10691,10686,10686,10528,158,10528
1215,16953,16956,16572,384,16572,16572,16953,16407,546,16407
1216,14543,14538,14332,206,14332,14332,14543,14122,421,14122
1217,17566,17566,17327,239,17327,17327,17566,17129,437,17129
1218,13339,13338,13340,-2,13338,13338,13339,13129,210,13129
1219,12943,12937,12894,43,12894,12894,12943,12643,300,12643
1220,210964,219885,214627,5258,214627,210964,219828,212480,7348,210964
1221,19296,19295,18936,359,18936,18936,19296,18724,572,18724
1222,12316,12312,12376,-64,12312,12312,12316,12104,212,12104
1223,642037,598336,571279,27057,571279,571279,598394,559666,38728,559666
1224,33075,32275,31747,528,31747,31747,32282,31428,854,31428
1225,8218,7579,7623,-44,7579,7579,7581,7543,38,7543
1226,630124,623247,594689,28558,594689,594689,623252,589851,33401,589851
1227,35816,35049,34249,800,34249,34249,35073,33768,1305,33768
1228,14293,13461,13398,63,13398,13398,13457,13252,205,13252
1229,20031,16699,16357,342,16357,16357,16700,15190,1510,15190
1230,204068,204912,200731,4181,200731,200731,204948,198695,6253,198695
1231,122209,121175,118764,2411,118764,118764,121154,116726,4428,116726
1232,13419,12860,12929,-69,12860,12860,12865,12685,180,12685
1233,2643,1761,1926,-165,1761,1761,1762,1782,-20,1782
1234,15108,2003,2273,-270,2003,2003,2005,2012,-7,2012
1235,62583,59436,56930,2506,56930,56930,59434,56430,3004,56430
1236,7292,7289,7379,-90,7289,7289,7292,7185,107,7185
1237,19699,18834,19365,-531,18834,18834,18842,18756,86,18756
1238,5096,4218,4341,-123,4218,4218,4214,4207,7,4207
1239,3791,3309,3459,-150,3309,3309,3311,3189,122,3189
1240,183419,165935,168956,-3021,165935,165935,165972,162555,3417,162555
1241,14368,13418,12879,539,12879,12879,13406,12725,681,12725
1242,24543,23668,22425,1243,22425,22425,23652,22325,1327,22325
1243,4684,4685,4768,-83,4685,4684,4684,4559,125,4559
1244,21961,21329,21346,-17,21329,21329,21326,20972,354,20972
1245,1883,904,1146,-242,904,904,902,959,-57,959
1246,1883,958,1182,-224,958,958,958,1005,-47,1005
1247,1136,748,1001,-253,748,748,748,801,-53,801
1248,362516,376186,362429,13757,362429,362429,376089,358508,17581,358508
1249,19625,18235,17421,814,17421,17421,18240,17311,929,17311
1250,3215,3214,3494,-280,3214,3214,3215,3142,73,3142
1251,30485,27366,27295,71,27295,27295,27364,27015,349,27015
1252,56810,55874,52982,2892,52982,52982,55852,52424,3428,52424
1253,189942,188999,175843,13156,175843,175843,188994,172435,16559,172435
1254,1692,1691,1887,-196,1691,1691,1692,1670,22,1670
1255,73400,70753,67045,3708,67045,67045,70761,65381,5380,65381
1256,36335,32519,29482,3037,29482,29482,32524,29256,3268,29256
1257,1657,1606,1879,-273,1606,1606,1605,1639,-34,1639
1258,55395,55402,52489,2913,52489,52489,55395,52334,3061,52334
1259,88249,92437,88267,4170,88267,88249,92471,87628,4843,87628
1260,123185,122267,118942,3325,118942,118942,122327,117931,4396,117931
1261,45981,45111,43898,1213,43898,43898,45160,42010,3150,42010
1262,6654,6187,6107,80,6107,6107,6186,6030,156,6030
1263,9656,9160,9104,56,9104,9104,9165,9012,153,9012
1264,100797,100742,97883,2859,97883,97883,100761,92802,7959,92802
1265,66698,65673,64535,1138,64535,64535,65654,64363,1291,64363
1266,108537,109663,107964,1699,107964,107964,109724,106808,2916,106808
1267,33976,34281,33610,671,33610,33610,34298,33354,944,33354
1268,15398,2397,2616,-219,2397,2397,2397,2434,-37,2434
1269,51728,2447,2584,-137,2447,2447,2448,2326,122,2326
1270,232649,214676,204460,10216,204460,204460,214712,202751,11961,202751
1271,566191,565063,546291,18772,546291,546291,565343,540987,24356,540987
1272,69300,70117,70269,-152,70117,69300,70145,69292,853,69292
1273,28579,22009,21796,213,21796,21796,22022,21617,405,21617
1274,4801,3954,4074,-120,3954,3954,3957,3956,1,3956
1275,9601,9178,9212,-34,9178,9178,9182,9028,154,9028
1276,182083,181230,178533,2697,178533,178533,181237,175730,5507,175730
1277,27063,28383,27004,1379,27004,27004,28385,26881,1504,26881
1278,3203,2264,2490,-226,2264,2264,2265,2298,-33,2298
1279,44620,38550,36506,2044,36506,36506,38568,36384,2184,36384
1280,4474,3569,3807,-238,3569,3569,3568,3641,-73,3641
1281,6763,6760,6881,-121,6760,6760,6763,6684,79,6684
1282,103858,104351,106688,-2337,104351,103858,104388,104894,-506,103858
1283,13397,12540,12861,-321,12540,12540,12544,12522,22,12522
1284,3969,3984,4268,-284,3984,3969,3985,3962,23,3962
1285,30316,29486,29323,163,29323,29323,29493,27670,1823,27670
1286,168399,155496,146751,8745,146751,146751,155474,145658,9816,145658
1287,46452,45615,45472,143,45472,45472,45614,44896,718,44896
1288,10242,10220,10446,-226,10220,10220,10225,10250,-25,10242
1289,36590,35970,35463,507,35463,35463,35968,35212,756,35212
1290,101471,101422,100727,695,100727,100727,101471,99140,2331,99140
1291,9377,9441,9376,65,9376,9376,9443,9250,193,9250
1292,89175,91800,89905,1895,89905,89175,91820,89167,2653,89167
1293,15257,14411,14228,183,14228,14228,14420,12855,1565,12855
1294,30671,31289,30671,618,30671,30671,31297,30502,795,30502
1295,63504,68358,63443,4915,63443,63443,68336,62830,5506,62830
1296,132639,132414,128604,3810,128604,128604,132426,126342,6084,126342
1297,128710,126286,125679,607,125679,125679,126361,124035,2326,124035
1298,64121,63255,61683,1572,61683,61683,63270,61138,2132,61138
1299,72933,48811,47069,1742,47069,47069,48812,46285,2527,46285
1300,64318,63708,61144,2564,61144,61144,63714,60921,2793,60921
1301,1803,1490,1715,-225,1490,1490,1489,1547,-58,1547
1302,13350,12565,12376,189,12376,12376,12566,12256,310,12256
1303,293308,315499,293270,22229,293270,293270,315584,290861,24723,290861
1304,6196,5689,5778,-89,5689,5689,5690,5580,110,5580
1305,157012,148453,138958,9495,138958,138958,148464,138178,10286,138178
1306,23046,22093,20956,1137,20956,20956,22089,20865,1224,20865
1307,248708,247739,233052,14687,233052,233052,247716,230002,17714,230002
1308,5120,1052,1301,-249,1052,1052,1052,1107,-55,1107
1309,2346,1856,2122,-266,1856,1856,1856,1911,-55,1911
1310,192414,204210,197692,6518,197692,192414,204216,191792,12424,191792
1311,20760,23547,23499,48,23499,20760,23550,20138,3412,20138
1312,135278,133991,129569,4422,129569,129569,134001,128959,5042,128959
1313,231971,230942,225669,5273,225669,225669,231006,222628,8378,222628
1314,38165,39637,38075,1562,38075,38075,39633,37698,1935,37698
1315,1248,1176,1408,-232,1176,1176,1175,1208,-33,1208
1316,73015,72164,71143,1021,71143,71143,72174,70413,1761,70413
1317,3553,2612,2832,-220,2612,2612,2614,2685,-71,2685
1318,18380,18341,17777,564,17777,17777,18347,17564,783,17564
1319,113369,118954,112751,6203,112751,112751,118960,112386,6574,112386
1320,144160,143150,139866,3284,139866,139866,143152,138598,4554,138598
1321,17519,17053,17187,-134,17053,17053,17053,16897,156,16897
1322,17796,1653,2191,-538,1653,1653,1651,2186,-535,2186
1323,1083,845,1083,-238,845,845,845,895,-50,895
1324,33761,33757,33114,643,33114,33114,33761,32117,1644,32117
1325,53490,52596,50174,2422,50174,50174,52568,49641,2927,49641
1326,444718,432934,398120,34814,398120,398120,433059,394966,38093,394966
1327,10509,10511,10586,-75,10511,10509,10509,10351,158,10351
1328,39766,39046,38219,827,38219,38219,39040,37888,1152,37888
1329,18083,17304,17695,-391,17304,17304,17313,17307,6,17307
1330,10168,10157,10132,25,10132,10132,10168,9819,349,9819
1331,1064739,1033541,992830,40711,992830,992830,1033733,987376,46357,987376
1332,8105,8390,8272,118,8272,8105,8389,7483,906,7483
1333,45912,38144,36958,1186,36958,36958,38163,36166,1997,36166
1334,24715,5879,6127,-248,5879,5879,5879,3427,2452,3427
1335,14182,12702,12206,496,12206,12206,12703,11584,1119,11584
1336,156181,153322,145331,7991,145331,145331,153297,144998,8299,144998
1337,34089,34095,33697,398,33697,33697,34089,33589,500,33589
1338,5976,5911,5845,66,5845,5845,5912,5674,238,5674
1339,30887,30889,29835,1054,29835,29835,30887,29725,1162,29725
1340,13459,11840,11772,68,11772,11772,11839,11717,122,11717
1341,37306,33057,31577,1480,31577,31577,33055,30994,2061,30994
1342,126411,104180,102161,2019,102161,102161,104195,100339,3856,100339
1343,3152,3115,3348,-233,3115,3115,3116,3190,-74,3152
1344,19491,17163,15894,1269,15894,15894,17161,15721,1440,15721
1345,418435,372698,353587,19111,353587,353587,372605,352026,20579,352026
1346,7458,7453,7618,-165,7453,7453,7458,7376,82,7376
1347,113638,116486,113606,2880,113606,113606,116490,112178,4312,112178
1348,35209,34275,34093,182,34093,34093,34272,33581,691,33581
1349,3741,3724,3894,-170,3724,3724,3723,3753,-30,3741
1350,32446,31056,29142,1914,29142,29142,31062,28604,2458,28604
1351,3652,3650,3736,-86,3650,3650,3652,3578,74,3578
1352,368300,355395,338246,17149,338246,338246,355532,334311,21221,334311
1353,9620,9162,9165,-3,9162,9162,9162,8999,163,8999
1354,176073,162199,153180,9019,153180,153180,162235,150340,11895,150340
1355,136265,136267,133124,3143,133124,133124,136265,128841,7424,128841
1356,16646,16652,16483,169,16483,16483,16646,16299,347,16299
1357,4996,4083,4283,-200,4083,4083,4084,4097,-13,4097
1358,58163,58145,58061,84,58061,58061,58163,57302,861,57302
1359,844598,853920,860788,-6868,853920,844598,854209,851139,3070,844598
1360,455,456,693,-237,456,455,455,505,-50,455
1361,33723,32581,31630,951,31630,31630,32583,31270,1313,31270
1362,20786,21190,20948,242,20948,20786,21195,20778,417,20778
1363,48853,48868,48237,631,48237,48237,48853,47542,1311,47542
1364,36277,35594,35516,78,35516,35516,35587,34931,656,34931
1365,36665,36911,36600,311,36600,36600,36915,35966,949,35966
1366,35060,34351,32280,2071,32280,32280,34350,32190,2160,32190
1367,124982,124072,115313,8759,115313,115313,124144,110864,13280,110864
1368,14013,14208,14194,14,14194,14013,14202,14014,188,14013
1369,13904,13381,13131,250,13131,13131,13378,12969,409,12969
1370,2869,2905,3015,-110,2905,2869,2903,2844,59,2844
1371,13269,12126,11694,432,11694,11694,12132,11113,1019,11113
1372,1752,912,1160,-248,912,912,911,967,-56,967
1373,31787,13875,13488,387,13488,13488,13878,13254,624,13254
1374,555952,555886,529549,26337,529549,529549,555791,525172,30619,525172
1375,12718,11835,12330,-495,11835,11835,11847,11881,-34,11881
1376,2012,1902,2092,-190,1902,1902,1902,1912,-10,1912
1377,10855,10821,10865,-44,10821,10821,10831,10685,146,10685
1378,30881,31922,31285,637,31285,30881,31933,31012,921,30881
1379,56966,54221,50488,3733,50488,50488,54228,50384,3844,50384
1380,166089,165780,164425,1355,164425,164425,165873,161228,4645,161228
1381,4065,3221,3432,-211,3221,3221,3221,3187,34,3187
1382,83710,87443,84164,3279,84164,83710,87456,83787,3669,83710
1383,167545,136701,134234,2467,134234,134234,136752,132792,3960,132792
1384,599471,502905,512807,-9902,502905,502905,502564,501866,698,501866
1385,14942,14942,14846,96,14846,14846,14942,14597,345,14597
1386,87088,86161,81267,4894,81267,81267,86154,80131,6023,80131
1387,4427,3948,4163,-215,3948,3948,3949,3805,144,3805
1388,3240,3241,3502,-261,3241,3240,3240,3281,-41,3240
1389,49633,29064,28420,644,28420,28420,29075,28082,993,28082
1390,8775,8775,8570,205,8570,8570,8775,8454,321,8454
1391,50489,33175,32065,1110,32065,32065,33191,31794,1397,31794
1392,47648,46363,45159,1204,45159,45159,46364,44753,1611,44753
1393,2339,1423,1599,-176,1423,1423,1423,1444,-21,1444
1394,39398,39312,38848,464,38848,38848,39337,38374,963,38374
1395,801990,726202,673358,52844,673358,673358,726015,666906,59109,666906
1396,17306,17312,16945,367,16945,16945,17306,16454,852,16454
1397,15323,14092,13859,233,13859,13859,14081,13286,795,13286
1398,31622,32793,31562,1231,31562,31562,32803,31466,1337,31466
1399,42669,41384,40144,1240,40144,40144,41385,39968,1417,39968
1400,116830,123013,116817,6196,116817,116817,122977,116185,6792,116185
1401,198723,197864,194467,3397,194467,194467,197816,189328,8488,189328
1402,13383,12909,12769,140,12769,12769,12909,12607,302,12607
1403,13477,13640,13472,168,13472,13472,13647,13148,499,13148
1404,100365,106621,102028,4593,102028,100365,106616,100301,6315,100301
1405,70983,70170,67423,2747,67423,67423,70219,66896,3323,66896
1406,16357,15015,14178,837,14178,14178,15016,12435,2581,12435
1407,6172,5980,5862,118,5862,5862,5982,5745,237,5745
1408,37697,18939,18688,251,18688,18688,18961,18221,740,18221
1409,48376,51511,48778,2733,48778,48376,51514,48354,3160,48354
1410,4827,4183,4238,-55,4183,4183,4183,4141,42,4141
1411,3582991,3014474,2799846,214628,2799846,2799846,3014190,2738677,275513,2738677
1412,21940,21098,20980,118,20980,20980,21102,20751,351,20751
1413,9715,9698,9938,-240,9698,9698,9697,9617,80,9617
1414,20607,21040,20784,256,20784,20607,21042,20572,470,20572
1415,7889,7095,7444,-349,7095,7095,7099,6905,194,6905
1416,32184,32340,32185,155,32185,32184,32348,30562,1786,30562
1417,2514,2462,2656,-194,2462,2462,2463,2473,-10,2473
1418,7624,7945,8081,-136,7945,7624,7947,7626,321,7624
1419,8238,8021,8173,-152,8021,8021,8028,7900,128,7900
1420,37780,36917,35918,999,35918,35918,36910,35387,1523,35387
1421,235466,235562,232429,3133,232429,232429,235466,230001,5465,230001
1422,17479,15711,15433,278,15433,15433,15712,15348,364,15348
1423,12473,12803,12410,393,12410,12410,12807,12071,736,12071
1424,3873,2962,3180,-218,2962,2962,2962,3014,-52,3014
1425,785,803,1024,-221,803,785,803,851,-48,785
1426,24080,24795,25312,-517,24795,24080,24807,24072,735,24072
1427,121782,119458,115455,4003,115455,115455,119476,115088,4388,115088
1428,146085,163725,154180,9545,154180,146085,163858,145463,18395,145463
1429,204019,203103,197234,5869,197234,197234,203130,194391,8739,194391
1430,142867,142605,138910,3695,138910,138910,142597,136017,6580,136017
1431,244685,222586,214634,7952,214634,214634,222563,213006,9557,213006
1432,29504,27537,25942,1595,25942,25942,27558,25806,1752,25806
1433,8952,8483,8373,110,8373,8373,8482,8226,256,8226
1434,4175,4172,4517,-345,4172,4172,4175,4253,-78,4175
1435,22519,22725,22645,80,22645,22519,22728,22511,217,22511
1436,338062,337034,325659,11375,325659,325659,337097,323330,13767,323330
1437,117601,116003,112090,3913,112090,112090,116016,111619,4397,111619
1438,72279,72283,68273,4010,68273,68273,72279,67817,4462,67817
1439,300237,300217,284621,15596,284621,284621,300255,278949,21306,278949
1440,11008,11218,11236,-18,11218,11008,11215,10980,235,10980
1441,1347543,1346945,1275843,71102,1275843,1275843,1347543,1271874,75669,1271874
1442,9421,8580,8670,-90,8580,8580,8581,8549,32,8549
1443,112185,111268,109402,1866,109402,109402,111256,100921,10335,100921
1444,3131,3327,3504,-177,3327,3131,3328,3123,205,3123
1445,59327,62358,59252,3106,59252,59252,62397,58471,3926,58471
1446,560158,560264,537580,22684,537580,537580,560158,535859,24299,535859
1447,6700,6663,6803,-140,6663,6663,6667,6392,275,6392
1448,222876,211256,198957,12299,198957,198957,211165,198788,12377,198788
1449,22388,23827,22378,1449,22378,22378,23845,22312,1533,22312
1450,3674,3672,3777,-105,3672,3672,3674,3636,38,3636
1451,1136,759,996,-237,759,759,758,803,-45,803
1452,14417,14416,14388,28,14388,14388,14417,14115,302,14115
1453,24852,26415,24850,1565,24850,24850,26402,24764,1638,24764
1454,6927,6002,6006,-4,6002,6002,6002,5686,316,5686
1455,51201,53485,52232,1253,52232,51201,53495,51201,2294,51201
1456,11584,11582,11616,-34,11582,11582,11584,11399,185,11399
1457,17638,17568,17438,130,17438,17438,17577,17123,454,17123
1458,67513,71509,67491,4018,67491,67491,71505,66336,5169,66336
1459,143671,133939,131498,2441,131498,131498,133986,129799,4187,129799
1460,11614,532,792,-260,532,532,532,588,-56,588
1461,2545,2484,2665,-181,2484,2484,2484,2441,43,2441
1462,116897,116959,111859,5100,111859,111859,116897,111759,5138,111759
1463,2770,1235,1441,-206,1235,1235,1234,1281,-47,1281
1464,19645,19066,18489,577,18489,18489,19063,18393,670,18393
1465,4676,4189,4295,-106,4189,4189,4189,4124,65,4124
1466,11026,10188,10187,1,10187,10187,10188,9349,839,9349
1467,367297,366051,359488,6563,359488,359488,365970,355096,10874,355096
1468,43020,24281,24441,-160,24281,24281,24290,24045,245,24045
1469,24302,24303,23038,1265,23038,23038,24302,22980,1322,22980
1470,91038,95478,94585,893,94585,91038,95479,91578,3901,91038
1471,37292,37278,36940,338,36940,36940,37284,36085,1199,36085
1472,243114,159516,144676,14840,144676,144676,159591,121847,37744,121847
1473,216129,216073,203868,12205,203868,203868,216125,201291,14834,201291
1474,10586,10536,10660,-124,10536,10536,10534,10411,123,10411
1475,21509,9541,9688,-147,9541,9541,9548,9483,65,9483
1476,9673,8833,9075,-242,8833,8833,8833,4608,4225,4608
1477,582880,582142,569143,12999,569143,569143,581900,560553,21347,560553
1478,147826,146863,139255,7608,139255,139255,146891,138716,8175,138716
1479,104601,104594,101830,2764,101830,101830,104601,101567,3034,101567
1480,1214,1214,1448,-234,1214,1214,1214,1093,121,1093
1481,97986,93513,91053,2460,91053,91053,93533,90436,3097,90436
1482,49370,49371,47760,1611,47760,47760,49370,47384,1986,47384
1483,3825,3626,3825,-199,3626,3626,3629,3621,8,3621
1484,30548,32483,30491,1992,30491,30491,32483,30260,2223,30260
1485,30573,30577,29640,937,29640,29640,30589,29358,1231,29358
1486,170766,150210,143502,6708,143502,143502,150276,142241,8035,142241
1487,2081,1597,1843,-246,1597,1597,1598,1659,-61,1659
1488,22471,22214,22473,-259,22214,22214,22216,21983,233,21983
1489,21967,20020,19029,991,19029,19029,20026,18627,1399,18627
1490,22125,9320,9232,88,9232,9232,9322,8942,380,8942
1491,5552,5020,5218,-198,5020,5020,5020,4972,48,4972
1492,80311,77691,75214,2477,75214,75214,77709,72770,4939,72770
1493,14184,14129,13981,148,13981,13981,14127,13804,323,13804
1494,247045,246100,240191,5909,240191,240191,246219,239253,6966,239253
1495,24703,3376,3584,-208,3376,3376,3384,3387,-3,3387
1496,3912,1253,1523,-270,1253,1253,1252,1281,-29,1281
1497,3430778,3338493,3168777,169716,3168777,3168777,3338914,3164105,174809,3164105
1498,197800,196736,187871,8865,187871,187871,196844,186762,10082,186762
1499,3193,3194,3342,-148,3194,3193,3193,3180,13,3180
1500,86134,81797,83714,-1917,81797,81797,81840,82030,-190,82030
1501,3661,3660,3798,-138,3660,3660,3661,3586,75,3586
1502,55391,54541,53438,1103,53438,53438,54572,53081,1491,53081
1503,1715,829,1069,-240,829,829,829,884,-55,884
1504,13650,12671,12291,380,12291,12291,12663,11991,672,11991
1505,48666,35559,34656,903,34656,34656,35564,34123,1441,34123
1506,148113,147172,135381,11791,135381,135381,147195,128553,18642,128553
1507,15614,14375,14550,-175,14375,14375,14391,14189,202,14189
1508,40870,25771,24979,792,24979,24979,25765,24898,867,24898
1509,9833,8990,8861,129,8861,8861,8991,8665,326,8665
1510,15071,14573,14450,123,14450,14450,14566,14257,309,14257
1511,17976,17360,16748,612,16748,16748,17360,16652,708,16652
1512,297545,297289,292034,5255,292034,292034,297306,289876,7430,289876
1513,7508,6823,6951,-128,6823,6823,6825,6792,33,6792
1514,13774,13739,13689,50,13689,13689,13742,12836,906,12836
1515,99547,98714,95471,3243,95471,95471,98746,94722,4024,94722
1516,27373,26519,25716,803,25716,25716,26533,25522,1011,25522
1517,5493,5043,5144,-101,5043,5043,5043,4947,96,4947
1518,37381,39874,37354,2520,37354,37354,39888,36408,3480,36408
1519,18675,17904,18139,-235,17904,17904,17910,17718,192,17718
1520,4273,4212,4434,-222,4212,4212,4213,4265,-52,4265
1521,474479,451991,433733,18258,433733,433733,452024,429602,22422,429602
1522,120255,100077,95973,4104,95973,95973,100119,95709,4410,95709
1523,11946,10746,10918,-172,10746,10746,10750,10635,115,10635
1524,20260,19439,19710,-271,19439,19439,19439,19255,184,19255
1525,24123,24097,23549,548,23549,23549,24106,23369,737,23369
1526,207877,206932,198527,8405,198527,198527,206945,196699,10246,196699
1527,151043,149420,146568,2852,146568,146568,149479,145642,3837,145642
1528,5287,5265,5374,-109,5265,5265,5270,5202,68,5202
1529,167058,167086,165264,1822,165264,165264,167058,162394,4664,162394
1530,81612,78012,76264,1748,76264,76264,78030,73641,4389,73641
1531,77725,59692,57578,2114,57578,57578,59687,57186,2501,57186
1532,9269,9086,9262,-176,9086,9086,9090,9037,53,9037
1533,48100,47728,47585,143,47585,47585,47738,46624,1114,46624
1534,53268,53102,53261,-159,53102,53102,53132,52772,360,52772
1535,85906,90746,88548,2198,88548,85906,90766,86525,4241,85906
1536,54522,53962,52971,991,52971,52971,53968,39970,13998,39970
1537,15319,14939,14706,233,14706,14706,14938,14519,419,14519
1538,7324,7330,7495,-165,7330,7324,7324,7277,47,7277
1539,16953,16959,16678,281,16678,16678,16953,16536,417,16536
1540,20015,20462,20018,444,20018,20015,20466,19120,1346,19120
1541,70391,70358,68287,2071,68287,68287,70344,68037,2307,68037
1542,34715,34708,33515,1193,33515,33515,34715,32956,1759,32956
1543,214886,193512,179669,13843,179669,179669,193601,179286,14315,179286
1544,82228,80735,79188,1547,79188,79188,80757,78933,1824,78933
1545,26728,25796,24954,842,24954,24954,25807,24414,1393,24414
1546,20175,20137,20363,-226,20137,20137,20152,19914,238,19914
1547,8202,7852,7872,-20,7852,7852,7849,7688,161,7688
1548,91017,61337,58594,2743,58594,58594,61340,58362,2978,58362
1549,3397,3023,3334,-311,3023,3023,3022,3018,4,3018
1550,74778,70064,67072,2992,67072,67072,70050,66134,3916,66134
1551,13097,13098,12946,152,12946,12946,13097,12813,284,12813
1552,237001,204822,196429,8393,196429,196429,204856,194798,10058,194798
1553,748508,54525,50748,3777,50748,50748,54521,47685,6836,47685
1554,8567,6086,6160,-74,6086,6086,6088,5947,141,5947
1555,91285,82952,79081,3871,79081,79081,82955,78304,4651,78304
1556,8732,7917,7862,55,7862,7862,7915,7749,166,7749
1557,190118,196999,191726,5273,191726,190118,196979,190118,6861,190118
1558,29564,29721,29575,146,29575,29564,29720,28942,778,28942
1559,76250,81790,81764,26,81764,76250,81862,78368,3494,76250
1560,241102,246977,243617,3360,243617,241102,247037,241094,5943,241094
1561,160021,170638,161061,9577,161061,160021,170633,158217,12416,158217
1562,70373,70272,67587,2685,67587,67587,70297,66834,3463,66834
1563,13790,13685,13413,272,13413,13413,13680,13273,407,13273
1564,39324,14636,14616,20,14616,14616,14635,14258,377,14258
1565,23855,22925,22390,535,22390,22390,22916,22212,704,22212
1566,125711,115538,110664,4874,110664,110664,115566,109375,6191,109375
1567,92024,65595,62391,3204,62391,62391,65590,61683,3907,61683
1568,4512,4511,4595,-84,4511,4511,4512,4377,135,4377
1569,17347,17606,17801,-195,17606,17347,17610,16725,885,16725
1570,10114,10092,10074,18,10074,10074,10097,9909,188,9909
1571,55965,41460,39309,2151,39309,39309,41471,39293,2178,39293
1572,354395,355349,361165,-5816,355349,354395,355512,354387,1125,354387
1573,57545,59389,57530,1859,57530,57530,59407,56891,2516,56891
1574,35437,27414,26689,725,26689,26689,27400,26557,843,26557
1575,55429,52989,53455,-466,52989,52989,52995,52414,581,52414
1576,33461,33457,33204,253,33204,33204,33461,32876,585,32876
1577,43550,43534,43602,-68,43534,43534,43542,42971,571,42971
1578,20174,22131,21487,644,21487,20174,22133,20372,1761,20174
1579,12208,12091,12158,-67,12091,12091,12101,11976,125,11976
1580,15125,4519,4600,-81,4519,4519,4520,4484,36,4484
1581,295996,294920,290377,4543,290377,290377,295103,286672,8431,286672
1582,61483,62384,61445,939,61445,61445,62416,60919,1497,60919
1583,25690,24783,24705,78,24705,24705,24776,24211,565,24211
1584,7281,6954,7038,-84,6954,6954,6950,6903,47,6903
1585,155226,84381,79520,4861,79520,79520,84432,77141,7291,77141
1586,31075,31057,30395,662,30395,30395,31075,29991,1084,29991
1587,6699,6743,6699,44,6699,6699,6748,6418,330,6418
1588,39899,33733,32282,1451,32282,32282,33759,31869,1890,31869
1589,34961,36061,34958,1103,34958,34958,36049,34742,1307,34742
1590,15485,15445,15385,60,15385,15385,15446,15162,284,15162
1591,43024,41265,39049,2216,39049,39049,41316,38990,2326,38990
1592,2106,2110,2250,-140,2110,2106,2106,2088,18,2088
1593,18893,17768,18455,-687,17768,17768,17771,17867,-96,17867
1594,70283,56926,56446,480,56446,56446,56935,55546,1389,55546
1595,56352,46355,45883,472,45883,45883,46369,45008,1361,45008
1596,7050,7398,7540,-142,7398,7050,7396,7116,280,7050
1597,4182,3340,3422,-82,3340,3340,3339,3129,210,3129
1598,24258,24247,23402,845,23402,23402,24258,23359,899,23359
1599,48808,47960,47257,703,47257,47257,47978,42457,5521,42457
1600,8487,8651,8429,222,8429,8429,8652,7865,787,7865
1601,79287,78316,79653,-1337,78316,78316,78355,77106,1249,77106
1602,92833,89245,85104,4141,85104,85104,89264,84753,4511,84753
1603,51848,48630,46704,1926,46704,46704,48652,46223,2429,46223
1604,30405,31751,30507,1244,30507,30405,31763,30359,1404,30359
1605,26747,25952,25124,828,25124,25124,25967,25074,893,25074
1606,1810,1810,2017,-207,1810,1810,1810,1833,-23,1810
1607,148032,147033,143758,3275,143758,143758,147044,142840,4204,142840
1608,6963,6423,6337,86,6337,6337,6422,6184,238,6184
1609,9291,8865,8903,-38,8865,8865,8871,8713,158,8713
1610,29864,29842,29607,235,29607,29607,29852,28959,893,28959
1611,14797,4059,4123,-64,4059,4059,4055,4003,52,4003
1612,232584,229597,220426,9171,220426,220426,229437,212211,17226,212211
1613,53905,56511,53887,2624,53887,53887,56490,53870,2620,53870
1614,384319,275805,269628,6177,269628,269628,275800,240579,35221,240579
1615,343794,347480,343802,3678,343802,343794,347501,339823,7678,339823
1616,117076,112961,111620,1341,111620,111620,113002,110224,2778,110224
1617,47820,23792,23980,-188,23792,23792,23801,23455,346,23455
1618,553750,552649,524580,28069,524580,524580,552612,512446,40166,512446
1619,10534,10493,10721,-228,10493,10493,10494,10131,363,10131
1620,3714,3122,3358,-236,3122,3122,3123,3045,78,3045
1621,7131,7103,7118,-15,7103,7103,7105,6852,253,6852
1622,10188,9571,9779,-208,9571,9571,9568,9566,2,9566
1623,40450,13068,12517,551,12517,12517,13069,11600,1469,11600
1624,4651,4625,4735,-110,4625,4625,4627,4619,8,4619
1625,22245,20339,19437,902,19437,19437,20353,19311,1042,19311
1626,43054,42306,41250,1056,41250,41250,42307,41001,1306,41001
1627,4057,3214,3387,-173,3214,3214,3214,3208,6,3208
1628,738506,723806,693514,30292,693514,693514,723699,689354,34345,689354
1629,3616,2771,2865,-94,2771,2771,2774,2564,210,2564
1630,3005,2635,2780,-145,2635,2635,2635,2618,17,2618
1631,57302,56504,56216,288,56216,56216,56507,55535,972,55535
1632,106805,112132,107479,4653,107479,106805,112134,106797,5337,106797
1633,1766,1772,2016,-244,1772,1766,1771,1809,-38,1766
1634,8957,8895,8832,63,8832,8832,8896,8674,222,8674
1635,5638,5203,5268,-65,5203,5203,5202,5108,94,5108
1636,62762,36953,36080,873,36080,36080,36948,34888,2060,34888
1637,77623,80572,78252,2320,78252,77623,80587,77615,2972,77615
1638,13441,13765,13459,306,13459,13441,13756,13269,487,13269
1639,4672924,4565691,4324202,241489,4324202,4324202,4564255,4283605,280650,4283605
1640,9481,9473,9798,-325,9473,9473,9481,9535,-54,9481
1641,72490,6946,6846,100,6846,6846,6954,6758,196,6758
1642,156764,160767,156754,4013,156754,156754,160767,155958,4809,155958
1643,8940,8998,8944,54,8944,8940,9000,8569,431,8569
1644,32069,32071,31439,632,31439,31439,32065,30989,1076,30989
1645,13692,12713,12797,-84,12713,12713,12714,12556,158,12556
1646,6460,6847,7096,-249,6847,6460,6842,6739,103,6460
1647,12591,12251,12048,203,12048,12048,12241,11862,379,11862
1648,10461,10485,10398,87,10398,10398,10479,10166,313,10166
1649,16200,15632,15221,411,15221,15221,15617,14967,650,14967
1650,84372,87280,84904,2376,84904,84372,87265,84514,2751,84372
1651,3514,2671,2915,-244,2671,2671,2669,2744,-75,2744
1652,74510,74467,76452,-1985,74467,74467,74519,72834,1685,72834
1653,1039,663,895,-232,663,663,663,712,-49,712
1654,121681,106410,105726,684,105726,105726,106416,102635,3781,102635
1655,131312,140728,131279,9449,131279,131279,140706,129503,11203,129503
1656,68048,67557,67457,100,67457,67457,67557,66684,873,66684
1657,144425,142879,142398,481,142398,142398,142955,138162,4793,138162
1658,14335,14328,14338,-10,14328,14328,14335,14082,253,14082
1659,54457,54432,52743,1689,52743,52743,54429,51309,3120,51309
1660,18514,17939,16847,1092,16847,16847,17960,16031,1929,16031
1661,17803,16875,16935,-60,16875,16875,16869,16657,212,16657
1662,30304,29329,28365,964,28365,28365,29347,28042,1305,28042
1663,75593,73281,68250,5031,68250,68250,73265,67907,5358,67907
1664,21549,21548,21065,483,21065,21065,21549,20972,577,20972
1665,10346,9480,9544,-64,9480,9480,9477,9312,165,9312
1666,38373,38611,38356,255,38356,38356,38631,37722,909,37722
1667,284,284,519,-235,284,284,284,331,-47,284
1668,195634,195683,185090,10593,185090,185090,195634,184341,11293,184341
1669,88311,78208,75033,3175,75033,75033,78245,74681,3564,74681
1670,3317,2410,2604,-194,2410,2410,2410,2434,-24,2434
1671,140258,140242,134765,5477,134765,134765,140258,134470,5788,134470
1672,339971,339952,324388,15564,324388,324388,339948,319664,20284,319664
1673,5862,5806,5861,-55,5806,5806,5808,5752,56,5752
1674,73899,69870,68485,1385,68485,68485,69852,67706,2146,67706
1675,13282,12773,12669,104,12669,12669,12776,12502,274,12502
1676,277182,282308,277077,5231,277077,277077,282317,278139,4178,277182
1677,151785,156209,153769,2440,153769,151785,156248,151163,5085,151163
1678,185923,177725,179005,-1280,177725,177725,177781,174482,3299,174482
1679,12418,12548,12355,193,12355,12355,12555,12151,404,12151
1680,47955,49293,47941,1352,47941,47941,49288,47440,1848,47440
1681,4707,4460,4673,-213,4460,4460,4460,4155,305,4155
1682,218262,213578,208535,5043,208535,208535,213688,207584,6104,207584
1683,802113,784505,749006,35499,749006,749006,784676,745344,39332,745344
1684,44410,45682,44498,1184,44498,44410,45687,44389,1298,44389
1685,12832,12794,12833,-39,12794,12794,12802,12614,188,12614
1686,67096,54575,53681,894,53681,53681,54582,53032,1550,53032
1687,83504,87117,89655,-2538,87117,83504,87119,82905,4214,82905
1688,64755,41372,41623,-251,41372,41372,41389,39203,2186,39203
1689,1731,760,998,-238,760,760,760,809,-49,809
1690,42992,41811,40114,1697,40114,40114,41824,40049,1775,40049
1691,1729,1727,1953,-226,1727,1727,1729,1789,-60,1729
1692,39299,38629,36813,1816,36813,36813,38618,36574,2044,36574
1693,22691,22684,21907,777,21907,21907,22691,21444,1247,21444
1694,21699,21661,21123,538,21123,21123,21661,21029,632,21029
1695,2299,2301,2483,-182,2301,2299,2299,2314,-15,2299
1696,73067,69173,64611,4562,64611,64611,69197,64080,5117,64080
1697,98389,100449,97743,2706,97743,97743,100431,97654,2777,97654
1698,13800,12548,12142,406,12142,12142,12553,11922,631,11922
1699,15223,15130,15415,-285,15130,15130,15138,14978,160,14978
1700,46666,28393,27594,799,27594,27594,28405,27046,1359,27046
1701,3869,2946,3114,-168,2946,2946,2945,2927,18,2927
1702,22457,2953,3091,-138,2953,2953,2952,2936,16,2936
1703,50757,35546,32866,2680,32866,32866,35574,31387,4187,31387
1704,48977,47488,46284,1204,46284,46284,47500,46120,1380,46120
1705,6545,6544,6591,-47,6544,6544,6545,6424,121,6424
1706,238805,217849,205867,11982,205867,205867,218016,205043,12973,205043
1707,72885,72902,72249,653,72249,72249,72885,71368,1517,71368
1708,504631,501541,484349,17192,484349,484349,501385,480797,20588,480797
1709,73433,73413,72345,1068,72345,72345,73433,71919,1514,71919
1710,29050,28533,27575,958,27575,27575,28527,27456,1071,27456
1711,325361,282309,262659,19650,262659,262659,282193,260172,22021,260172
1712,9624,8889,8575,314,8575,8575,8887,8482,405,8482
1713,570979,570133,548536,21597,548536,548536,570102,538359,31743,538359
1714,24633,24634,23937,697,23937,23937,24633,23917,716,23917
1715,36628,36624,35802,822,35802,35802,36628,35492,1136,35492
1716,5887,5903,6015,-112,5903,5887,5908,5867,41,5867
1717,3737,3383,3504,-121,3383,3383,3382,3353,29,3353
1718,6238,6207,6345,-138,6207,6207,6210,6202,8,6202
1719,467818,435191,416401,18790,416401,416401,435351,408836,26515,408836
1720,3013751,2934297,2847003,87294,2847003,2847003,2934903,2793208,141695,2793208
1721,12172,12188,11916,272,11916,11916,12192,11728,464,11728
1722,23737,23737,23402,335,23402,23402,23737,23084,653,23084
1723,24747,24255,23668,587,23668,23668,24261,23525,736,23525
1724,60070,58847,57410,1437,57410,57410,58824,57150,1674,57150
1725,4065,4081,4287,-206,4081,4065,4081,3992,89,3992
1726,45946,45351,44012,1339,44012,44012,45368,43704,1664,43704
1727,79956,79114,77698,1416,77698,77698,79085,77193,1892,77193
1728,5913,5089,5327,-238,5089,5089,5088,4984,104,4984
1729,30529,31555,30530,1025,30530,30529,31556,30431,1125,30431
1730,24418,22949,21854,1095,21854,21854,22952,21774,1178,21774
1731,296480,312867,298669,14198,298669,296480,312761,296472,16289,296472
1732,1606,1219,1438,-219,1219,1219,1219,1265,-46,1265
1733,17270,16690,15897,793,15897,15897,16689,15831,858,15831
1734,27480,28413,27484,929,27484,27480,28412,27300,1112,27300
1735,56787,55945,55127,818,55127,55127,55927,54356,1571,54356
1736,36688,21012,20625,387,20625,20625,21030,20461,569,20461
1737,441344,425716,406392,19324,406392,406392,425949,403587,22362,403587
1738,1508992,1462624,1476940,-14316,1462624,1462624,1462871,1401323,61548,1401323
1739,76043,10503,10237,266,10237,10237,10507,10181,326,10181
1740,10387,10323,10313,10,10313,10313,10329,9750,579,9750
1741,30608,28969,27841,1128,27841,27841,28969,27759,1210,27759
1742,51222,52788,51978,810,51978,51222,52788,51171,1617,51171
1743,4769,4621,4768,-147,4621,4621,4619,4540,79,4540
1744,15421,15422,15312,110,15312,15312,15421,15176,245,15176
1745,6851,5939,6018,-79,5939,5939,5939,5778,161,5778
1746,18324,4563,4874,-311,4563,4563,4564,4589,-25,4589
1747,50711,49854,48870,984,48870,48870,49865,48146,1719,48146
1748,14092,13449,13687,-238,13449,13449,13460,13260,200,13260
1749,17307,16751,16600,151,16600,16600,16753,16404,349,16404
1750,2060,2476,3157,-681,2476,2060,2475,2027,448,2027
1751,161480,119642,114545,5097,114545,114545,119666,114163,5503,114163
1752,53577,54390,54241,149,54241,53577,54396,53577,819,53577
1753,12151,12149,11669,480,11669,11669,12151,11419,732,11419
1754,2446,2406,2561,-155,2406,2406,2408,2447,-39,2446
1755,1341,1340,1604,-264,1340,1340,1341,1387,-46,1341
1756,1181,1181,1307,-126,1181,1181,1181,1194,-13,1181
1757,117914,117077,112373,4704,112373,112373,117058,111525,5533,111525
1758,14661,15139,14846,293,14846,14661,15135,14653,482,14653
1759,92628,92584,91501,1083,91501,91501,92628,90800,1828,90800
1760,500,500,735,-235,500,500,500,549,-49,500
1761,29626,31891,31608,283,31608,29626,31900,29866,2034,29626
1762,18473,18780,18531,249,18531,18473,18784,18469,315,18469
1763,329108,300308,296258,4050,296258,296258,300388,290622,9766,290622
1764,41956,41934,41589,345,41589,41589,41942,40626,1316,40626
1765,42078,43309,43425,-116,43309,42078,43322,41456,1866,41456
1766,14492,13855,13728,127,13728,13728,13851,13517,334,13517
1767,10281,9791,9564,227,9564,9564,9790,9489,301,9489
1768,5380,5229,5316,-87,5229,5229,5229,4772,457,4772
1769,144550,151191,144823,6368,144823,144550,151159,144517,6642,144517
1770,17703,18123,17700,423,17700,17700,18128,17540,588,17540
1771,42457,52265,54663,-2398,52265,42457,52264,42449,9815,42449
1772,6080,5149,5299,-150,5149,5149,5150,5198,-48,5198
1773,422,422,654,-232,422,422,422,468,-46,422
1774,55903,60151,57021,3130,57021,55903,60190,55819,4371,55819
1775,1014,448,683,-235,448,448,448,494,-46,494
1776,3675,2970,3137,-167,2970,2970,2969,2971,-2,2971
1777,231465,231443,223791,7652,223791,223791,231419,222901,8518,222901
1778,31265,34483,37845,-3362,34483,31265,34489,31558,2931,31265
1779,251750,250802,240730,10072,240730,240730,250870,240211,10659,240211
1780,85499,77973,73393,4580,73393,73393,77959,70732,7227,70732
1781,819936,791392,755224,36168,755224,755224,791314,745176,46138,745176
1782,847603,846280,809911,36369,809911,809911,846615,803648,42967,803648
1783,284629,280832,263315,17517,263315,263315,280746,260445,20301,260445
1784,13720,11799,11266,533,11266,11266,11798,10428,1370,10428
1785,1887,1887,2102,-215,1887,1887,1887,1940,-53,1887
1786,36847,27355,28618,-1263,27355,27355,27346,25542,1804,25542
1787,3509,2662,2867,-205,2662,2662,2660,2700,-40,2700
1788,14873,14393,14332,61,14332,14332,14397,14251,146,14251
1789,29043,30114,29036,1078,29036,29036,30132,28628,1504,28628
1790,35909,34913,33411,1502,33411,33411,34920,33352,1568,33352
1791,8300,7731,7321,410,7321,7321,7733,6991,742,6991
1792,55861,55741,54781,960,54781,54781,55762,54283,1479,54283
1793,21239,20520,20134,386,20134,20134,20522,19975,547,19975
1794,32639,18269,17854,415,17854,17854,18278,17608,670,17608
1795,21024,21012,20195,817,20195,20195,21024,20158,866,20158
1796,26073,26760,26000,760,26000,26000,26762,25857,905,25857
1797,38820,37678,36325,1353,36325,36325,37687,35884,1803,35884
1798,22816,21589,21229,360,21229,21229,21600,20910,690,20910
1799,7940,7218,7656,-438,7218,7218,7221,7318,-97,7318
1800,5994,5100,5265,-165,5100,5100,5100,5105,-5,5105
1801,1015107,972700,923737,48963,923737,923737,973070,919030,54040,919030
1802,177697,169802,163919,5883,163919,163919,169848,161851,7997,161851
1803,88723,88247,87900,347,87900,87900,88303,87090,1213,87090
1804,11971,11206,11014,192,11014,11014,11198,10869,329,10869
1805,12999,12423,11991,432,11991,11991,12419,11697,722,11697
1806,131618,105214,102620,2594,102620,102620,105240,101482,3758,101482
1807,31670,33200,31853,1347,31853,31670,33201,31662,1539,31662
1808,205919,214790,205886,8904,205886,205886,214824,205030,9794,205030
1809,124716,127403,125476,1927,125476,124716,127421,124716,2705,124716
1810,375,375,625,-250,375,375,375,426,-51,375
1811,1324,1307,1551,-244,1307,1307,1307,1361,-54,1324
1812,357796,357671,339628,18043,339628,339628,357796,334415,23381,334415
1813,26771,26184,25779,405,25779,25779,26193,25320,873,25320
1814,9100,9092,9124,-32,9092,9092,9100,8802,298,8802
1815,19227,19223,18661,562,18661,18661,19227,18547,680,18547
1816,12328,12326,12329,-3,12326,12326,12328,12011,317,12011
1817,301211,318093,301057,17036,301057,301057,318119,299089,19030,299089
1818,137482,135596,128964,6632,128964,128964,135600,128458,7142,128458
1819,22503,22506,22146,360,22146,22146,22503,21885,618,21885
1820,24568,25366,24507,859,24507,24507,25373,24362,1011,24362
1821,17109,17207,17113,94,17113,17109,17205,16888,317,16888
1822,2415,1481,1737,-256,1481,1481,1480,1530,-50,1530
1823,14172,13246,12891,355,12891,12891,13247,12679,568,12679
1824,241003,240904,231789,9115,231789,231789,240941,229770,11171,229770
1825,15583,12788,13164,-376,12788,12788,12784,12107,677,12107
1826,771008,770933,769851,1082,769851,769851,771008,744261,26747,744261
1827,144996,150337,146065,4272,146065,144996,150290,145726,4564,144996
1828,141064,145857,142503,3354,142503,141064,145857,141056,4801,141056
1829,59510,59452,59541,-89,59452,59452,59477,58579,898,58579
1830,69131,69356,69561,-205,69356,69131,69376,68509,867,68509
1831,7856,6878,6980,-102,6878,6878,6876,6910,-34,6910
1832,327500,331378,323361,8017,323361,323361,331390,319536,11854,319536
1833,4010,3376,3562,-186,3376,3376,3374,3414,-40,3414
1834,1273,1273,1537,-264,1273,1273,1273,1100,173,1100
1835,220941,182183,179612,2571,179612,179612,182165,176956,5209,176956
1836,182937,182863,175358,7505,175358,175358,182937,173348,9589,173348
1837,57111,47807,46119,1688,46119,46119,47817,45647,2170,45647
1838,58211,56921,54414,2507,54414,54414,56893,54185,2708,54185
1839,37518,35348,33492,1856,33492,33492,35344,33380,1964,33380
1840,143403,141620,136219,5401,136219,136219,141549,135701,5848,135701
1841,6843,6841,6839,2,6839,6839,6843,6428,415,6428
1842,18375,17564,17100,464,17100,17100,17570,17008,562,17008
1843,11258,10670,10400,270,10400,10400,10679,10205,474,10205
1844,16025,15110,14644,466,14644,14644,15115,14525,590,14525
1845,10632,10633,10411,222,10411,10411,10632,10327,305,10327
1846,37463,34137,32796,1341,32796,32796,34143,32731,1412,32731
1847,19030,19023,18979,44,18979,18979,19030,18852,178,18852
1848,503595,487374,479645,7729,479645,479645,487448,469503,17945,469503
1849,340105,299420,285170,14250,285170,285170,299412,269053,30359,269053
1850,11088,10166,10212,-46,10166,10166,10171,10071,100,10071
1851,28375,27460,26688,772,26688,26688,27460,26386,1074,26386
1852,3117,3116,3262,-146,3116,3116,3117,3147,-30,3117
1853,298112,308575,300285,8290,300285,298112,308769,298060,10709,298060
1854,12668,2484,2751,-267,2484,2484,2482,2558,-76,2558
1855,68613,56504,55399,1105,55399,55399,56524,55206,1318,55206
1856,133625,115308,109246,6062,109246,109246,115309,108358,6951,108358
1857,965953,940175,891063,49112,891063,891063,940053,880607,59446,880607
1858,103907,106545,103887,2658,103887,103887,106580,103712,2868,103712
1859,7297,7365,7445,-80,7365,7297,7370,7276,94,7276
1860,13305,13311,13250,61,13250,13250,13305,13117,188,13117
1861,19455,20272,19386,886,19386,19386,20279,19281,998,19281
1862,25443,25393,24708,685,24708,24708,25403,24500,903,24500
1863,114669,113732,108628,5104,108628,108628,113757,107592,6165,107592
1864,254022,243748,234568,9180,234568,234568,243712,231989,11723,231989
1865,200184,214529,201934,12595,201934,200184,214439,200452,13987,200184
1866,21696,1595,1821,-226,1595,1595,1593,1634,-41,1634
1867,511875,537961,517966,19995,517966,511875,538032,512412,25620,511875
1868,133454,137335,132028,5307,132028,132028,137324,130414,6910,130414
1869,897645,893483,845019,48464,845019,845019,893417,837404,56013,837404
1870,354676,364921,354490,10431,354490,354490,364955,351858,13097,351858
1871,1508209,1460409,1384362,76047,1384362,1384362,1460526,1368106,92420,1368106
1872,38268,40578,38264,2314,38264,38264,40566,37955,2611,37955
1873,10423,9465,9497,-32,9465,9465,9465,8991,474,8991
1874,235382,244788,236991,7797,236991,235382,244849,235734,9115,235382
1875,2608,1785,2014,-229,1785,1785,1784,1847,-63,1847
1876,88577,87745,86631,1114,86631,86631,87753,83861,3892,83861
1877,24603,24554,23593,961,23593,23593,24545,23528,1017,23528
1878,55928,56550,56769,-219,56550,55928,56595,56327,268,55928
1879,94923,98218,99653,-1435,98218,94923,98214,96674,1540,94923
1880,1907,1066,1322,-256,1066,1066,1066,1116,-50,1116
1881,127139,127078,123944,3134,123944,123944,127139,123081,4058,123081
1882,8990,7782,7543,239,7543,7543,7781,7282,499,7282
1883,5726,5129,5278,-149,5129,5129,5128,5098,30,5098
1884,87779,86743,84603,2140,84603,84603,86793,84269,2524,84269
1885,17970,16151,15463,688,15463,15463,16164,15369,795,15369
1886,40550,36898,35430,1468,35430,35430,36912,35260,1652,35260
1887,14901,14904,14849,55,14849,14849,14906,14657,249,14657
1888,199105,194113,184509,9604,184509,184509,194186,184435,9751,184435
1889,18464,17626,17394,232,17394,17394,17628,17110,518,17110
1890,21747,21742,21335,407,21335,21335,21747,21161,586,21161
1891,136233,135025,136116,-1091,135025,135025,135024,133167,1857,133167
1892,54370,52961,51164,1797,51164,51164,52966,50804,2162,50804
1893,22167,21163,20627,536,20627,20627,21167,20333,834,20333
1894,12222495,12220758,11755398,465360,11755398,11755398,12219329,11570202,649127,11570202
1895,8830,8804,8805,-1,8804,8804,8805,8765,40,8765
1896,40790,38264,36301,1963,36301,36301,38273,36187,2086,36187
1897,20118,7320,7345,-25,7320,7320,7318,7259,59,7259
1898,120675,109799,102903,6896,102903,102903,109824,101452,8372,101452
1899,1385,1060,1313,-253,1060,1060,1060,1098,-38,1098
1900,47468,47460,45239,2221,45239,45239,47468,44707,2761,44707
1901,6407,5525,5757,-232,5525,5525,5530,5554,-24,5554
1902,3501,3335,3438,-103,3335,3335,3336,3287,49,3287
1903,153335,153283,146038,7245,146038,146038,153335,145423,7912,145423
1904,209292,208332,198309,10023,198309,198309,208401,197604,10797,197604
1905,68735,68843,68709,134,68709,68709,68857,67264,1593,67264
1906,45206,23032,22429,603,22429,22429,23037,22240,797,22240
1907,43533,43532,41845,1687,41845,41845,43549,41316,2233,41316
1908,17197,3217,3439,-222,3217,3217,3222,3204,18,3204
1909,5559,5322,5495,-173,5322,5322,5320,5217,103,5217
1910,28268,26764,26208,556,26208,26208,26770,25701,1069,25701
1911,2246,2050,2186,-136,2050,2050,2051,2008,43,2008
1912,6545,6555,6547,8,6547,6545,6554,6418,136,6418
1913,27664,12512,12370,142,12370,12370,12511,11476,1035,11476
1914,3991,3487,3646,-159,3487,3487,3487,3369,118,3369
1915,139085,137161,132414,4747,132414,132414,137126,131278,5848,131278
1916,6152,5718,5855,-137,5718,5718,5718,5684,34,5684
1917,1752,1752,1973,-221,1752,1752,1752,1802,-50,1752
1918,13183,2692,2880,-188,2692,2692,2694,2720,-26,2720
1919,86688,86086,81948,4138,81948,81948,86134,81772,4362,81772
1920,95637,95648,94475,1173,94475,94475,95637,93556,2081,93556
1921,11216,5097,5216,-119,5097,5097,5098,5101,-3,5101
1922,32962,16403,16025,378,16025,16025,16405,15832,573,15832
1923,52697,55376,52633,2743,52633,52633,55377,52088,3289,52088
1924,9212,9203,9287,-84,9203,9203,9212,9119,93,9119
1925,44214,47075,44192,2883,44192,44192,47081,44018,3063,44018
1926,52322,55125,53351,1774,53351,52322,55126,52332,2794,52322
1927,7637,7655,7945,-290,7655,7637,7653,7645,8,7637
1928,2035,1088,1297,-209,1088,1088,1087,1138,-51,1138
1929,1959,1060,1280,-220,1060,1060,1060,1113,-53,1113
1930,2286,1848,2088,-240,1848,1848,1848,1898,-50,1898
1931,58574,57676,56731,945,56731,56731,57666,55810,1856,55810
1932,7830,7790,7963,-173,7790,7790,7789,7752,37,7752
1933,109535,115777,109505,6272,109505,109505,115778,105646,10132,105646
1934,9247,8760,8639,121,8639,8639,8756,8438,318,8438
1935,210054,179595,171121,8474,171121,171121,179627,169583,10044,169583
1936,37049,37433,37035,398,37035,37035,37429,36653,776,36653
1937,7931,7090,7336,-246,7090,7090,7088,7010,78,7010
1938,2911,2912,3055,-143,2912,2911,2911,2837,74,2837
1939,2353,1979,2176,-197,1979,1979,1976,2036,-60,2036
1940,20531,21175,20548,627,20548,20531,21178,20295,883,20295
1941,49736,17467,16920,547,16920,16920,17479,16821,658,16821
1942,19102,19148,19174,-26,19148,19102,19171,18827,344,18827
1943,138955,138068,136690,1378,136690,136690,138039,134142,3897,134142
1944,43257,42085,41503,582,41503,41503,42104,41045,1059,41045
1945,383479,383353,372763,10590,372763,372763,383275,366922,16353,366922
1946,31907,29988,28692,1296,28692,28692,29982,28624,1358,28624
1947,23129,21756,21811,-55,21756,21756,21754,21441,313,21441
1948,111050,106766,111485,-4719,106766,106766,106751,106812,-61,106812
1949,72755,71306,69775,1531,69775,69775,71307,68829,2478,68829
1950,108796,110137,108796,1341,108796,108796,110176,107868,2308,107868
1951,33456,33966,34169,-203,33966,33456,33966,33610,356,33456
1952,11268,10049,9902,147,9902,9902,10050,9881,169,9881
1953,22889,22887,22872,15,22872,22872,22889,22627,262,22627
1954,1007282,979983,933158,46825,933158,933158,979749,919338,60411,919338
1955,34960,31689,30396,1293,30396,30396,31685,29663,2022,29663
1956,558921,524762,522124,2638,522124,522124,524886,518820,6066,518820
1957,502670,501726,476894,24832,476894,476894,501523,472492,29031,472492
1958,95624,71278,68957,2321,68957,68957,71280,68426,2854,68426
1959,44710,22764,22205,559,22205,22205,22760,21708,1052,21708
1960,13585,12820,12276,544,12276,12276,12826,11782,1044,11782
1961,14774,11931,11857,74,11857,11857,11921,11736,185,11736
1962,165265,175132,164549,10583,164549,164549,175209,163710,11499,163710
1963,90152,89309,84718,4591,84718,84718,89378,84563,4815,84563
1964,10510,10011,10101,-90,10011,10011,10023,9798,225,9798
1965,41349,41317,41380,-63,41317,41317,41348,40525,823,40525
1966,69874,68946,67437,1509,67437,67437,68968,67198,1770,67198
1967,27934,29073,28103,970,28103,27934,29073,27889,1184,27889
1968,2477,2323,2416,-93,2323,2323,2324,2227,97,2227
1969,20683,20683,20372,311,20372,20372,20683,20231,452,20231
1970,248321,246930,236437,10493,236437,236437,246795,235918,10877,235918
1971,201557,200508,201501,-993,200508,200508,200517,197189,3328,197189
1972,28563,25255,23767,1488,23767,23767,25261,23419,1842,23419
1973,442284,422088,400098,21990,400098,400098,422093,397591,24502,397591
1974,15814,15820,15293,527,15293,15293,15814,15177,637,15177
1975,70512,75357,70503,4854,70503,70503,75317,69611,5706,69611
1976,95789,97532,99193,-1661,97532,95789,97571,96568,1003,95789
1977,3070,2690,2819,-129,2690,2690,2690,2686,4,2686
1978,17896,17899,17418,481,17418,17418,17896,17358,538,17358
1979,326544,326462,310805,15657,310805,310805,326544,308534,18010,308534
1980,245471,242690,231678,11012,231678,231678,242640,229644,12996,229644
1981,10655,10190,10138,52,10138,10138,10194,9984,210,9984
1982,65255,69700,65238,4462,65238,65238,69651,64810,4841,64810
1983,3028,2663,2871,-208,2663,2663,2662,2704,-42,2704
1984,27308,27250,26961,289,26961,26961,27270,26457,813,26457
1985,7971,7971,8061,-90,7971,7971,7971,7851,120,7851
1986,86500,86478,81287,5191,81287,81287,86500,79034,7466,79034
1987,75145,76424,76219,205,76219,75145,76444,75137,1307,75137
1988,33550,23199,22723,476,22723,22723,23199,21667,1532,21667
1989,145112,131302,127479,3823,127479,127479,131368,126626,4742,126626
1990,33277,33709,33754,-45,33709,33277,33706,33371,335,33277
1991,10594,9672,9505,167,9505,9505,9677,9237,440,9237
1992,5167261,4997401,4843737,153664,4843737,4843737,4998731,4801395,197336,4801395
1993,172180,173559,172125,1434,172125,172125,173558,170329,3229,170329
1994,1679,1661,1848,-187,1661,1661,1659,1613,46,1613
1995,4217,4092,4278,-186,4092,4092,4092,4165,-73,4165
1996,196710,183563,179679,3884,179679,179679,183620,178835,4785,178835
1997,14092,14423,14034,389,14034,14034,14431,13769,662,13769
1998,215554,159808,146796,13012,146796,146796,159814,143193,16621,143193
1999,41117,41127,39739,1388,39739,39739,41117,37719,3398,37719
2000,48790,30798,30621,177,30621,30621,30803,30288,515,30288
2001,25565,26553,25831,722,25831,25565,26556,25549,1007,25549
2002,13496,14505,14411,94,14411,13496,14504,13488,1016,13488
2003,172113,176380,173034,3346,173034,172113,176416,172622,3794,172113
2004,329790,340099,331280,8819,331280,329790,340067,329782,10285,329782
2005,97045,93887,90633,3254,90633,90633,93883,89978,3905,89978
2006,49118,49523,49359,164,49359,49118,49519,48496,1023,48496
2007,270290,242211,241168,1043,241168,241168,242263,238208,4055,238208
2008,1959,1059,1284,-225,1059,1059,1060,1109,-49,1109
2009,2555,2375,2554,-179,2375,2375,2375,2411,-36,2411
2010,2654,2245,2494,-249,2245,2245,2244,2269,-25,2269
2011,4607,4566,4545,21,4545,4545,4567,4341,226,4341
2012,47895,23209,22880,329,22880,22880,23222,22768,454,22768
2013,28416,27224,26585,639,26585,26585,27224,26308,916,26308
2014,73521,74173,73268,905,73268,73268,74155,72220,1935,72220
2015,5843,1839,2130,-291,1839,1839,1839,1825,14,1825
2016,14735,14181,15173,-992,14181,14181,14193,13891,302,13891
2017,7431,7495,7433,62,7433,7431,7497,7303,194,7303
2018,1106103,1064038,1029161,34877,1029161,1029161,1064209,1010888,53321,1010888
2019,22802,22201,21792,409,21792,21792,22198,21567,631,21567
2020,42216,16942,16899,43,16899,16899,16951,16623,328,16623
2021,1556,1556,1789,-233,1556,1556,1556,1584,-28,1556
2022,405603,411892,405487,6405,405487,405487,411943,398180,13763,398180
2023,8301,8303,8191,112,8191,8191,8299,7945,354,7945
2024,197130,158912,159295,-383,158912,158912,158924,152178,6746,152178
2025,156449,162645,158035,4610,158035,156449,162655,156441,6214,156441
2026,9004,9002,9053,-51,9002,9002,9004,8671,333,8671
2027,11700,11087,10796,291,10796,10796,11088,10732,356,10732
2028,4818,4753,5071,-318,4753,4753,4751,4818,-67,4818
2029,14756,4858,4869,-11,4858,4858,4861,4697,164,4697
2030,32846,32952,32993,-41,32952,32846,32960,32658,302,32658
2031,48962,48836,47360,1476,47360,47360,48823,47212,1611,47212
2032,11648,11643,11850,-207,11643,11643,11648,11570,78,11570
2033,20386,20390,19681,709,19681,19681,20386,19494,892,19494
2034,48362,48794,49491,-697,48794,48362,48807,48354,453,48354
2035,57988,57985,57450,535,57450,57450,57988,56304,1684,56304
2036,79207,77026,75373,1653,75373,75373,77040,74995,2045,74995
2037,15305,15310,15177,133,15177,15177,15305,14991,314,14991
2038,2567,2570,2780,-210,2570,2567,2568,2619,-51,2567
2039,1202,1201,1475,-274,1201,1201,1202,1248,-46,1202
2040,7833,7832,8023,-191,7832,7832,7833,7710,123,7710
2041,10939,10938,11196,-258,10938,10938,10939,10858,81,10858
2042,19198,19205,18590,615,18590,18590,19198,18411,787,18411
2043,17876,17876,17570,306,17570,17570,17876,17393,483,17393
2044,9098,9196,9097,99,9097,9097,9194,8933,261,8933
2045,10413,7958,7917,41,7917,7917,7955,7708,247,7708
2046,67663,67649,65168,2481,65168,65168,67673,64142,3531,64142
2047,313800,331270,321970,9300,321970,313800,331289,313792,17497,313792
2048,19238,18649,17894,755,17894,17894,18652,17754,898,17754
2049,35033,35060,34587,473,34587,34587,35083,34411,672,34411
2050,55083,56388,55069,1319,55069,55069,56373,53933,2440,53933
2051,16810,16238,16255,-17,16238,16238,16240,16014,226,16014
2052,19112,18200,17466,734,17466,17466,18197,17081,1116,17081
2053,142773,105830,107328,-1498,105830,105830,105858,103675,2183,103675
2054,1244,862,1090,-228,862,862,862,912,-50,912
2055,20034,15038,14621,417,14621,14621,15040,14541,499,14541
2056,6106,6353,6583,-230,6353,6106,6353,6106,247,6106
2057,2292,1446,1712,-266,1446,1446,1446,1410,36,1410
2058,13931,14066,14226,-160,14066,13931,14068,13907,161,13907
2059,8214,8168,8236,-68,8168,8168,8170,8137,33,8137
2060,124505,128263,124465,3798,124465,124465,128223,124103,4120,124103
2061,131074,130994,130735,259,130735,130735,131026,129344,1682,129344
2062,15836,15186,15212,-26,15186,15186,15195,14961,234,14961
2063,2159,1578,1811,-233,1578,1578,1580,1637,-57,1637
2064,1995,1998,2187,-189,1998,1995,1995,2017,-22,1995
2065,9983,9146,9298,-152,9146,9146,9145,9047,98,9047
2066,13717,872,1113,-241,872,872,872,628,244,628
2067,16402,16403,16195,208,16195,16195,16402,16080,322,16080
2068,66648,55992,55051,941,55051,55051,56021,54262,1759,54262
2069,29899,29085,27918,1167,27918,27918,29095,27538,1557,27538
2070,54494,55244,53985,1259,53985,53985,55260,53872,1388,53872
2071,448519,393785,371077,22708,371077,371077,393680,365406,28274,365406
2072,86280,86204,82135,4069,82135,82135,86229,80960,5269,80960
2073,12094,12092,11738,354,11738,11738,12094,11609,485,11609
2074,52804,51648,49724,1924,49724,49724,51676,49318,2358,49318
2075,60475,63033,60750,2283,60750,60475,63022,60546,2476,60475
2076,101583,96637,96406,231,96406,96406,96713,95045,1668,95045
2077,23323,22633,21906,727,21906,21906,22638,21548,1090,21548
2078,6091,6086,6338,-252,6086,6086,6085,6055,30,6055
2079,13273,11199,11361,-162,11199,11199,11201,10547,654,10547
2080,25728,22701,21879,822,21879,21879,22695,21797,898,21797
2081,26907,27639,27242,397,27242,26907,27647,26907,740,26907
2082,1543850,1447710,1373577,74133,1373577,1373577,1447945,1358474,89471,1358474
2083,46732,45880,44788,1092,44788,44788,45882,43964,1918,43964
2084,28232,9722,9831,-109,9722,9722,9723,9573,150,9573
2085,31039,32250,31666,584,31666,31039,32307,31129,1178,31039
2086,375720,374581,365370,9211,365370,365370,374652,356113,18539,356113
2087,157040,146287,139737,6550,139737,139737,146360,139206,7154,139206
2088,80005,71925,73764,-1839,71925,71925,71919,71045,874,71045
2089,28109,27281,25875,1406,25875,25875,27273,24329,2944,24329
2090,7100,6390,6482,-92,6390,6390,6390,6174,216,6174
2091,41419,41444,41584,-140,41444,41419,41450,40797,653,40797
2092,15153,15164,15086,78,15086,15086,15153,14918,235,14918
2093,1673,766,1049,-283,766,766,765,828,-63,828
2094,18486,18658,18476,182,18476,18476,18657,18187,470,18187
2095,13719,13222,13230,-8,13222,13222,13217,13002,215,13002
2096,3336,2821,3013,-192,2821,2821,2820,2776,44,2776
2097,25555,24724,24583,141,24583,24583,24727,24204,523,24204
2098,36849,36831,35181,1650,35181,35181,36849,35087,1762,35087
2099,6616,5781,5845,-64,5781,5781,5782,5637,145,5637
2100,2860,2266,2477,-211,2266,2266,2266,2315,-49,2315
2101,57282,57136,54625,2511,54625,54625,57190,53808,3382,53808
2102,747,308,542,-234,308,308,308,344,-36,344
2103,2252551,2063007,2012507,50500,2012507,2012507,2062796,1998395,64401,1998395
2104,4018,485,742,-257,485,485,485,534,-49,534
2105,4830,1142,1436,-294,1142,1142,1142,1189,-47,1189
2106,70765,69854,67360,2494,67360,67360,69842,66559,3283,66559
2107,10610,10040,9391,649,9391,9391,10037,9139,898,9139
2108,2146,2129,2406,-277,2129,2129,2130,2197,-67,2146
2109,122469,99207,95395,3812,95395,95395,99234,93837,5397,93837
2110,153644,144860,137878,6982,137878,137878,144908,137033,7875,137033
2111,45856,45809,43991,1818,43991,43991,45813,43772,2041,43772
2112,2997,2825,2992,-167,2825,2825,2825,2831,-6,2831
2113,12807,12814,12547,267,12547,12547,12807,12452,355,12452
2114,1337502,1336580,1264754,71826,1264754,1264754,1336853,1245404,91449,1245404
2115,124190,127892,129640,-1748,127892,124190,127910,124182,3728,124182
2116,250990,201927,189737,12190,189737,189737,201867,188704,13163,188704
2117,114368,82273,80494,1779,80494,80494,82293,80181,2112,80181
2118,14175,2358,2591,-233,2358,2358,2359,2400,-41,2400
2119,57701,49819,47301,2518,47301,47301,49805,46848,2957,46848
2120,63825,62496,59618,2878,59618,59618,62505,59513,2992,59513
2121,69726,68391,67048,1343,67048,67048,68403,66436,1967,66436
2122,21904,19905,19500,405,19500,19500,19919,19350,569,19350
2123,26408,26105,26012,93,26012,26012,26121,25786,335,25786
2124,12262,12267,12457,-190,12267,12262,12262,12204,58,12204
2125,104858,99975,95778,4197,95778,95778,99971,95321,4650,95321
2126,178572,176837,172020,4817,172020,172020,176746,170977,5769,170977
2127,9223,9201,8843,358,8843,8843,9205,8307,898,8307
2128,7176,7133,7469,-336,7133,7133,7139,7156,-17,7156
2129,52116,43841,41496,2345,41496,41496,43834,40547,3287,40547
2130,9135,7945,7795,150,7795,7795,7946,7662,284,7662
2131,13510,14040,13746,294,13746,13510,14050,13472,578,13472
2132,8027,4866,4963,-97,4866,4866,4865,4804,61,4804
2133,54939,53975,51112,2863,51112,51112,53945,51045,2900,51045
2134,468688,479728,469948,9780,469948,468688,479688,468066,11622,468066
2135,11261,11322,11524,-202,11322,11261,11323,11220,103,11220
2136,160223,154363,145686,8677,145686,145686,154382,144554,9828,144554
2137,104129,103087,99014,4073,99014,99014,103081,98606,4475,98606
2138,2525,1695,1916,-221,1695,1695,1697,1701,-4,1701
2139,22632,22634,22216,418,22216,22216,22632,22053,579,22053
2140,77595,64358,61373,2985,61373,61373,64326,61248,3078,61248
2141,35535,36270,35528,742,35528,35528,36272,33934,2338,33934
2142,73990,75777,71726,4051,71726,71726,75788,71410,4378,71410
2143,15356,12913,12730,183,12730,12730,12912,12690,222,12690
2144,263974,276022,273112,2910,273112,263974,276062,263192,12870,263192
2145,9579,9700,9542,158,9542,9542,9696,9425,271,9425
2146,68370,67776,64354,3422,64354,64354,67802,64125,3677,64125
2147,1603,1602,1874,-272,1602,1602,1603,1661,-58,1603
2148,37212,37207,37939,-732,37207,37207,37212,34072,3140,34072
2149,30934,29580,28511,1069,28511,28511,29575,28529,1046,28529
2150,3618,3478,3618,-140,3478,3478,3477,3362,115,3362
2151,2358,2340,2567,-227,2340,2340,2340,2393,-53,2358
2152,33830,34800,33813,987,33813,33813,34809,33524,1285,33524
2153,9590,8730,9002,-272,8730,8730,8730,8655,75,8655
2154,116289,115361,110616,4745,110616,110616,115381,110429,4952,110429
2155,8701,8273,8304,-31,8273,8273,8274,8113,161,8113
2156,36009,35994,35403,591,35403,35403,36009,35149,860,35149
2157,39291,38360,35676,2684,35676,35676,38358,34053,4305,34053
2158,9655,9872,9595,277,9595,9595,9874,9351,523,9351
2159,20175,20454,20177,277,20177,20175,20440,19974,466,19974
2160,8568,8011,8124,-113,8011,8011,8013,7781,232,7781
2161,45949,45715,44288,1427,44288,44288,45741,44014,1727,44014
2162,636540,635689,619622,16067,619622,619622,635507,618810,16697,618810
2163,134671,131498,125463,6035,125463,125463,131503,125244,6259,125244
2164,55830,53394,51384,2010,51384,51384,53383,50606,2777,50606
2165,102768,100094,95411,4683,95411,95411,100090,95310,4780,95310
2166,5614,5693,6022,-329,5693,5614,5695,5614,81,5614
2167,3129,3132,3369,-237,3132,3129,3129,3053,76,3053
2168,151673,150020,146452,3568,146452,146452,150032,144683,5349,144683
2169,19694,19695,19080,615,19080,19080,19694,18987,707,18987
2170,125591,124649,119405,5244,119405,119405,124667,117341,7326,117341
2171,11057,10603,10500,103,10500,10500,10604,10378,226,10378
2172,17297,17294,16853,441,16853,16853,17297,16775,522,16775
2173,33476,29881,29097,784,29097,29097,29876,28867,1009,28867
2174,1549,1060,1306,-246,1060,1060,1060,1117,-57,1117
2175,178932,181413,184878,-3465,181413,178932,181530,178924,2606,178924
2176,11812,10979,10733,246,10733,10733,10971,10584,387,10584
2177,3145,2202,2429,-227,2202,2202,2201,2240,-39,2240
2178,298017,297112,286050,11062,286050,286050,297177,283415,13762,283415
2179,14018,13174,12629,545,12629,12629,13176,12216,960,12216
2180,8723,8074,8122,-48,8074,8074,8075,7907,168,7907
2181,42123,41554,40308,1246,40308,40308,41548,40208,1340,40208
2182,24711,25489,24701,788,24701,24701,25499,23694,1805,23694
2183,207341,151287,142344,8943,142344,142344,151328,139546,11782,139546
2184,130779,106267,102333,3934,102333,102333,106274,101593,4681,101593
2185,3323,3287,3451,-164,3287,3287,3287,3257,30,3257
2186,10422,10961,10360,601,10360,10360,10956,10093,863,10093
2187,78463,78469,78341,128,78341,78341,78463,77514,949,77514
2188,4976,5020,4980,40,4980,4976,5024,4619,405,4619
2189,40955,40916,40240,676,40240,40240,40901,39932,969,39932
2190,210729,196467,189560,6907,189560,189560,196546,189304,7242,189304
2191,7127,7129,7151,-22,7129,7127,7127,6923,204,6923
2192,78729,68597,68319,278,68319,68319,68617,66628,1989,66628
2193,717,310,543,-233,310,310,310,356,-46,356
2194,3698,2638,2839,-201,2638,2638,2638,2668,-30,2668
2195,36248,8290,8307,-17,8290,8290,8291,7890,401,7890
2196,499,342,467,-125,342,342,341,352,-11,352
2197,127089,125351,130748,-5397,125351,125351,125348,125298,50,125298
2198,8647,7977,8099,-122,7977,7977,7984,7835,149,7835
2199,1641,1641,1874,-233,1641,1641,1641,1690,-49,1641
2200,5845,5427,5541,-114,5427,5427,5427,5383,44,5383
2201,96909,86166,78613,7553,78613,78613,86171,77364,8807,77364
2202,7299,6373,6564,-191,6373,6373,6372,6286,86,6286
2203,98704,98777,94040,4737,94040,94040,98722,93588,5134,93588
2204,193760,209479,199460,10019,199460,193760,209504,193138,16366,193138
2205,7787,7705,7789,-84,7705,7705,7710,7322,388,7322
2206,13632,13628,13579,49,13579,13579,13632,13434,198,13434
2207,17392,16954,16692,262,16692,16692,16955,16518,437,16518
2208,220485,198956,189925,9031,189925,189925,198968,187577,11391,187577
2209,76035,77260,77257,3,77257,76035,77291,76027,1264,76027
2210,20469,21496,20778,718,20778,20469,21493,20461,1032,20461
2211,70808,73444,72636,808,72636,70808,73440,70808,2632,70808
2212,19013,19711,18949,762,18949,18949,19721,18498,1223,18498
2213,4362,3916,4148,-232,3916,3916,3915,3956,-41,3956
2214,97311,95808,91468,4340,91468,91468,95825,91087,4738,91087
2215,17952,18798,18457,341,18457,17952,18793,17944,849,17944
2216,2845,2153,2410,-257,2153,2153,2154,2223,-69,2223
2217,7249,7263,7477,-214,7263,7249,7265,7305,-40,7249
2218,21490,20944,20413,531,20413,20413,20950,20179,771,20179
2219,10007,10132,10262,-130,10132,10007,10132,10045,87,10007
2220,12371,416,651,-235,416,416,416,399,17,399
2221,120261,104773,102256,2517,102256,102256,104787,101400,3387,101400
2222,44312,43313,42141,1172,42141,42141,43333,42006,1327,42006
2223,12568,12571,12587,-16,12571,12568,12568,12353,215,12353
2224,12578,12579,12657,-78,12579,12578,12578,12379,199,12379
2225,2187,1266,1459,-193,1266,1266,1267,1319,-52,1319
2226,60000,61738,60803,935,60803,60000,61762,60390,1372,60000
2227,17484,17750,17424,326,17424,17424,17746,16110,1636,16110
2228,20611,20616,20162,454,20162,20162,20611,20013,598,20013
2229,17609,17604,17199,405,17199,17199,17609,17070,539,17070
2230,53775,49256,47114,2142,47114,47114,49273,46807,2466,46807
2231,1573,553,786,-233,553,553,553,608,-55,608
2232,38412,37384,36400,984,36400,36400,37388,36072,1316,36072
2233,14068,12498,12780,-282,12498,12498,12509,12397,112,12397
2234,61276,42765,41399,1366,41399,41399,42803,40861,1942,40861
2235,5951,5039,5278,-239,5039,5039,5040,5033,7,5033
2236,7212,6740,6730,10,6730,6730,6740,6602,138,6602
2237,466714,452319,418398,33921,418398,418398,452502,416436,36066,416436
2238,6647,6626,6605,21,6605,6605,6629,6501,128,6501
2239,3019,2604,2731,-127,2604,2604,2603,2590,13,2590
2240,25024,25037,24152,885,24152,24152,25024,23983,1041,23983
2241,12125,12115,12842,-727,12115,12115,12125,12232,-107,12125
2242,25073,24536,23935,601,23935,23935,24555,23753,802,23753
2243,195738,195659,187459,8200,187459,187459,195738,185749,9989,185749
2244,918,918,1136,-218,918,918,918,967,-49,918
2245,64141,42455,42191,264,42191,42191,42459,41715,744,41715
2246,91355,89390,89031,359,89031,89031,89394,88051,1343,88051
2247,12497,11938,12013,-75,11938,11938,11944,11851,93,11851
2248,8311,8326,8241,85,8241,8241,8329,7959,370,7959
2249,33109,32278,31164,1114,31164,31164,32268,30554,1714,30554
2250,34892,19924,20308,-384,19924,19924,19926,19788,138,19788
2251,3583,3392,3583,-191,3392,3392,3392,3403,-11,3403
2252,52082,29899,29096,803,29096,29096,29900,28529,1371,28529
2253,20332,18752,18020,732,18020,18020,18753,17735,1018,17735
2254,6378,5724,5738,-14,5724,5724,5726,5560,166,5560
2255,150379,149058,144103,4955,144103,144103,149061,143843,5218,143843
2256,10359,10352,10299,53,10299,10299,10359,10112,247,10112
2257,38820,38808,37026,1782,37026,37026,38820,36310,2510,36310
2258,110792,96296,92363,3933,92363,92363,96334,92229,4105,92229
2259,5798,5166,5313,-147,5166,5166,5170,5176,-6,5176
2260,20760,7015,7222,-207,7015,7015,7011,6986,25,6986
2261,257871,256921,254659,2262,254659,254659,256968,248264,8704,248264
2262,44366,44369,42794,1575,42794,42794,44366,42549,1817,42549
2263,17319,16592,16136,456,16136,16136,16600,16001,599,16001
2264,3596,3297,3478,-181,3297,3297,3296,3281,15,3281
2265,72069,74565,72643,1922,72643,72069,74613,72041,2572,72041
2266,360704,359603,342251,17352,342251,342251,359589,339107,20482,339107
2267,28329,27428,27182,246,27182,27182,27434,26948,486,26948
2268,331761,321602,304805,16797,304805,304805,321585,303762,17823,303762
2269,54677,54686,53831,855,53831,53831,54677,53034,1643,53034
2270,2701,2384,2598,-214,2384,2384,2384,2414,-30,2414
2271,2786,2419,2695,-276,2419,2419,2420,2427,-7,2427
2272,145453,137177,130577,6600,130577,130577,137247,129834,7413,129834
2273,46919,48398,46922,1476,46922,46919,48386,46757,1629,46757
2274,6851,6847,6823,24,6823,6823,6851,6707,144,6707
2275,134224,130810,126913,3897,126913,126913,130842,126533,4309,126533
2276,48122,47215,44685,2530,44685,44685,47253,44538,2715,44538
2277,30927,30928,30373,555,30373,30373,30927,30022,905,30022
2278,147242,143946,135233,8713,135233,135233,144011,134937,9074,134937
2279,10357,9235,8816,419,8816,8816,9235,8695,540,8695
2280,31245,31961,31231,730,31231,31231,31961,31090,871,31090
2281,48706,50580,49056,1524,49056,48706,50585,48084,2501,48084
2282,2108,2181,2348,-167,2181,2108,2182,2059,123,2059
2283,136522,135478,135690,-212,135478,135478,135477,133214,2263,133214
2284,135337,108590,104930,3660,104930,104930,108659,104106,4553,104106
2285,17164,17162,16951,211,16951,16951,17164,16756,408,16756
2286,33527,33530,32067,1463,32067,32067,33527,31437,2090,31437
2287,9400,9368,9149,219,9149,9149,9377,8480,897,8480
2288,46683,45888,44513,1375,44513,44513,45888,44020,1868,44020
2289,324206,339283,324105,15178,324105,324105,339269,322896,16373,322896
2290,6810,7191,7542,-351,7191,6810,7191,6769,422,6769
2291,178201,178183,169033,9150,169033,169033,178201,168633,9568,168633
2292,10849,10352,10299,53,10299,10299,10354,10227,127,10227
2293,122390,121446,116621,4825,116621,116621,121501,115393,6108,115393
2294,4863,4786,4821,-35,4786,4786,4785,4682,103,4682
2295,10840,10880,10836,44,10836,10836,10879,10601,278,10601
2296,45937,47365,46352,1013,46352,45937,47370,46150,1220,45937
2297,114922,107739,102964,4775,102964,102964,107639,101616,6023,101616
2298,292185,289014,269688,19326,269688,269688,289023,264545,24478,264545
2299,1355,516,753,-237,516,516,515,559,-44,559
2300,2562,2160,2317,-157,2160,2160,2160,2191,-31,2191
2301,9426,8895,8686,209,8686,8686,8888,8427,461,8427
2302,25028,24502,23558,944,23558,23558,24498,23373,1125,23373
2303,23749,23037,23269,-232,23037,23037,23057,23127,-70,23127
2304,80392,79690,76749,2941,76749,76749,79724,76457,3267,76457
2305,42496,43651,42419,1232,42419,42419,43663,40695,2968,40695
2306,6610,5771,5956,-185,5771,5771,5770,5639,131,5639
2307,4076,3642,3826,-184,3642,3642,3641,3670,-29,3670
2308,9013,8654,8558,96,8558,8558,8658,8442,216,8442
2309,13261,12359,12189,170,12189,12189,12353,12080,273,12080
2310,3330,3428,3637,-209,3428,3330,3427,3322,105,3322
2311,8905,8912,9134,-222,8912,8905,8905,8794,111,8794
2312,4536,4536,4381,155,4381,4381,4536,4281,255,4281
2313,5747,5888,5746,142,5746,5746,5888,5616,272,5616
2314,4997,5201,5370,-169,5201,4997,5202,4375,827,4375
2315,4833,4835,4835,0,4835,4833,4834,4721,113,4721
2316,18903,19342,19025,317,19025,18903,19344,18895,449,18895
2317,10589,10175,10037,138,10037,10037,10176,9896,280,9896
2318,96375,94922,91041,3881,91041,91041,94901,90787,4114,90787
2319,29913,29013,28391,622,28391,28391,29003,26295,2708,26295
2320,41555,42668,41586,1082,41586,41555,42652,41555,1097,41555
2321,69384,46125,44499,1626,44499,44499,46151,43315,2836,43315
2322,22506,21666,21926,-260,21666,21666,21675,14704,6971,14704
2323,103530,80969,78337,2632,78337,78337,80972,77872,3100,77872
2324,90592,70911,69504,1407,69504,69504,70933,68976,1957,68976
2325,379910,396283,381555,14728,381555,379910,396183,379869,16314,379869
2326,14895,14890,14699,191,14699,14699,14895,14537,358,14537
2327,50002,49156,48329,827,48329,48329,49157,47919,1238,47919
2328,134555,138497,140239,-1742,138497,134555,138550,136453,2097,134555
2329,27464,28238,27449,789,27449,27449,28227,27292,935,27292
2330,8849,8465,8411,54,8411,8411,8471,8290,181,8290
2331,8211,8410,8330,80,8330,8211,8410,8178,232,8178
2332,11250,9722,9508,214,9508,9508,9722,9396,326,9396
2333,195,195,315,-120,195,195,195,188,7,188
2334,10914,10906,10177,729,10177,10177,10914,9768,1146,9768
2335,52545,53702,52532,1170,52532,52532,53717,52135,1582,52135
2336,34942,34893,34478,415,34478,34478,34906,34320,586,34320
2337,4277,4035,4216,-181,4035,4035,4034,4031,3,4031
2338,22089,21529,20556,973,20556,20556,21511,20424,1087,20424
2339,19858,19852,19272,580,19272,19272,19858,19144,714,19144
2340,1004919,1003747,958869,44878,958869,958869,1004110,951010,53100,951010
2341,15206,15206,15078,128,15078,15078,15206,14967,239,14967
2342,14385,14393,14247,146,14247,14247,14385,14026,359,14026
2343,12768,12772,12705,67,12705,12705,12768,12419,349,12419
2344,11627,11617,11737,-120,11617,11617,11627,11463,164,11463
2345,87432,83922,82512,1410,82512,82512,84002,81485,2517,81485
2346,51439,51171,51061,110,51061,51061,51187,49842,1345,49842
2347,2543,2371,2570,-199,2371,2371,2371,2437,-66,2437
2348,8052,7586,7691,-105,7586,7586,7589,7500,89,7500
2349,16760,16757,16463,294,16463,16463,16760,16290,470,16290
2350,17623,17627,17197,430,17197,17197,17623,17024,599,17024
2351,72415,69131,65510,3621,65510,65510,69151,64655,4496,64655
2352,117903,114664,114208,456,114208,114208,114678,112669,2009,112669
2353,12692,12695,12701,-6,12695,12692,12692,12475,217,12475
2354,16055,16053,15718,335,15718,15718,16055,15571,484,15571
2355,1184,344,581,-237,344,344,344,390,-46,390
2356,16191,15719,15237,482,15237,15237,15724,15102,622,15102
2357,8111,8113,8323,-210,8113,8111,8111,7988,123,7988
2358,124583,133544,124578,8966,124578,124578,133537,123154,10383,123154
2359,23063,23059,22455,604,22455,22455,23063,22283,780,22283
2360,12031,11592,11544,48,11544,11544,11593,11336,257,11336
2361,3876,4039,4188,-149,4039,3876,4038,3859,179,3859
2362,1731,768,1021,-253,768,768,767,817,-50,817
2363,14162,14161,14051,110,14051,14051,14162,13800,362,13800
2364,87681,85687,79968,5719,79968,79968,85656,79619,6037,79619
2365,16162,16161,15927,234,15927,15927,16162,15732,430,15732
2366,14468,14474,14425,49,14425,14425,14468,14158,310,14158
2367,17788,17782,17265,517,17265,17265,17788,17136,652,17136
2368,32512,32473,31063,1410,31063,31063,32477,29296,3181,29296
2369,10086,9596,9677,-81,9596,9596,9604,9464,140,9464
2370,15494,15489,15250,239,15250,15250,15494,15068,426,15068
2371,18017,18013,17884,129,17884,17884,18017,17665,352,17665
2372,17326,17325,17008,317,17008,17008,17326,16775,551,16775
2373,5954,5769,5893,-124,5769,5769,5775,5333,442,5333
2374,9037,9030,9236,-206,9030,9030,9037,8985,52,8985
2375,16117,15573,15279,294,15279,15279,15569,15002,567,15002
2376,255513,226553,225566,987,225566,225566,226617,223047,3570,223047
2377,25521,26149,25511,638,25511,25511,26157,25334,823,25334
2378,740196,749185,708354,40831,708354,708354,749287,702931,46356,702931
2379,247617,245517,235077,10440,235077,235077,245483,234293,11190,234293
2380,11999,11381,11603,-222,11381,11381,11380,11377,3,11377
2381,2943,2530,2723,-193,2530,2530,2529,2567,-38,2567
2382,254257,258328,250409,7919,250409,250409,258387,248943,9444,248943
2383,61629,63133,59512,3621,59512,59512,63154,58904,4250,58904
2384,190361,183778,184010,-232,183778,183778,183679,181491,2188,181491
2385,23888,23888,23575,313,23575,23575,23888,23450,438,23450
2386,23888,23888,23575,313,23575,23575,23888,23450,438,23450
2387,8650,7982,8133,-151,7982,7982,7982,7931,51,7931
2388,33431,32725,32214,511,32214,32214,32730,31762,968,31762
2389,11400,11453,11338,115,11338,11338,11456,11076,380,11076
2390,19518,11591,11641,-50,11591,11591,11593,11390,203,11390
2391,216696,229901,224835,5066,224835,216696,229946,216074,13872,216074
2392,573555,503379,486363,17016,486363,486363,503449,476538,26911,476538
2393,66104,66093,62613,3480,62613,62613,66104,62256,3848,62256
2394,17052,19441,19212,229,19212,17052,19446,17044,2402,17044
2395,54833,42744,38887,3857,38887,38887,42760,37052,5708,37052
2396,166985,166093,163829,2264,163829,163829,166090,162924,3166,162924
2397,3594,3078,3240,-162,3078,3078,3079,3011,68,3011
2398,62771,61670,62210,-540,61670,61670,61672,60762,910,60762
2399,87516,90017,86783,3234,86783,86783,90028,84842,5186,84842
2400,18671,18678,18594,84,18594,18594,18671,18398,273,18398
2401,46089,47145,46088,1057,46088,46088,47188,45318,1870,45318
2402,5927,6099,5923,176,5923,5923,6094,5613,481,5613
2403,31333,4635,4737,-102,4635,4635,4632,4540,92,4540
2404,30163,30548,29308,1240,29308,29308,30592,29066,1526,29066
2405,23322,10675,10671,4,10671,10671,10671,10282,389,10282
2406,41074,34201,32909,1292,32909,32909,34214,30571,3643,30571
2407,868,848,1118,-270,848,848,847,904,-57,868
2408,56371,38750,37570,1180,37570,37570,38738,36836,1902,36836
2409,12184,12188,11590,598,11590,11590,12184,11249,935,11249
2410,20455,20453,20027,426,20027,20027,20455,19891,564,19891
2411,177691,176832,177223,-391,176832,176832,176792,174650,2142,174650
2412,17943,17887,17946,-59,17887,17887,17891,17556,335,17556
2413,74750,77972,74368,3604,74368,74368,77978,74128,3850,74128
2414,39519,15854,14899,955,14899,14899,15856,14078,1778,14078
2415,4630,4029,4198,-169,4029,4029,4027,4056,-29,4056
2416,131799,131845,127574,4271,127574,127574,131799,125449,6350,125449
2417,97987,98450,96197,2253,96197,96197,98421,92550,5871,92550
2418,30665,18922,18365,557,18365,18365,18936,18059,877,18059
2419,2492,2239,2425,-186,2239,2239,2240,2278,-38,2278
2420,271790,271765,251385,20380,251385,251385,271790,249978,21812,249978
2421,23709,24976,24099,877,24099,23709,24968,23629,1339,23629
2422,1760,1761,1943,-182,1761,1760,1760,1803,-43,1760
2423,3058,3014,3239,-225,3014,3014,3013,3084,-71,3058
2424,2526,2127,2355,-228,2127,2127,2127,2142,-15,2142
2425,2035,1111,1349,-238,1111,1111,1111,1173,-62,1173
2426,31394,31404,30578,826,30578,30578,31394,30394,1000,30394
2427,32682,33391,32599,792,32599,32599,33391,32497,894,32497
2428,22095,9182,9004,178,9004,9004,9186,8424,762,8424
2429,15859,4700,4938,-238,4700,4700,4700,4219,481,4219
2430,19145,6431,6485,-54,6431,6431,6432,5780,652,5780
2431,23024,23889,23013,876,23013,23013,23884,22866,1018,22866
2432,76369,75412,72372,3040,72372,72372,75394,72022,3372,72022
2433,20019,19083,18123,960,18123,18123,19092,17542,1550,17542
2434,29114,29812,29104,708,29104,29104,29817,28894,923,28894
2435,23160,23119,22844,275,22844,22844,23130,22620,510,22620
2436,6784,6760,6784,-24,6760,6760,6760,6438,322,6438
2437,46464,45559,44962,597,44962,44962,45551,44075,1476,44075
2438,31229,32036,31215,821,31215,31215,32041,31078,963,31078
2439,27151,25267,24246,1021,24246,24246,25267,24117,1150,24117
2440,10108,10032,10104,-72,10032,10032,10030,9848,182,9848
2441,6877,6874,7182,-308,6874,6874,6877,6564,313,6564
2442,71557,71564,69168,2396,69168,69168,71557,68566,2991,68566
2443,185425,184536,173861,10675,173861,173861,184590,170216,14374,170216
2444,79665,79641,77642,1999,77642,77642,79632,76813,2819,76813
2445,4620,3698,4083,-385,3698,3698,3700,3561,139,3561
2446,21012,17379,16760,619,16760,16760,17384,16433,951,16433
2447,17355,16458,15747,711,15747,15747,16460,15549,911,15549
2448,781,361,600,-239,361,361,361,410,-49,410
2449,27245,27091,26370,721,26370,26370,27082,26057,1025,26057
2450,16690,16687,16384,303,16384,16384,16690,16259,431,16259
2451,173209,177972,179534,-1562,177972,173209,178075,176411,1664,173209
2452,40486,39906,38134,1772,38134,38134,39892,38042,1850,38042
2453,273562,272696,267240,5456,267240,267240,272741,264153,8588,264153
2454,115271,120020,115240,4780,115240,115240,120008,115298,4710,115271
2455,6654,5663,5435,228,5435,5435,5665,5030,635,5030
2456,47253,49391,47260,2131,47260,47253,49417,47044,2373,47044
2457,8641,7844,7941,-97,7844,7844,7848,7666,182,7666
2458,142981,135974,130934,5040,130934,130934,135932,130647,5285,130647
2459,28800,26161,25574,587,25574,25574,26158,25525,633,25525
2460,25256,26105,25817,288,25817,25256,26116,24820,1296,24820
2461,85290,85277,85494,-217,85277,85277,85262,82651,2611,82651
2462,465484,430597,410496,20101,410496,410496,430526,407694,22832,407694
2463,43800,43597,40356,3241,40356,40356,43599,39040,4559,39040
2464,14641,14643,14376,267,14376,14376,14641,14309,332,14309
2465,2660,2086,2323,-237,2086,2086,2085,2038,47,2038
2466,145128,145061,138763,6298,138763,138763,145067,138355,6712,138355
2467,11674,11055,11054,1,11054,11054,11060,10878,182,10878
2468,5572,4965,5185,-220,4965,4965,4971,4823,148,4823
2469,35957,34424,33716,708,33716,33716,34439,33158,1281,33158
2470,9828,9822,9997,-175,9822,9822,9828,9757,71,9757
2471,6107,3528,3633,-105,3528,3528,3530,3399,131,3399
2472,47868,31849,31178,671,31178,31178,31862,30425,1437,30425
2473,31330,31346,30328,1018,30328,30328,31330,30187,1143,30187
2474,137212,136311,135794,517,135794,135794,136329,133514,2815,133514
2475,101660,101555,100389,1166,100389,100389,101559,99410,2149,99410
2476,45667,22689,21495,1194,21495,21495,22685,19759,2926,19759
2477,159075,151929,145280,6649,145280,145280,151953,144255,7698,144255
2478,30479,27302,27070,232,27070,27070,27317,26844,473,26844
2479,16572,7362,7268,94,7268,7268,7362,7198,164,7198
2480,73055,43703,41344,2359,41344,41344,43717,41118,2599,41118
2481,864,848,1113,-265,848,848,848,902,-54,864
2482,10433,9771,9676,95,9676,9676,9768,9467,301,9467
2483,2422,2254,2360,-106,2254,2254,2254,2131,123,2131
2484,13633,12976,13236,-260,12976,12976,12984,12900,84,12900
2485,34618,33721,32791,930,32791,32791,33726,32701,1025,32701
2486,60564,60556,59069,1487,59069,59069,60582,58485,2097,58485
2487,9363,9366,9343,23,9343,9343,9363,9151,212,9151
2488,22880,22878,22267,611,22267,22267,22880,22122,758,22122
2489,48797,47831,45387,2444,45387,45387,47839,44023,3816,44023
2490,9144,9139,8961,178,8961,8961,9144,8844,300,8844
2491,2035,1073,1296,-223,1073,1073,1073,1127,-54,1127
2492,105567,111164,105807,5357,105807,105567,111176,105748,5428,105567
2493,23267,23056,23161,-105,23056,23056,23078,22921,157,22921
2494,616,321,555,-234,321,321,321,349,-28,349
2495,10125,9291,9054,237,9054,9054,9289,8934,355,8934
2496,15240,15796,15262,534,15262,15240,15799,14618,1181,14618
2497,36594,23571,23506,65,23506,23506,23579,22805,774,22805
2498,10579,10577,10545,32,10545,10545,10580,10363,217,10363
2499,27928,27241,25986,1255,25986,25986,27242,25907,1335,25907
2500,4907,4430,4410,20,4410,4410,4431,4292,139,4292
2501,14292,14291,13888,403,13888,13888,14292,13767,525,13767
2502,23392,17013,16618,395,16618,16618,17002,16469,533,16469
2503,107260,74965,72679,2286,72679,72679,75010,71346,3664,71346
2504,107859,112849,107856,4993,107856,107856,112798,104553,8245,104553
2505,38451,40936,38440,2496,38440,38440,40944,38377,2567,38377
2506,83457,86025,82869,3156,82869,82869,86024,80846,5178,80846
2507,50500,50509,48309,2200,48309,48309,50532,47793,2739,47793
2508,20326,18899,18562,337,18562,18562,18911,18282,629,18282
2509,28050,29573,29027,546,29027,28050,29589,28042,1547,28042
2510,22585,22594,21859,735,21859,21859,22585,21731,854,21731
2511,152411,150645,143561,7084,143561,143561,150633,142338,8295,142338
2512,95944,73334,71586,1748,71586,71586,73312,70783,2529,70783
2513,25467,22024,21373,651,21373,21373,22024,21324,700,21324
2514,31911,30804,28856,1948,28856,28856,30796,28808,1988,28808
2515,3014,2940,3014,-74,2940,2940,2940,2874,66,2874
2516,263042,250085,241526,8559,241526,241526,250211,239226,10985,239226
2517,190327,189403,180859,8544,180859,180859,189341,179486,9855,179486
2518,4128,4043,4123,-80,4043,4043,4044,3801,243,3801
2519,85541,89948,86025,3923,86025,85541,89948,85647,4301,85541
2520,122662,119964,119302,662,119302,119302,120032,118062,1970,118062
2521,368756,367966,356755,11211,356755,356755,367882,353175,14707,353175
2522,879,880,1121,-241,880,879,879,927,-48,879
2523,369164,344408,342274,2134,342274,342274,344441,332707,11734,332707
2524,13921,13921,13898,23,13898,13898,13921,13824,97,13824
2525,157637,157609,151519,6090,151519,151519,157637,150929,6708,150929
2526,10202,9201,9262,-61,9201,9201,9203,8906,297,8906
2527,1343,1302,1543,-241,1302,1302,1301,1332,-31,1332
2528,2841,2265,2439,-174,2265,2265,2266,2219,47,2219
2529,2111,1146,1375,-229,1146,1146,1146,1198,-52,1198
2530,40802,41354,40791,563,40791,40791,41366,40375,991,40375
2531,37493,37603,37974,-371,37603,37493,37615,37299,316,37299
2532,10350,10921,10284,637,10284,10284,10928,9558,1370,9558
2533,692343,732810,692264,40546,692264,692264,732728,688747,43981,688747
2534,53712,52100,49743,2357,49743,49743,52084,49182,2902,49182
2535,34024,29330,29452,-122,29330,29330,29347,28692,655,28692
2536,179664,179615,174238,5377,174238,174238,179664,173291,6373,173291
2537,19845,18638,18744,-106,18638,18638,18642,18467,175,18467
2538,110039,100089,95433,4656,95433,95433,100047,94362,5685,94362
2539,20723,21287,20713,574,20713,20713,21287,20587,700,20587
2540,13998,13070,12980,90,12980,12980,13064,12643,421,12643
2541,11464,11623,11662,-39,11623,11464,11629,11464,165,11464
2542,206797,175175,169679,5496,169679,169679,175216,167873,7343,167873
2543,7519,7551,7792,-241,7551,7519,7551,7511,40,7511
2544,149103,148202,145743,2459,145743,145743,148240,141487,6753,141487
2545,373115,342467,323957,18510,323957,323957,342527,323097,19430,323097
2546,8819,8819,8698,121,8698,8698,8819,8384,435,8384
2547,9115,8732,9118,-386,8732,8732,8739,8748,-9,8748
2548,5413,5556,5641,-85,5556,5413,5555,4791,764,4791
2549,36784,10067,10031,36,10031,10031,10070,9784,286,9784
2550,6726,6646,6781,-135,6646,6646,6643,6606,37,6606
2551,15845,16071,15844,227,15844,15844,16063,15640,423,15640
2552,75677,71112,71031,81,71031,71031,71136,70143,993,70143
2553,6149,6151,6103,48,6103,6103,6149,5898,251,5898
2554,9218,9216,9052,164,9052,9052,9218,9012,206,9012
2555,8931,8269,8122,147,8122,8122,8273,8049,224,8049
2556,393440,376093,352823,23270,352823,352823,376027,349724,26303,349724
2557,43153,45769,43063,2706,43063,43063,45783,42728,3055,42728
2558,18020,18729,17958,771,17958,17958,18726,17778,948,17778
2559,8798,8401,8380,21,8380,8380,8403,8224,179,8224
2560,21827,2493,2694,-201,2493,2493,2492,2546,-54,2546
2561,20542,21051,20835,216,20835,20542,21060,20575,485,20542
2562,88237,73871,72327,1544,72327,72327,73930,69173,4757,69173
2563,24680,24609,23812,797,23812,23812,24619,23631,988,23631
2564,2832,2448,2633,-185,2448,2448,2448,2453,-5,2453
2565,21561,20205,18959,1246,18959,18959,20217,18937,1280,18937
2566,136029,139390,135454,3936,135454,135454,139428,135407,4021,135407
2567,156525,123735,122845,890,122845,122845,123753,121991,1762,121991
2568,37525,37482,37420,62,37420,37420,37499,36172,1327,36172
2569,151658,151594,146090,5504,146090,146090,151658,142454,9204,142454
2570,1627,1627,1866,-239,1627,1627,1627,1676,-49,1627
2571,150137,150155,142332,7823,142332,142332,150137,140475,9662,140475
2572,165267,164306,154497,9809,154497,154497,164326,148564,15762,148564
2573,2858,1953,2133,-180,1953,1953,1953,1906,47,1906
2574,31716,31273,30395,878,30395,30395,31266,30190,1076,30190
2575,204401,162620,158593,4027,158593,158593,162646,158178,4468,158178
2576,10515,9674,9314,360,9314,9314,9674,8891,783,8891
2577,8747,7975,7985,-10,7975,7975,7973,7626,347,7626
2578,1777225,1658601,1637847,20754,1637847,1637847,1658692,1617068,41624,1617068
2579,578629,538524,512462,26062,512462,512462,538530,506011,32519,506011
2580,14929,13993,13767,226,13767,13767,13985,13437,548,13437
2581,10403,9595,9427,168,9427,9427,9601,9096,505,9096
2582,35046,16038,15715,323,15715,15715,16027,15051,976,15051
2583,51659,50273,48058,2215,48058,48058,50276,47284,2992,47284
2584,41826,45569,44582,987,44582,41826,45589,37394,8195,37394
2585,74873,29262,30833,-1571,29262,29262,29283,28876,407,28876
2586,6096,5188,5352,-164,5188,5188,5186,5222,-36,5222
2587,4728,4647,4669,-22,4647,4647,4641,4480,161,4480
2588,72925,71720,71400,320,71400,71400,71723,70510,1213,70510
2589,50676,49392,47221,2171,47221,47221,49389,47116,2273,47116
2590,50154,45880,41974,3906,41974,41974,45879,41790,4089,41790
2591,38440,14818,14251,567,14251,14251,14824,14109,715,14109
2592,10029,9279,9359,-80,9279,9279,9273,9160,113,9160
2593,5139,1134,1373,-239,1134,1134,1134,1180,-46,1180
2594,66850,66849,64382,2467,64382,64382,66850,63995,2855,63995
2595,7992,6909,6946,-37,6909,6909,6911,6553,358,6553
2596,74222,54941,54004,937,54004,54004,54958,53346,1612,53346
2597,191257,199097,191236,7861,191236,191236,199051,190792,8259,190792
2598,12038,12145,12176,-31,12145,12038,12143,11991,152,11991
2599,16575,16704,16961,-257,16704,16575,16714,16595,119,16575
2600,21629,5861,6063,-202,5861,5861,5866,5790,76,5790
2601,83664,49793,48246,1547,48246,48246,49802,47857,1945,47857
2602,50668,43587,41873,1714,41873,41873,43590,41650,1940,41650
2603,4665,4165,4253,-88,4165,4165,4167,4031,136,4031
2604,208716,212613,210723,1890,210723,208716,212642,208708,3934,208708
2605,339699,256631,251484,5147,251484,251484,256667,250104,6563,250104
2606,29524,26471,26803,-332,26471,26471,26486,25639,847,25639
2607,210144,178723,172589,6134,172589,172589,178677,170974,7703,170974
2608,36210,36210,35164,1046,35164,35164,36210,35106,1104,35106
2609,42397,41474,41684,-210,41474,41474,41492,40391,1101,40391
2610,111691,111369,111648,-279,111369,111369,111445,108020,3425,108020
2611,18339,18908,18340,568,18340,18339,18907,18286,621,18286
2612,13144,13321,13202,119,13202,13144,13326,13099,227,13099
2613,66527,65410,62554,2856,62554,62554,65407,61873,3534,61873
2614,14220,24421,24938,-517,24421,14220,24422,13817,10605,13817
2615,300979,317374,300944,16430,300944,300944,317296,301285,16011,300979
2616,179074,176924,168906,8018,168906,168906,176961,168595,8366,168595
2617,217229,217178,205698,11480,205698,205698,217247,203996,13251,203996
2618,37055,18651,18405,246,18405,18405,18652,18164,488,18164
2619,2428,2095,2322,-227,2095,2095,2096,2089,7,2089
2620,45478,44219,42341,1878,42341,42341,44218,42263,1955,42263
2621,149682,159179,149650,9529,149650,149650,159277,149048,10229,149048
2622,1971029,1934877,1848474,86403,1848474,1848474,1934712,1833729,100983,1833729
2623,2127,1742,1908,-166,1742,1742,1743,1762,-19,1762
2624,407300,406320,400448,5872,400448,400448,406350,395403,10947,395403
2625,118951,125187,120554,4633,120554,118951,125197,119013,6184,118951
2626,31475,30287,30878,-591,30287,30287,30311,29926,385,29926
2627,7913,6985,6669,316,6669,6669,6990,6367,623,6367
2628,45560,34170,31705,2465,31705,31705,34158,30924,3234,30924
2629,885,845,1086,-241,845,845,845,889,-44,885
2630,301122,295311,277660,17651,277660,277660,295369,277315,18054,277315
2631,586,559,802,-243,559,559,559,604,-45,586
2632,2187,1266,1495,-229,1266,1266,1265,1320,-55,1320
2633,8648,8646,8950,-304,8646,8646,8648,8644,4,8644
2634,1378496,38562,37004,1558,37004,37004,38574,36090,2484,36090
2635,118716,120882,118701,2181,118701,118701,120919,116863,4056,116863
2636,395505,366182,352955,13227,352955,352955,366092,350677,15415,350677
2637,2727,2284,2520,-236,2284,2284,2285,2324,-39,2324
2638,35564,35645,35556,89,35556,35556,35635,33103,2532,33103
2639,26247,23823,22673,1150,22673,22673,23818,22464,1354,22464
2640,74048,74076,70924,3152,70924,70924,74048,69480,4568,69480
2641,35597,34749,34514,235,34514,34514,34752,34116,636,34116
2642,6309,5868,5899,-31,5868,5868,5866,5756,110,5756
2643,6586,3138,3289,-151,3138,3138,3139,3141,-2,3141
2644,45703,45680,43172,2508,43172,43172,45670,41926,3744,41926
2645,12009,12008,11764,244,11764,11764,12009,11701,308,11701
2646,51145,49388,46011,3377,46011,46011,49393,45679,3714,45679
2647,38963,40044,38954,1090,38954,38954,40045,38922,1123,38922
2648,150830,155410,154858,552,154858,150830,155396,152707,2689,150830
2649,1369,395,652,-257,395,395,395,452,-57,452
2650,8321,8328,8369,-41,8328,8321,8321,8200,121,8200
2651,3075,2663,2817,-154,2663,2663,2663,2662,1,2662
2652,5807,5806,5897,-91,5806,5806,5807,5734,73,5734
2653,57296,52597,49656,2941,49656,49656,52610,49336,3274,49336
2654,12734,9545,9303,242,9303,9303,9541,9175,366,9175
2655,5318,4804,4993,-189,4804,4804,4804,4761,43,4761
2656,26457,26431,26155,276,26155,26155,26437,25871,566,25871
2657,26457,26431,26155,276,26155,26155,26437,25871,566,25871
2658,78422,80241,78027,2214,78027,78027,80248,77642,2606,77642
2659,5322,4282,4378,-96,4282,4282,4280,4276,4,4276
2660,140430,138509,138937,-428,138509,138509,138560,134617,3943,134617
2661,233929,238542,233890,4652,233890,233890,238600,233094,5506,233094
2662,6909,7160,7180,-20,7160,6909,7159,6955,204,6909
2663,29838,28984,27753,1231,27753,27753,28978,27690,1288,27690
2664,3148,3145,3403,-258,3145,3145,3148,3110,38,3110
2665,42900,21617,21099,518,21099,21099,21615,20363,1252,20363
2666,1458,1458,1831,-373,1458,1458,1458,1157,301,1157
2667,17102,4217,4422,-205,4217,4217,4217,4296,-79,4296
2668,9644,9648,9491,157,9491,9491,9644,9213,431,9213
2669,10166,10152,10170,-18,10152,10152,10153,9947,206,9947
2670,51849,48281,46118,2163,46118,46118,48276,45856,2420,45856
2671,29286,13823,13654,169,13654,13654,13821,13607,214,13607
2672,61223,61229,60629,600,60629,60629,61223,60097,1126,60097
2673,11640,11981,12002,-21,11981,11640,11982,11640,342,11640
2674,2788,2603,2726,-123,2603,2603,2602,2565,37,2565
2675,802,462,700,-238,462,462,462,507,-45,507
2676,229919,209761,198511,11250,198511,198511,209781,196360,13421,196360
2677,83676,83623,79558,4065,79558,79558,83637,78926,4711,78926
2678,102195,102102,99472,2630,99472,99472,102128,98325,3803,98325
2679,17486,4551,4801,-250,4551,4551,4551,4618,-67,4618
2680,2853,2751,2984,-233,2751,2751,2750,2786,-36,2786
2681,7811,7251,7439,-188,7251,7251,7251,7189,62,7189
2682,312,293,525,-232,293,293,293,338,-45,312
2683,39282,37599,35662,1937,35662,35662,37603,35486,2117,35486
2684,12121,11184,10977,207,10977,10977,11185,10759,426,10759
2685,5110,4143,4357,-214,4143,4143,4142,4176,-34,4176
2686,9805,8992,8707,285,8707,8707,8998,8470,528,8470
2687,894,525,780,-255,525,525,526,575,-49,575
2688,712495,669524,641291,28233,641291,641291,669783,635937,33846,635937
2689,31358,32062,31352,710,31352,31352,32061,31247,814,31247
2690,161770,166299,164694,1605,164694,161770,166368,162967,3401,161770
2691,57873,56527,55731,796,55731,55731,56520,54613,1907,54613
2692,6254,6163,6252,-89,6163,6163,6161,6008,153,6008
2693,85682,87300,85671,1629,85671,85671,87372,85143,2229,85143
2694,10219,10532,10315,217,10315,10219,10530,10147,383,10147
2695,3557,2721,2861,-140,2721,2721,2720,2608,112,2608
2696,4230,3229,3392,-163,3229,3229,3230,3234,-4,3234
2697,33004,34506,33003,1503,33003,33003,34493,32741,1752,32741
2698,122063,116870,110729,6141,110729,110729,116873,107539,9334,107539
2699,394489,393659,377810,15849,377810,377810,393576,376118,17458,376118
2700,83907,87941,86172,1769,86172,83907,87919,83285,4634,83285
2701,2425,2047,2289,-242,2047,2047,2048,2094,-46,2094
2702,9082,2654,2849,-195,2654,2654,2653,2709,-56,2709
2703,58821,33984,32940,1044,32940,32940,33982,32535,1447,32535
2704,44925,42425,40181,2244,40181,40181,42415,39699,2716,39699
2705,407099,392607,365381,27226,365381,365381,392606,362342,30264,362342
2706,30190,29265,28950,315,28950,28950,29263,26811,2452,26811
2707,24046,24370,24043,327,24043,24043,24374,23808,566,23808
2708,66259,57314,55891,1423,55891,55891,57361,55235,2126,55235
2709,9570,5582,5731,-149,5582,5582,5583,5614,-31,5614
2710,3996,3386,3568,-182,3386,3386,3386,3422,-36,3422
2711,7399,7339,7411,-72,7339,7339,7338,7179,159,7179
2712,22740,7562,7855,-293,7562,7562,7567,7327,240,7327
2713,41863,19712,19502,210,19502,19502,19715,19371,344,19371
2714,134697,138989,136754,2235,136754,134697,139079,135297,3782,134697
2715,139291,135987,128742,7245,128742,128742,135979,127935,8044,127935
2716,527835,526890,505292,21598,505292,505292,526905,497370,29535,497370
2717,118206,124796,118208,6588,118208,118206,124743,117808,6935,117808
2718,3956377,3810850,3652113,158737,3652113,3652113,3810450,3632676,177774,3632676
2719,3503,3501,3701,-200,3501,3501,3503,3409,94,3409
2720,16639,16588,16757,-169,16588,16588,16596,16317,279,16317
2721,43132,18766,18517,249,18517,18517,18761,18144,617,18144
2722,13043,13040,12959,81,12959,12959,13043,12755,288,12755
2723,28501,27636,28495,-859,27636,27636,27638,27694,-56,27694
2724,24858,24016,24244,-228,24016,24016,24019,12775,11244,12775
2725,34782,33926,32955,971,32955,32955,33926,32707,1219,32707
2726,3461,1030,1256,-226,1030,1030,1031,1087,-56,1087
2727,110369,112900,111733,1167,111733,110369,112918,110703,2215,110369
2728,34107,33392,32265,1127,32265,32265,33389,32031,1358,32031
2729,13166,13197,13163,34,13163,13163,13196,12972,224,12972
2730,12525,12074,12123,-49,12074,12074,12080,11874,206,11874
2731,81034,72886,71569,1317,71569,71569,72922,71307,1615,71307
2732,6254,6247,6251,-4,6247,6247,6248,6048,200,6048
2733,114386,96903,92307,4596,92307,92307,96899,91195,5704,91195
2734,132614,132649,127244,5405,127244,127244,132614,126992,5622,126992
2735,15090,16161,15027,1134,15027,15027,16169,14914,1255,14914
2736,8256,7773,7777,-4,7773,7773,7776,7618,158,7618
2737,14064,14008,14145,-137,14008,14008,14012,13887,125,13887
2738,11236,11214,11248,-34,11214,11214,11214,11026,188,11026
2739,43569,27384,26598,786,26598,26598,27383,26484,899,26484
2740,17654,16663,16662,1,16662,16662,16675,16408,267,16408
2741,142698,146597,142617,3980,142617,142617,146593,141758,4835,141758
2742,31816,32827,32872,-45,32827,31816,32821,31816,1005,31816
2743,9138,9072,8766,306,8766,8766,9077,8679,398,8679
2744,9393,9391,9366,25,9366,9366,9393,9203,190,9203
2745,3191,2200,2430,-230,2200,2200,2205,2264,-59,2264
2746,18956,18359,17938,421,17938,17938,18362,17727,635,17727
2747,17093,17090,16882,208,16882,16882,17093,16705,388,16705
2748,62417,61311,60174,1137,60174,60174,61312,59293,2019,59293
2749,74118,59603,59102,501,59102,59102,59638,58328,1310,58328
2750,78636,75354,75535,-181,75354,75354,75353,73957,1396,73957
2751,7275,6849,6730,119,6730,6730,6851,6606,245,6606
2752,2831,2455,2578,-123,2455,2455,2455,2449,6,2449
2753,10739,10740,10575,165,10575,10575,10739,10025,714,10025
2754,702047,14215,14173,42,14173,14173,14224,13496,728,13496
2755,4466,3925,3949,-24,3925,3925,3926,3794,132,3794
2756,23511,23666,23507,159,23507,23507,23674,23325,349,23325
2757,292148,254785,246014,8771,246014,246014,254785,242567,12218,242567
2758,189454,188564,180703,7861,180703,180703,188592,178734,9858,178734
2759,3218,2310,2536,-226,2310,2310,2308,2282,26,2282
2760,33076,15388,15243,145,15243,15243,15392,14878,514,14878
2761,92380,49928,49369,559,49369,49369,49945,48546,1399,48546
2762,23924,24756,23924,832,23924,23924,24761,23760,1001,23760
2763,54845,53527,51870,1657,51870,51870,53548,51198,2350,51198
2764,11411,11412,11377,35,11377,11377,11411,11216,195,11216
2765,38224,24576,23594,982,23594,23594,24582,23189,1393,23189
2766,5353,5340,5408,-68,5340,5340,5345,5219,126,5219
2767,283738,286277,285546,731,285546,283738,286453,283730,2723,283730
2768,67253,71385,67248,4137,67248,67248,71460,67101,4359,67101
2769,30262,30537,30262,275,30262,30262,30549,29680,869,29680
2770,2998,2900,2937,-37,2900,2900,2901,2732,169,2732
2771,151713,152077,151631,446,151631,151631,152101,148339,3762,148339
2772,3101,3100,3261,-161,3100,3100,3101,3085,16,3085
2773,1534628,1480526,1416219,64307,1416219,1416219,1480180,1394844,85336,1394844
2774,19478,20000,20673,-673,20000,19478,20007,19470,537,19470
2775,4299,4306,4434,-128,4306,4299,4308,4269,39,4269
2776,25221,23632,21987,1645,21987,21987,23640,21497,2143,21497
2777,139857,129455,123021,6434,123021,123021,129481,121744,7737,121744
2778,90857,86708,81596,5112,81596,81596,86707,81255,5452,81255
2779,3471,2632,2792,-160,2632,2632,2629,2622,7,2622
2780,36432,35469,34213,1256,34213,34213,35475,33988,1487,33988
2781,14127,13357,12927,430,12927,12927,13361,12825,536,12825
2782,4688,4689,4720,-31,4689,4688,4688,4549,139,4549
2783,13818,13271,13033,238,13033,13033,13264,12826,438,12826
2784,376583,354100,335065,19035,335065,335065,354179,330779,23400,330779
2785,75347,75269,72289,2980,72289,72289,75289,71816,3473,71816
2786,153135,156475,149938,6537,149938,149938,156497,149827,6670,149827
2787,16609,16881,16610,271,16610,16609,16887,16504,383,16504
2788,28125,9346,9612,-266,9346,9346,9343,9234,109,9234
2789,2187,1307,1503,-196,1307,1307,1309,1363,-54,1363
2790,56699,53157,52276,881,52276,52276,53151,51880,1271,51880
2791,41305,35388,31754,3634,31754,31754,35378,29512,5866,29512
2792,27580,21362,20661,701,20661,20661,21362,19721,1641,19721
2793,10619,10613,10453,160,10453,10453,10622,10161,461,10161
2794,25047,23637,22211,1426,22211,22211,23643,22151,1492,22151
2795,28146,27236,26602,634,26602,26602,27236,26454,782,26454
2796,301542,301334,302920,-1586,301334,301334,301560,291038,10522,291038
2797,83980,83403,80385,3018,80385,80385,83438,80012,3426,80012
2798,1889,1382,1562,-180,1382,1382,1382,1303,79,1303
2799,4782,3869,4079,-210,3869,3869,3868,3793,75,3793
2800,9705,9809,9642,167,9642,9642,9810,9448,362,9448
2801,36096,34757,34222,535,34222,34222,34763,33872,891,33872
2802,4268,3885,3974,-89,3885,3885,3882,3843,39,3843
2803,30658,30600,29754,846,29754,29754,30614,28892,1722,28892
2804,5246,4733,4832,-99,4733,4733,4735,4733,2,4733
2805,19363,1227,1452,-225,1227,1227,1229,1295,-66,1295
2806,42126,41247,39769,1478,39769,39769,41243,39670,1573,39670
2807,14708,15837,15655,182,15655,14708,15841,14776,1065,14708
2808,433611,429940,406803,23137,406803,406803,430058,400509,29549,400509
2809,26442,25183,24196,987,24196,24196,25180,24010,1170,24010
2810,28146,28089,27051,1038,27051,27051,28085,27001,1084,27001
2811,4422,3861,3931,-70,3861,3861,3863,3774,89,3774
2812,20247,20222,19783,439,19783,19783,20224,19350,874,19350
2813,5936,5937,5873,64,5873,5873,5936,5731,205,5731
2814,15735,15734,15681,53,15681,15681,15735,15592,143,15592
2815,70919,70842,71082,-240,70842,70842,70853,68805,2048,68805
2816,33562,34444,33556,888,33556,33556,34437,33426,1011,33426
2817,32023,32753,32019,734,32019,32019,32755,31881,874,31881
2818,58939,60338,58925,1413,58925,58925,60359,58529,1830,58529
2819,87456,86514,85084,1430,85084,85084,86510,82146,4364,82146
2820,2331,1966,2167,-201,1966,1966,1966,2007,-41,2007
2821,6841,5998,6115,-117,5998,5998,5997,5865,132,5865
2822,30528,3496,3750,-254,3496,3496,3496,3551,-55,3551
2823,103311,106824,104365,2459,104365,103311,106802,103291,3511,103291
2824,11067,11067,11092,-25,11067,11067,11067,10918,149,10918
2825,33393,30111,29652,459,29652,29652,30101,29553,548,29553
2826,1469,1143,1410,-267,1143,1143,1143,1194,-51,1194
2827,3430,3449,3645,-196,3449,3430,3448,3418,30,3418
2828,20454,20235,20110,125,20110,20110,20235,19832,403,19832
2829,2337247,2329995,2202549,127446,2202549,2202549,2330459,2189155,141304,2189155
2830,19345,19650,19339,311,19339,19339,19647,19232,415,19232
2831,29147,28592,27254,1338,27254,27254,28596,26991,1605,26991
2832,68925,68040,68065,-25,68040,68040,68059,58340,9719,58340
2833,1272,1232,1467,-235,1232,1232,1231,1290,-59,1272
2834,846163,809801,766842,42959,766842,766842,809792,762397,47395,762397
2835,3088,3125,3088,37,3088,3088,3124,2851,273,2851
2836,40130,36963,34671,2292,34671,34671,36978,34462,2516,34462
2837,701006,725695,709598,16097,709598,701006,725720,700998,24722,700998
2838,468,449,703,-254,449,449,449,488,-39,468
2839,92744,92629,87347,5282,87347,87347,92656,87047,5609,87047
2840,2853,2557,2750,-193,2557,2557,2557,2583,-26,2583
2841,274162,273184,272814,370,272814,272814,273302,254711,18591,254711
2842,14139,14136,13747,389,13747,13747,14139,13657,482,13657
2843,302543,265211,255260,9951,255260,255260,265356,253601,11755,253601
2844,28322,29266,28469,797,28469,28322,29273,28270,1003,28270
2845,9383,9377,9358,19,9358,9358,9383,9206,177,9206
2846,4528,3406,3668,-262,3406,3406,3407,3452,-45,3452
2847,35762,35680,34028,1652,34028,34028,35700,33847,1853,33847
2848,10846,10859,10875,-16,10859,10846,10859,10740,119,10740
2849,1203,1203,1431,-228,1203,1203,1203,1258,-55,1203
2850,16765,4191,4330,-139,4191,4191,4190,4138,52,4138
2851,36896,36917,34656,2261,34656,34656,36916,33800,3116,33800
2852,447376,447195,441111,6084,441111,441111,447376,432192,15184,432192
2853,1322248,108972,104752,4220,104752,104752,108975,103858,5117,103858
2854,12224,12225,12244,-19,12225,12224,12224,11974,250,11974
2855,13179,12044,11193,851,11193,11193,12039,11075,964,11075
2856,55487,55506,53885,1621,53885,53885,55487,53489,1998,53489
2857,246872,238227,229290,8937,229290,229290,238272,226413,11859,226413
2858,5241,5243,5272,-29,5243,5241,5241,4773,468,4773
2859,5188,4706,4666,40,4666,4666,4703,4590,113,4590
2860,10095,9246,9260,-14,9246,9246,9244,9042,202,9042
2861,39784,37867,35610,2257,35610,35610,37879,35554,2325,35554
2862,1407444,1344366,1276768,67598,1276768,1276768,1344555,1264494,80061,1264494
2863,219846,218825,209915,8910,209915,209915,218853,207440,11413,207440
2864,333819,314242,295382,18860,295382,295382,314047,294452,19595,294452
2865,7144,7145,7232,-87,7145,7144,7144,7073,71,7073
2866,133732,117525,115360,2165,115360,115360,117447,114399,3048,114399
2867,35047,34461,33945,516,33945,33945,34463,33690,773,33690
2868,4489,4485,4635,-150,4485,4485,4489,4471,18,4471
2869,21733,22510,22001,509,22001,21733,22513,21733,780,21733
2870,44829,29470,28972,498,28972,28972,29489,28748,741,28748
2871,12424,12589,12358,231,12358,12358,12588,12138,450,12138
2872,11918,13967,13092,875,13092,11918,13966,11296,2670,11296
2873,16571,15990,16012,-22,15990,15990,16000,15752,248,15752
2874,56410,55481,52907,2574,52907,52907,55487,52192,3295,52192
2875,154548,153500,146916,6584,146916,146916,153513,145962,7551,145962
2876,103001,74726,69370,5356,69370,69370,74733,63576,11157,63576
2877,8084,8036,8084,-48,8036,8036,8040,7964,76,7964
2878,8143,8147,8202,-55,8147,8143,8143,8048,95,8048
2879,360,360,595,-235,360,360,360,402,-42,360
2880,1801,1801,2018,-217,1801,1801,1801,1857,-56,1801
2881,3941,3941,4062,-121,3941,3941,3941,3895,46,3895
2882,2607,2490,2676,-186,2490,2490,2489,2538,-49,2538
2883,7042,6144,6303,-159,6144,6144,6150,5891,259,5891
2884,11299,10328,10481,-153,10328,10328,10329,10187,142,10187
2885,27995,26827,25359,1468,25359,25359,26824,25140,1684,25140
2886,61459,57890,54192,3698,54192,54192,57866,53834,4032,53834
2887,27864,28310,27862,448,27862,27862,28295,27651,644,27651
2888,1287,943,1186,-243,943,943,943,974,-31,974
2889,553849,546240,527335,18905,527335,527335,546284,519750,26534,519750
2890,74616,74546,74597,-51,74546,74546,74568,73107,1461,73107
2891,95794,91212,87154,4058,87154,87154,91219,85893,5326,85893
2892,77185,78110,77173,937,77173,77173,78126,75828,2298,75828
2893,90939,87712,84922,2790,84922,84922,87715,84214,3501,84214
2894,951097,1000930,952796,48134,952796,951097,1001081,951089,49992,951089
2895,5843,5210,5251,-41,5210,5210,5211,5143,68,5143
2896,11795,11864,11796,68,11796,11795,11863,11665,198,11665
2897,997,617,863,-246,617,617,617,669,-52,669
2898,734590,733434,694837,38597,694837,694837,733262,692247,41015,692247
2899,22966,22611,22327,284,22327,22327,22623,21911,712,21911
2900,495562,480375,467802,12573,467802,467802,480423,461065,19358,461065
2901,11766,12223,12304,-81,12223,11766,12214,11724,490,11724
2902,13458,12953,12848,105,12848,12848,12955,12673,282,12673
2903,2076,1758,2001,-243,1758,1758,1759,1813,-54,1813
2904,2883,2903,3042,-139,2903,2883,2907,2860,47,2860
2905,4786,4841,4945,-104,4841,4786,4846,4756,90,4756
2906,12026,13161,12709,452,12709,12026,13166,12018,1148,12018
2907,9463,9467,9532,-65,9467,9463,9463,9399,64,9399
2908,574,342,584,-242,342,342,342,390,-48,390
2909,197809,197788,189710,8078,189710,189710,197809,188728,9081,188728
2910,64771,68213,64764,3449,64764,64764,68185,64482,3703,64482
2911,18430,16948,16090,858,16090,16090,16945,15646,1299,15646
2912,38532,34038,32026,2012,32026,32026,34021,31778,2243,31778
2913,455455,449607,442484,7123,442484,442484,449537,433144,16393,433144
2914,20285,7193,7300,-107,7193,7193,7193,7040,153,7040
2915,18309,18897,18446,451,18446,18309,18895,18337,558,18309
2916,6853,6665,6786,-121,6665,6665,6668,6499,169,6499
2917,10771,10395,10177,218,10177,10177,10393,9864,529,9864
2918,34277,6622,6533,89,6533,6533,6624,6461,163,6461
2919,78463,78469,78341,128,78341,78341,78463,77514,949,77514
2920,23250,23246,22712,534,22712,22712,23250,22528,722,22528
2921,19826,19824,19544,280,19544,19544,19826,19291,535,19291
2922,85427,71919,70520,1399,70520,70520,71990,64788,7202,64788
2923,2268,1860,2108,-248,1860,1860,1860,1917,-57,1917
2924,2204,1797,2025,-228,1797,1797,1798,1842,-44,1842
2925,13861,13019,12791,228,12791,12791,13024,12334,690,12334
2926,46711,46610,46644,-34,46610,46610,46616,42800,3816,42800
2927,5824,5380,5373,7,5373,5373,5384,5198,186,5198
2928,12441,10817,10408,409,10408,10408,10817,9646,1171,9646
2929,14095,13907,13442,465,13442,13442,13907,13263,644,13263
2930,324208,318736,305221,13515,305221,305221,318714,304896,13818,304896
2931,24316,21725,20914,811,20914,20914,21733,19796,1937,19796
2932,38844,37363,37475,-112,37363,37363,37367,36414,953,36414
2933,22811,21854,21630,224,21630,21630,21866,21356,510,21356
2934,8213,7937,8210,-273,7937,7937,7937,7677,260,7677
2935,196230,182017,172998,9019,172998,172998,182060,171806,10254,171806
2936,2405,1563,1799,-236,1563,1563,1562,1591,-29,1591
2937,48779,48807,47861,946,47861,47861,48779,47683,1096,47683
2938,2289,2289,2523,-234,2289,2289,2289,2345,-56,2289
2939,23603,23079,22603,476,22603,22603,23069,22523,546,22523
2940,19778,19768,19013,755,19013,19013,19778,18942,836,18942
2941,75415,74546,70899,3647,70899,70899,74610,68492,6118,68492
2942,17306,17327,17006,321,17006,17006,17324,16774,550,16774
2943,44973,46144,44966,1178,44966,44966,46151,44691,1460,44691
2944,4128860,4051039,3823203,227836,3823203,3823203,4052579,3798522,254057,3798522
2945,5763,5207,5389,-182,5207,5207,5208,5109,99,5109
2946,17017,17346,17019,327,17019,17017,17342,16869,473,16869
2947,5338,5076,5339,-263,5076,5076,5073,5123,-50,5123
2948,166148,162930,156875,6055,156875,156875,162929,155941,6988,155941
2949,56373,55457,53889,1568,53889,53889,55477,53514,1963,53514
2950,55005,56607,55251,1356,55251,55005,56609,55062,1547,55005
2951,54148,53291,52262,1029,52262,52262,53290,51856,1434,51856
2952,521594,547306,521474,25832,521474,521474,547388,516673,30715,516673
2953,14048,13010,12592,418,12592,12592,13011,12419,592,12419
2954,8965,8021,7895,126,7895,7895,8018,7731,287,7731
2955,39721,40116,39720,396,39720,39720,40113,39520,593,39520
2956,24516,23754,23340,414,23340,23340,23758,23205,553,23205
2957,9316,9282,9446,-164,9282,9282,9290,9199,91,9199
2958,219170,190124,185475,4649,185475,185475,190139,183480,6659,183480
2959,24779,24145,23774,371,23774,23774,24150,23494,656,23494
2960,12166,12163,12011,152,12011,12011,12166,11823,343,11823
2961,41215,38234,36226,2008,36226,36226,38233,36067,2166,36067
2962,19344,2972,3156,-184,2972,2972,2971,3023,-52,3023
2963,284,284,519,-235,284,284,284,331,-47,284
2964,2268,2272,2515,-243,2272,2268,2274,2235,39,2235
2965,874663,821876,793195,28681,793195,793195,822315,785421,36894,785421
2966,37446,38994,37434,1560,37434,37434,39009,37380,1629,37380
2967,21464,20148,19131,1017,19131,19131,20151,18993,1158,18993
2968,55045,31073,30473,600,30473,30473,31068,29549,1519,29549
2969,77631,81188,77606,3582,77606,77606,81189,76690,4499,76690
2970,7552,7561,7784,-223,7561,7552,7568,7540,28,7540
2971,10355,10353,10503,-150,10353,10353,10355,10242,113,10242
2972,69227,70096,68373,1723,68373,68373,70083,67944,2139,67944
2973,85068,81251,76994,4257,76994,76994,81268,76610,4658,76610
2974,13941,13817,13399,418,13399,13399,13819,13242,577,13242
2975,49697,48706,46760,1946,46760,46760,48705,46455,2250,46455
2976,6313,6293,6450,-157,6293,6293,6295,6204,91,6204
2977,10127,10453,10168,285,10168,10127,10455,10073,382,10073
2978,59111,58265,57719,546,57719,57719,58272,56952,1320,56952
2979,11708,960,1225,-265,960,960,960,1022,-62,1022
2980,6187,5688,5795,-107,5688,5688,5697,5588,109,5588
2981,1472174,1470941,1397611,73330,1397611,1397611,1471162,1373930,97232,1373930
2982,29884,30422,29873,549,29873,29873,30412,29750,662,29750
2983,395944,392050,382768,9282,382768,382768,392130,380947,11183,380947
2984,20708,20229,19511,718,19511,19511,20224,19358,866,19358
2985,1908,1577,1811,-234,1577,1577,1577,1639,-62,1639
2986,35948,35024,33792,1232,33792,33792,35020,33258,1762,33258
2987,35104,33588,32125,1463,32125,32125,33599,31924,1675,31924
2988,100850,100834,97201,3633,97201,97201,100850,97124,3726,97124
2989,20628,20623,20009,614,20009,20009,20628,19886,742,19886
2990,26619,17416,16611,805,16611,16611,17422,16521,901,16521
2991,73704,43432,43618,-186,43432,43432,43461,42970,491,42970
2992,25481,25495,24585,910,24585,24585,25481,24493,988,24493
2993,10834,10830,11057,-227,10830,10830,10838,10630,208,10630
2994,26408,26637,26410,227,26410,26408,26644,26207,437,26207
2995,29335,29562,29332,230,29332,29332,29559,29074,485,29074
2996,1201762,995400,927269,68131,927269,927269,995869,917811,78058,917811
2997,35003,18611,18367,244,18367,18367,18613,17628,985,17628
2998,1816,980,1232,-252,980,980,981,1039,-58,1039
2999,12475,11419,11089,330,11089,11089,11410,10922,488,10922
3000,39226,39699,38943,756,38943,38943,39721,38436,1285,38436
3001,11256,10345,10649,-304,10345,10345,10343,10199,144,10199
3002,12054,12049,12163,-114,12049,12049,12054,11913,141,11913
3003,2484,2299,2424,-125,2299,2299,2299,2251,48,2251
3004,3628,3224,3356,-132,3224,3224,3221,3230,-9,3230
3005,258414,258276,256552,1724,256552,256552,258414,248937,9477,248937
3006,2468,2226,2406,-180,2226,2226,2227,2266,-39,2266
3007,17061,9265,8994,271,8994,8994,9269,8974,295,8974
3008,37621,36358,34728,1630,34728,34728,36349,34527,1822,34527
3009,26490,23262,22183,1079,22183,22183,23266,21945,1321,21945
3010,352743,360291,346155,14136,346155,346155,360429,339869,20560,339869
3011,4073,3995,4170,-175,3995,3995,3988,4030,-42,4030
3012,29339,29942,29331,611,29331,29331,29937,29216,721,29216
3013,227404,234005,229113,4892,229113,227404,234013,226782,7231,226782
3014,57055,55995,54627,1368,54627,54627,55981,54482,1499,54482
3015,10438,10436,10102,334,10102,10102,10438,10046,392,10046
3016,13378,11665,11481,184,11481,11481,11677,10784,893,10784
3017,49768,49770,49306,464,49306,49306,49768,48174,1594,48174
3018,1928,1565,1803,-238,1565,1565,1563,1620,-57,1620
3019,5671,5665,5890,-225,5665,5665,5671,5661,10,5661
3020,65794,49075,47935,1140,47935,47935,49088,46160,2928,46160
3021,284,284,519,-235,284,284,284,331,-47,284
3022,18041,15091,14878,213,14878,14878,15092,13625,1467,13625
3023,38124,37232,36740,492,36740,36740,37247,36404,843,36404
3024,5566,5023,5008,15,5008,5008,5021,4812,209,4812
3025,46523,46494,45565,929,45565,45565,46499,45114,1385,45114
3026,250540,245708,234808,10900,234808,234808,245740,232992,12748,232992
3027,14768,14358,14053,305,14053,14053,14358,13941,417,13941
3028,1264,853,1102,-249,853,853,853,899,-46,899
3029,4380,4363,4525,-162,4363,4363,4363,4383,-20,4380
3030,57740,57730,56205,1525,56205,56205,57740,54074,3666,54074
3031,24864,25383,24858,525,24858,24858,25387,24713,674,24713
3032,20639,20758,20638,120,20638,20638,20765,20436,329,20436
3033,13791,13792,13835,-43,13792,13791,13791,13519,272,13519
3034,43641,45668,43643,2025,43643,43641,45650,43615,2035,43615
3035,27656,28276,27651,625,27651,27651,28281,27548,733,27548
3036,16007,16287,16004,283,16004,16004,16286,15881,405,15881
3037,35348,36525,35347,1178,35347,35347,36520,35260,1260,35260
3038,27980,28703,27979,724,27979,27979,28695,27817,878,27817
3039,33902,34693,33892,801,33892,33892,34689,33767,922,33767
3040,17740,18212,17742,470,17742,17740,18214,17669,545,17669
3041,14560,14875,14561,314,14561,14560,14872,14442,430,14442
3042,45567,41624,40243,1381,40243,40243,41628,40060,1568,40060
3043,342640,352703,343568,9135,343568,342640,352622,342018,10604,342018
3044,4949,4416,4573,-157,4416,4416,4417,4401,16,4401
3045,427573,408804,374190,34614,374190,374190,408890,369491,39399,369491
3046,24012,20055,19608,447,19608,19608,20049,19400,649,19400
3047,2299,2128,2300,-172,2128,2128,2129,2159,-30,2159
3048,213985,206579,195397,11182,195397,195397,206591,194634,11957,194634
3049,527641,493895,463574,30321,463574,463574,494040,460367,33673,460367
3050,4804,4741,4906,-165,4741,4741,4743,4740,3,4740
3051,37470,31362,30270,1092,30270,30270,31364,29993,1371,29993
3052,12931,12513,12350,163,12350,12350,12518,12212,306,12212
3053,6717,6784,6653,131,6653,6653,6791,6443,348,6443
3054,60471,58418,56234,2184,56234,56234,58411,55885,2526,55885
3055,13280,12770,12479,291,12479,12479,12773,12402,371,12402
3056,862415,788951,721347,67604,721347,721347,788890,706006,82884,706006
3057,7439,6934,6878,56,6878,6878,6934,6752,182,6752
3058,251988,254369,251975,2394,251975,251975,254493,246859,7634,246859
3059,997181,996150,945475,50675,945475,945475,996227,937825,58402,937825
3060,12020,11640,11176,464,11176,11176,11652,11011,641,11011
3061,5712,5711,6121,-410,5711,5711,5712,5774,-62,5712
3062,16784,15945,15832,113,15832,15832,15954,15322,632,15322
3063,21876,20660,20331,329,20331,20331,20660,20067,593,20067
3064,16753,16745,16432,313,16432,16432,16750,16143,607,16143
3065,74444,71224,69239,1985,69239,69239,71219,68286,2933,68286
3066,63842,25108,24581,527,24581,24581,25103,24425,678,24425
3067,1049,671,905,-234,671,671,671,723,-52,723
3068,13362,12687,12475,212,12475,12475,12687,12247,440,12247
3069,20148,19674,19161,513,19161,19161,19682,19020,662,19020
3070,7927,7928,7927,1,7927,7927,7927,7737,190,7737
3071,57532,48569,47998,571,47998,47998,48578,44797,3781,44797
3072,5308,4937,5115,-178,4937,4937,4939,4929,10,4929
3073,16044,14517,13335,1182,13335,13335,14524,13158,1366,13158
3074,404027,419727,403991,15736,403991,403991,419781,401363,18418,401363
3075,76252,76191,75399,792,75399,75399,76252,75019,1233,75019
3076,47844,47829,44503,3326,44503,44503,47844,44280,3564,44280
3077,12025,12416,12288,128,12288,12025,12413,12017,396,12017
3078,508759,501263,477706,23557,477706,477706,500985,472576,28409,472576
3079,33564,33576,33045,531,33045,33045,33564,33061,503,33061
3080,147471,125054,121022,4032,121022,121022,125094,120592,4502,120592
3081,404538,415840,405212,10628,405212,404538,415960,404485,11475,404485
3082,7954,7540,7396,144,7396,7396,7546,7272,274,7272
3083,86102,73721,73748,-27,73721,73721,73739,69114,4625,69114
3084,2569,2528,2738,-210,2528,2528,2531,2595,-64,2569
3085,55174,53970,53515,455,53515,53515,53994,52780,1214,52780
3086,15937,15101,15185,-84,15101,15101,15097,14679,418,14679
3087,32221,31283,30446,837,30446,30446,31298,30078,1220,30078
3088,5660,5650,5757,-107,5650,5650,5660,4960,700,4960
3089,23363,23354,22625,729,22625,22625,23363,22455,908,22455
3090,11052,11055,10941,114,10941,10941,11052,10823,229,10823
3091,8741,8739,8805,-66,8739,8739,8741,8648,93,8648
3092,21331,19596,18761,835,18761,18761,19609,18675,934,18675
3093,187231,192104,189135,2969,189135,187231,192105,187245,4860,187231
3094,5974,5995,5971,24,5971,5971,5997,5825,172,5825
3095,9737,9119,8896,223,8896,8896,9124,8641,483,8641
3096,13568,12637,12459,178,12459,12459,12638,12249,389,12249
3097,4392156,4094437,3938853,155584,3938853,3938853,4096221,3906886,189335,3906886
3098,1360,991,1218,-227,991,991,992,1039,-47,1039
3099,61742,60894,61813,-919,60894,60894,60891,60594,297,60594
3100,41690,41098,39529,1569,39529,39529,41085,39308,1777,39308
3101,32016,31989,30810,1179,30810,30810,31990,30698,1292,30698
3102,8666,8658,8945,-287,8658,8658,8666,8600,66,8600
3103,29208,31154,29143,2011,29143,29143,31151,29087,2064,29087
3104,88213,85111,83077,2034,83077,83077,85135,81645,3490,81645
3105,1729494,1612966,1602612,10354,1602612,1602612,1613891,1541273,72618,1541273
3106,20869,19709,19393,316,19393,19393,19714,18851,863,18851
3107,55543,54557,53143,1414,53143,53143,54551,52347,2204,52347
3108,147100,146284,140065,6219,140065,140065,146214,138738,7476,138738
3109,17841,17814,17218,596,17218,17218,17823,16237,1586,16237
3110,11141,11170,11138,32,11138,11138,11169,10931,238,10931
3111,27604,26955,26628,327,26628,26628,26965,26446,519,26446
3112,22665,22410,22600,-190,22410,22410,22413,22231,182,22231
3113,116534,121638,119875,1763,119875,116534,121684,117396,4288,116534
3114,16910,16305,16177,128,16177,16177,16306,15969,337,15969
3115,61839,34079,33240,839,33240,33240,34087,32228,1859,32228
3116,5791,5349,5417,-68,5349,5349,5353,5258,95,5258
3117,284560,277502,269674,7828,269674,269674,277562,266452,11110,266452
3118,72518,67547,64348,3199,64348,64348,67527,63761,3766,63761
3119,26120,25085,26122,-1037,25085,25085,25088,24022,1066,24022
3120,46970,49166,46953,2213,46953,46953,49178,46830,2348,46830
3121,27894,24563,22965,1598,22965,22965,24563,22588,1975,22588
3122,503109,483909,464157,19752,464157,464157,484073,460591,23482,460591
3123,43668,42937,41314,1623,41314,41314,42949,41099,1850,41099
3124,9983,9892,9936,-44,9892,9892,9891,9780,111,9780
3125,40411,41515,40404,1111,40404,40404,41536,40212,1324,40212
3126,776,528,776,-248,528,528,528,571,-43,571
3127,365,365,604,-239,365,365,365,402,-37,365
3128,205668,200818,200337,481,200337,200337,200843,198129,2714,198129
3129,532009,512938,489346,23592,489346,489346,512896,485616,27280,485616
3130,85505,84540,82491,2049,82491,82491,84563,81357,3206,81357
3131,58246,55601,55250,351,55250,55250,55612,54546,1066,54546
3132,19163,18324,17994,330,17994,17994,18315,17879,436,17879
3133,68825,67894,66025,1869,66025,66025,67916,64914,3002,64914
3134,460923,447374,436521,10853,436521,436521,447354,430554,16800,430554
3135,3496,2475,2676,-201,2475,2475,2474,2530,-56,2530
3136,478,459,683,-224,459,459,459,496,-37,478
3137,10390,9722,9763,-41,9722,9722,9723,9397,326,9397
3138,37302,35358,33069,2289,33069,33069,35358,32980,2378,32980
3139,13396,9956,9823,133,9823,9823,9955,9674,281,9674
3140,12658,11815,12069,-254,11815,11815,11814,9738,2076,9738
3141,10374,9555,9784,-229,9555,9555,9555,9551,4,9551
3142,35119,7341,7340,1,7340,7340,7335,7229,106,7229
3143,1792,1697,1951,-254,1697,1697,1695,1711,-16,1711
3144,90980,59162,55858,3304,55858,55858,59174,54209,4965,54209
3145,15612,15074,15190,-116,15074,15074,15080,14886,194,14886
3146,8699,8742,8636,106,8636,8636,8745,8445,300,8445
3147,9262,7963,8029,-66,7963,7963,7964,7406,558,7406
3148,1522,1494,1737,-243,1494,1494,1493,1536,-43,1522
3149,908515,814370,824551,-10181,814370,814370,814290,799462,14828,799462
3150,1905,1696,1906,-210,1696,1696,1697,1744,-47,1744
3151,120138,119193,117709,1484,117709,117709,119236,116225,3011,116225
3152,67852,67000,67044,-44,67000,67000,67026,64929,2097,64929
3153,3376,3186,3315,-129,3186,3186,3186,3170,16,3170
3154,219176,182679,173700,8979,173700,173700,182635,172385,10250,172385
3155,16013,15483,15409,74,15409,15409,15479,15391,88,15391
3156,2788,2396,2598,-202,2396,2396,2395,2412,-17,2412
3157,48105,47786,48108,-322,47786,47786,47792,36945,10847,36945
3158,3320,2816,3017,-201,2816,2816,2813,2870,-57,2870
3159,41479,40508,40314,194,40314,40314,40525,39865,660,39865
3160,3558,2652,2976,-324,2652,2652,2651,2235,416,2235
3161,293253,267895,257597,10298,257597,257597,267918,256409,11509,256409
3162,12253,12494,12253,241,12253,12253,12496,12098,398,12098
3163,928,860,1117,-257,860,860,860,886,-26,886
3164,19132,17441,16669,772,16669,16669,17439,16034,1405,16034
3165,10820,10059,9820,239,9820,9820,10062,9723,339,9723
3166,12808,13603,13291,312,13291,12808,13601,13025,576,12808
3167,613203,638664,615005,23659,615005,613203,638892,614667,24225,613203
3168,38102,37442,36291,1151,36291,36291,37434,36127,1307,36127
3169,35623,34260,34680,-420,34260,34260,34250,34126,124,34126
3170,5093,5093,5185,-92,5093,5093,5093,5006,87,5006
3171,6492,5973,6000,-27,5973,5973,5976,5903,73,5903
3172,48675,47976,47939,37,47939,47939,48012,45997,2015,45997
3173,25800,24852,24265,587,24265,24265,24852,24035,817,24035
3174,51820,17616,17082,534,17082,17082,17613,16964,649,16964
3175,11765,11765,11721,44,11721,11721,11765,11552,213,11552
3176,2404,2307,2404,-97,2307,2307,2306,2269,37,2269
3177,110873,83735,80707,3028,80707,80707,83743,80232,3511,80232
3178,2142,1316,1541,-225,1316,1316,1315,1348,-33,1348
3179,4216,3780,3957,-177,3780,3780,3778,3786,-8,3786
3180,467,449,702,-253,449,449,449,502,-53,467
3181,60163,58865,57500,1365,57500,57500,58865,57053,1812,57053
3182,770,389,628,-239,389,389,389,437,-48,437
3183,12984,13307,13164,143,13164,12984,13309,12937,372,12937
3184,1883,869,1139,-270,869,869,869,926,-57,926
3185,9699,9659,9878,-219,9659,9659,9660,9658,2,9658
3186,15371,15367,14902,465,14902,14902,15371,14791,580,14791
3187,7956,7956,7783,173,7783,7783,7958,7526,432,7526
3188,20167,20174,19863,311,19863,19863,20167,19723,444,19723
3189,21410,21411,20610,801,20610,20610,21410,20468,942,20468
3190,12154,12154,12123,31,12123,12123,12154,11922,232,11922
3191,12100,12109,12082,27,12082,12082,12100,11816,284,11816
3192,1723,1349,1560,-211,1349,1349,1349,1400,-51,1400
3193,31599,11483,11286,197,11286,11286,11488,11018,470,11018
3194,14290,14297,14106,191,14106,14106,14290,13876,414,13876
3195,39502,41479,40486,993,40486,39502,41490,38880,2610,38880
3196,13892,13885,13645,240,13645,13645,13892,13477,415,13477
3197,16875,16875,16659,216,16659,16659,16875,16521,354,16521
3198,22113,22125,21450,675,21450,21450,22113,21383,730,21383
3199,96470,76175,72798,3377,72798,72798,76178,68515,7663,68515
3200,15682,15686,15530,156,15530,15530,15682,15299,383,15299
3201,12572,12570,12372,198,12372,12372,12572,12089,483,12089
3202,17661,17670,17604,66,17604,17604,17661,17375,286,17375
3203,12320,12312,12401,-89,12312,12312,12320,12101,219,12101
3204,15556,15551,15367,184,15367,15367,15556,15210,346,15210
3205,7925,7837,7924,-87,7837,7837,7841,7742,99,7742
3206,15407,15405,15206,199,15206,15206,15407,15004,403,15004
3207,8723,8724,8882,-158,8724,8723,8723,8610,113,8610
3208,6643,6641,6904,-263,6641,6641,6643,6557,86,6557
3209,18573,18575,18282,293,18282,18282,18573,18133,440,18133
3210,12606,12605,12534,71,12534,12534,12606,12277,329,12277
3211,12294,12301,12268,33,12268,12268,12294,11962,332,11962
3212,159708,154851,144603,10248,144603,144603,154937,144262,10675,144262
3213,15619,15105,14947,158,14947,14947,15103,14702,401,14702
3214,16050,16061,15825,236,15825,15825,16050,15667,383,15667
3215,53636,53952,52613,1339,52613,52613,53954,52288,1666,52288
3216,16713,16713,16527,186,16527,16527,16713,16395,318,16395
3217,12428,12430,12462,-32,12430,12428,12428,12138,290,12138
3218,345827,345014,329473,15541,329473,329473,344895,327661,17234,327661
3219,21772,21779,21299,480,21299,21299,21772,21187,585,21187
3220,7218,5622,5529,93,5529,5529,5619,5292,327,5292
3221,14318,14318,14193,125,14193,14193,14318,14034,284,14034
3222,12181,12175,12141,34,12141,12141,12181,11870,311,11870
3223,6161,5222,5290,-68,5222,5222,5221,5005,216,5005
3224,96278,96276,92677,3599,92677,92677,96278,91160,5118,91160
3225,14800,14799,14562,237,14562,14562,14800,14377,423,14377
3226,62502,63977,63260,717,63260,62502,63993,62459,1534,62459
3227,130977,103331,98481,4850,98481,98481,103304,98077,5227,98077
3228,22002,5408,5603,-195,5408,5408,5409,5380,29,5380
3229,34096,3472,3639,-167,3472,3472,3472,3453,19,3453
3230,118168,117274,117369,-95,117274,117274,117342,113282,4060,113282
3231,214465,168073,156547,11526,156547,156547,167999,155879,12120,155879
3232,16130,15567,15249,318,15249,15249,15565,15119,446,15119
3233,5103,4157,4378,-221,4157,4157,4158,4164,-6,4164
3234,14470,1621,1871,-250,1621,1621,1623,1593,30,1593
3235,19121,18292,18326,-34,18292,18292,18295,17925,370,17925
3236,63389,62455,62332,123,62332,62332,62503,61552,951,61552
3237,26523,26489,26179,310,26179,26179,26502,25805,697,25805
3238,2344,2105,2284,-179,2105,2105,2104,2130,-26,2130
3239,396,414,648,-234,414,396,414,397,17,396
3240,60593,33057,31797,1260,31797,31797,33057,31582,1475,31582
3241,10948,899,1154,-255,899,899,899,963,-64,963
3242,48126,48101,46488,1613,46488,46488,48109,44968,3141,44968
3243,28559,7676,7705,-29,7676,7676,7680,7410,270,7410
3244,24258,24251,23875,376,23875,23875,24258,23796,462,23796
3245,64866,63661,63749,-88,63661,63661,63676,62113,1563,62113
3246,104257,106969,103647,3322,103647,103647,106981,103120,3861,103120
3247,130457,119244,112540,6704,112540,112540,119259,110927,8332,110927
3248,24501,24496,24184,312,24184,24184,24501,24025,476,24025
3249,24501,24496,24184,312,24184,24184,24501,24025,476,24025
3250,14859,13289,13914,-625,13289,13289,13298,13275,23,13275
3251,98023,86916,85844,1072,85844,85844,86930,85045,1885,85045
3252,15136,15131,14910,221,14910,14910,15136,14672,464,14672
3253,16076,16074,15875,199,15875,15875,16076,15691,385,15691
3254,8000,7982,8068,-86,7982,7982,7981,7750,231,7750
3255,11108,11107,11089,18,11089,11089,11108,10819,289,10819
3256,20492,20495,19990,505,19990,19990,20492,19838,654,19838
3257,17966,17957,17833,124,17833,17833,17966,17560,406,17560
3258,19031,19029,18650,379,18650,18650,19031,18427,604,18427
3259,17478,17480,17119,361,17119,17119,17478,16946,532,16946
3260,12634,12632,12415,217,12415,12415,12634,12212,422,12212
3261,15366,15380,15092,288,15092,15092,15366,14900,466,14900
3262,19721,19726,19074,652,19074,19074,19721,18926,795,18926
3263,13720,13727,13598,129,13598,13598,13720,13390,330,13390
3264,8220,8221,8363,-142,8221,8220,8220,8046,174,8046
3265,83470,88187,85526,2661,85526,83470,88190,83462,4728,83462
3266,1352927,1427322,1343638,83684,1343638,1343638,1427668,1333520,94148,1333520
3267,96571,95445,96770,-1325,95445,95445,95466,92670,2796,92670
3268,223293,205087,198515,6572,198515,198515,205109,193412,11697,193412
3269,21250,20319,19455,864,19455,19455,20325,19011,1314,19011
3270,5393,5395,5635,-240,5395,5393,5393,5266,127,5266
3271,3512,3421,3511,-90,3421,3421,3421,3359,62,3359
3272,66374,40306,38810,1496,38810,38810,40309,38543,1766,38543
3273,8595,8590,8534,56,8534,8534,8595,8441,154,8441
3274,21768,21770,21620,150,21620,21620,21768,21326,442,21326
3275,74686,76142,74689,1453,74689,74686,76167,74753,1414,74686
3276,56654,55842,53689,2153,53689,53689,55841,53473,2368,53473
3277,9718,9977,9718,259,9718,9718,9979,9641,338,9641
3278,4244,4247,4388,-141,4247,4244,4244,4224,20,4224
3279,30972,26338,24824,1514,24824,24824,26333,24673,1660,24673
3280,2216,2196,2445,-249,2196,2196,2196,2247,-51,2216
3281,37795,37790,36059,1731,36059,36059,37795,35907,1888,35907
3282,19154,19154,18941,213,18941,18941,19154,18725,429,18725
3283,14401,13490,13085,405,13085,13085,13494,12919,575,12919
3284,5344,4957,5100,-143,4957,4957,4955,4947,8,4947
3285,36521,36906,36016,890,36016,36016,36909,35594,1315,35594
3286,2035,1098,1321,-223,1098,1098,1098,1153,-55,1153
3287,1602,1214,1444,-230,1214,1214,1215,1250,-35,1250
3288,70113,69145,70097,-952,69145,69145,69150,68584,566,68584
3289,13767,14081,13763,318,13763,13763,14084,13656,428,13656
3290,34231,26557,26459,98,26459,26459,26560,26063,497,26063
3291,29804,29926,29800,126,29800,29800,29930,29168,762,29168
3292,375179,349181,337836,11345,337836,337836,349299,333176,16123,333176
3293,11375,11390,11070,320,11070,11070,11393,10891,502,10891
3294,75798,75805,74408,1397,74408,74408,75809,72673,3136,72673
3295,110683,85347,81634,3713,81634,81634,85330,80377,4953,80377
3296,101550,100057,99963,94,99963,99963,100057,98008,2049,98008
3297,9268,8736,8573,163,8573,8573,8735,8360,375,8360
3298,18436,17016,16972,44,16972,16972,17020,16696,324,16696
3299,15557,3080,3262,-182,3080,3080,3080,2953,127,2953
3300,7653,7609,7891,-282,7609,7609,7606,7645,-39,7645
3301,606025,605809,597001,8808,597001,597001,606025,582021,24004,582021
3302,20443,19505,19380,125,19380,19380,19509,19173,336,19173
3303,30282,25465,24840,625,24840,24840,25488,24654,834,24654
3304,14060,13420,13264,156,13264,13264,13423,13096,327,13096
3305,829,811,1073,-262,811,811,811,868,-57,829
3306,7309,7308,7254,54,7254,7254,7307,7048,259,7048
3307,62285,53207,52788,419,52788,52788,53190,51981,1209,51981
3308,256093,256085,246470,9615,246470,246470,256093,245071,11022,245071
3309,53613,53585,50763,2822,50763,50763,53603,49338,4265,49338
3310,2339,1462,1662,-200,1462,1462,1460,1498,-38,1498
3311,19229,20347,19694,653,19694,19229,20340,19207,1133,19207
3312,446109,459825,445941,13884,445941,445941,459882,444002,15880,444002
3313,186109,184961,187494,-2533,184961,184961,185160,180686,4474,180686
3314,31111,29563,28200,1363,28200,28200,29583,27950,1633,27950
3315,21046,20483,19900,583,19900,19900,20481,19599,882,19599
3316,85198,88018,85111,2907,85111,85111,88039,84280,3759,84280
3317,157710,140494,135361,5133,135361,135361,140520,133892,6628,133892
3318,12500,11859,11579,280,11579,11579,11858,11455,403,11455
3319,4254,3772,4010,-238,3772,3772,3775,3826,-51,3826
3320,15070,15264,15009,255,15009,15009,15258,14691,567,14691
3321,76674,37402,35981,1421,35981,35981,37411,35718,1693,35718
3322,1347,1327,1591,-264,1327,1327,1328,1388,-60,1347
3323,12723,12736,12600,136,12600,12600,12723,12437,286,12437
3324,2872,2831,3056,-225,2831,2831,2833,2864,-31,2864
3325,1731,892,1142,-250,892,892,892,943,-51,943
3326,5724,4987,5058,-71,4987,4987,4984,4833,151,4833
3327,101561,105207,100642,4565,100642,100642,105206,99968,5238,99968
3328,4845,4268,4550,-282,4268,4268,4268,4211,57,4211
3329,9085,8141,8452,-311,8141,8141,8141,8114,27,8114
3330,33477,32873,31761,1112,31761,31761,32879,31698,1181,31698
3331,475675,474790,462663,12127,462663,462663,474646,458932,15714,458932
3332,34472,35758,34451,1307,34451,34451,35768,34311,1457,34311
3333,2626,2257,2468,-211,2257,2257,2258,2296,-38,2296
3334,1749,1730,1986,-256,1730,1730,1729,1795,-66,1749
3335,25435,24603,24228,375,24228,24228,24596,24036,560,24036
3336,214460,213442,205892,7550,205892,205892,213443,203563,9880,203563
3337,449075,447870,443098,4772,443098,443098,448057,436159,11898,436159
3338,374136,360701,345751,14950,345751,345751,360898,344286,16612,344286
3339,29615,28760,28606,154,28606,28606,28761,27903,858,27903
3340,53352,55292,53343,1949,53343,53343,55310,53222,2088,53222
3341,8387,8411,8320,91,8320,8320,8405,8221,184,8221
3342,3298,2583,2774,-191,2583,2583,2582,2443,139,2443
3343,48065,47935,46215,1720,46215,46215,47947,44829,3118,44829
3344,44557,43395,42269,1126,42269,42269,43402,41933,1469,41933
3345,131978,135915,131940,3975,131940,131940,135889,131151,4738,131151
3346,53209,52732,50454,2278,50454,50454,52728,50078,2650,50078
3347,28695,27442,25893,1549,25893,25893,27445,25530,1915,25530
3348,21632,20960,19813,1147,19813,19813,20956,19629,1327,19629
3349,4883,4351,4548,-197,4351,4351,4350,4304,46,4304
3350,39752,39751,38335,1416,38335,38335,39752,38117,1635,38117
3351,2358,2356,2577,-221,2356,2356,2358,2395,-37,2358
3352,182119,184289,183593,696,183593,182119,184393,181497,2896,181497
3353,19520,18880,18279,601,18279,18279,18878,18037,841,18037
3354,6015,5680,5643,37,5643,5643,5678,5515,163,5515
3355,37834,31500,30143,1357,30143,30143,31507,29822,1685,29822
3356,16421,16416,16215,201,16215,16215,16421,16008,413,16008
3357,508043,466677,444725,21952,444725,444725,466530,441551,24979,441551
3358,227687,221382,223001,-1619,221382,221382,221544,215173,6371,215173
3359,15411,3574,3769,-195,3574,3574,3574,3518,56,3518
3360,256155,255229,255240,-11,255229,255229,255217,247976,7241,247976
3361,457351,423867,408055,15812,408055,408055,423767,404742,19025,404742
3362,5602,5599,5668,-69,5599,5599,5602,5524,78,5524
3363,10283,9721,9791,-70,9721,9721,9721,9661,60,9661
3364,24332,22154,21868,286,21868,21868,22165,21805,360,21805
3365,51842,31521,30503,1018,30503,30503,31507,30342,1165,30342
3366,34536,34490,32725,1765,32725,32725,34475,32623,1852,32623
3367,151527,158250,151489,6761,151489,151489,158279,150836,7443,150836
3368,130344,136476,130334,6142,130334,130334,136506,129742,6764,129742
3369,90966,90072,88296,1776,88296,88296,90090,87321,2769,87321
3370,23712,22753,22402,351,22402,22402,22757,22056,701,22056
3371,66566,65582,64049,1533,64049,64049,65555,63653,1902,63653
3372,7631,7173,7319,-146,7173,7173,7176,7116,60,7116
3373,67779,57757,55174,2583,55174,55174,57771,54556,3215,54556
3374,97630,96285,94240,2045,94240,94240,96317,93739,2578,93739
3375,23842,24669,23837,832,23837,23837,24677,23753,924,23753
3376,7336,7340,7395,-55,7340,7336,7336,7193,143,7193
3377,11699,11251,11176,75,11176,11176,11245,11054,191,11054
3378,15939,15936,15452,484,15452,15452,15939,15392,547,15392
3379,12644,12460,12703,-243,12460,12460,12464,12275,189,12275
3380,24198,24191,23643,548,23643,23643,24188,23576,612,23576
3381,118853,124259,118806,5453,118806,118806,124306,118157,6149,118157
3382,7765,7407,7405,2,7405,7405,7406,7268,138,7268
3383,22965,6402,6473,-71,6402,6402,6404,6331,73,6331
3384,11749,11745,12208,-463,11745,11745,11749,11845,-96,11749
3385,2791,2101,2362,-261,2101,2101,2101,2169,-68,2169
3386,293298,302021,298636,3385,298636,293298,302112,293290,8822,293290
3387,19297,19298,18674,624,18674,18674,19297,18431,866,18431
3388,5989,5154,5199,-45,5154,5154,5152,4970,182,4970
3389,28970,27000,26633,367,26633,26633,26999,25623,1376,25623
3390,89363,88512,88509,3,88509,88509,88518,86720,1798,86720
3391,52539,51608,49720,1888,49720,49720,51590,48756,2834,48756
3392,7967,7936,7945,-9,7936,7936,7938,7771,167,7771
3393,6669,6671,6588,83,6588,6588,6669,6443,226,6443
3394,47822,32076,31621,455,31621,31621,32074,31298,776,31298
3395,36084,35074,33377,1697,33377,33377,35082,33280,1802,33280
3396,17963,17531,16855,676,16855,16855,17533,16761,772,16761
3397,16328,15773,15432,341,15432,15432,15765,15261,504,15261
3398,3070,2485,2701,-216,2485,2485,2486,2444,42,2444
3399,121351,129459,121347,8112,121347,121347,129577,120986,8591,120986
3400,1015096,963795,899566,64229,899566,899566,963812,894719,69093,894719
3401,9199,9200,9057,143,9057,9057,9199,8967,232,8967
3402,478969,477591,462365,15226,462365,462365,477703,459182,18521,459182
3403,28424,27521,27781,-260,27521,27521,27541,27279,262,27279
3404,64105,32559,32311,248,32311,32311,32561,31902,659,31902
3405,10435,9640,9204,436,9204,9204,9640,8940,700,8940
3406,24187,23196,22668,528,22668,22668,23209,22455,754,22455
3407,91139,90054,85073,4981,85073,85073,90036,84802,5234,84802
3408,5702,5702,5827,-125,5702,5702,5702,5633,69,5633
3409,2092,1641,1804,-163,1641,1641,1640,1628,12,1628
3410,2111,1189,1425,-236,1189,1189,1188,1245,-57,1245
3411,797247,828435,790671,37764,790671,790671,828531,788365,40166,788365
3412,102051,101908,100705,1203,100705,100705,101984,99842,2142,99842
3413,6421,6444,6368,76,6368,6368,6441,6125,316,6125
3414,112328,111295,108295,3000,108295,108295,111288,107332,3956,107332
3415,85534,100246,91938,8308,91938,85534,100322,85526,14796,85526
3416,2514,2376,2453,-77,2376,2376,2378,2276,102,2276
3417,1441,1217,1441,-224,1217,1217,1218,1260,-42,1260
3418,27147,26297,26041,256,26041,26041,26304,25282,1022,25282
3419,133809,129228,123354,5874,123354,123354,129247,121566,7681,121566
3420,25212,25285,25712,-427,25285,25212,25290,25204,86,25204
3421,732062,732649,700362,32287,700362,700362,732062,686731,45331,686731
3422,14310,14296,14018,278,14018,14018,14292,13932,360,13932
3423,85702,27294,26610,684,26610,26610,27307,26540,767,26540
3424,7370,6626,6594,32,6594,6594,6631,6483,148,6483
3425,19176,19113,19238,-125,19113,19113,19115,18366,749,18366
3426,7124,7118,7170,-52,7118,7118,7124,7021,103,7021
3427,942,942,1172,-230,942,942,942,992,-50,942
3428,32017,31165,30866,299,30866,30866,31173,30398,775,30398
3429,1149041,1105119,1040492,64627,1040492,1040492,1105114,1024860,80254,1024860
3430,584,585,705,-120,585,584,584,595,-11,584
3431,20289,21849,20831,1018,20831,20289,21857,20289,1568,20289
3432,4541,3691,3891,-200,3691,3691,3693,3575,118,3575
3433,39805,39775,38761,1014,38761,38761,39770,38109,1661,38109
3434,10918,10855,10925,-70,10855,10855,10857,10717,140,10717
3435,5612,5635,5703,-68,5635,5612,5635,5644,-9,5612
3436,7385,7201,7113,88,7113,7113,7203,7012,191,7012
3437,79776,78293,77239,1054,77239,77239,78340,76405,1935,76405
3438,147151,146291,141203,5088,141203,141203,146284,139614,6670,139614
3439,59835,58861,57800,1061,57800,57800,58870,57178,1692,57178
3440,10476,9906,9657,249,9657,9657,9922,9373,549,9373
3441,8887,8406,8379,27,8379,8379,8413,8199,214,8199
3442,14767,15057,14709,348,14709,14709,15057,14577,480,14577
3443,12865,3480,3696,-216,3480,3480,3480,3509,-29,3509
3444,3464,3426,3562,-136,3426,3426,3425,3415,10,3415
3445,119072,121845,119059,2786,119059,119059,121837,117661,4176,117661
3446,22382,23023,22667,356,22667,22382,23021,22374,647,22374
3447,1247,1212,1479,-267,1212,1212,1212,1239,-27,1239
3448,9650,11740,11087,653,11087,9650,11740,9693,2047,9650
3449,10028,9347,9177,170,9177,9177,9350,9020,330,9020
3450,85506,84677,81232,3445,81232,81232,84678,79255,5423,79255
3451,9982,9138,9210,-72,9138,9138,9149,8787,362,8787
3452,214748,213974,210893,3081,210893,210893,213957,205268,8689,205268
3453,2035,1099,1325,-226,1099,1099,1099,1152,-53,1152
3454,21080,20847,21072,-225,20847,20847,20854,20021,833,20021
3455,33881,33803,33158,645,33158,33158,33831,32877,954,32877
3456,737667,675726,658699,17027,658699,658699,675713,656715,18998,656715
3457,43367,43373,42141,1232,42141,42141,43367,41194,2173,41194
3458,6824,6290,6243,47,6243,6243,6289,6028,261,6028
3459,19108,10636,10283,353,10283,10283,10632,10167,465,10167
3460,8543,8927,8742,185,8742,8543,8932,8535,397,8535
3461,286758,261422,257629,3793,257629,257629,261529,253493,8036,253493
3462,2593,2598,2756,-158,2598,2593,2597,2564,33,2564
3463,5415,5414,5415,-1,5414,5414,5415,5271,144,5271
3464,107364,77246,73386,3860,73386,73386,77237,72443,4794,72443
3465,1225792,1244496,1257363,-12867,1244496,1225792,1244422,1225784,18638,1225784
3466,18877,15708,15308,400,15308,15308,15715,15126,589,15126
3467,27719,27682,27717,-35,27682,27682,27697,25956,1741,25956
3468,22447,18876,18758,118,18758,18758,18881,18213,668,18213
3469,20300,20603,20295,308,20295,20295,20608,20073,535,20073
3470,21097,21082,20799,283,20799,20799,21080,20692,388,20692
3471,65878,65914,63236,2678,63236,63236,65885,62604,3281,62604
3472,665,563,836,-273,563,563,563,622,-59,622
3473,94471,92599,90925,1674,90925,90925,92590,90724,1866,90724
3474,51200,48128,44357,3771,44357,44357,48125,43965,4160,43965
3475,10871,10971,10872,99,10872,10871,10972,10772,200,10772
3476,470457,435448,410911,24537,410911,410911,435413,408712,26701,408712
3477,7114,6210,6345,-135,6210,6210,6209,6185,24,6185
3478,103285,102253,98984,3269,98984,98984,102286,98528,3758,98528
3479,10883,10884,10801,83,10801,10801,10883,10663,220,10663
3480,7316,7316,7357,-41,7316,7316,7316,7265,51,7265
3481,55406,29526,28912,614,28912,28912,29536,28653,883,28653
3482,62404,64812,62389,2423,62389,62389,64810,62108,2702,62108
3483,63980,62251,62364,-113,62251,62251,62275,61491,784,61491
3484,13475,13365,13620,-255,13365,13365,13366,13366,0,13366
3485,56592,55824,54149,1675,54149,54149,55828,53880,1948,53880
3486,49046,30489,29182,1307,29182,29182,30489,28950,1539,28950
3487,7860,7859,8068,-209,7859,7859,7860,7827,33,7827
3488,39300,39319,37352,1967,37352,37352,39300,37275,2025,37275
3489,33276,33266,33123,143,33123,33123,33276,32364,912,32364
3490,25777,24282,23578,704,23578,23578,24281,23522,759,23522
3491,4752,4740,4940,-200,4740,4740,4741,4782,-41,4752
3492,6688,6634,6627,7,6627,6627,6635,6464,171,6464
3493,3898,3773,3838,-65,3773,3773,3773,3637,136,3637
3494,6681,6518,6622,-104,6518,6518,6520,6320,200,6320
3495,35949,35043,34402,641,34402,34402,35047,34112,935,34112
3496,582,582,816,-234,582,582,582,616,-34,582
3497,6062,1986,2193,-207,1986,1986,1987,1961,26,1961
3498,69412,48972,46840,2132,46840,46840,48977,46068,2909,46068
3499,30300,29376,28810,566,28810,28810,29387,27389,1998,27389
3500,45268,43709,43076,633,43076,43076,43720,42417,1303,42417
3501,112740,114823,112726,2097,112726,112726,114824,111774,3050,111774
3502,876762,875791,841512,34279,841512,841512,875625,827034,48591,827034
3503,22553,21706,20714,992,20714,20714,21712,20068,1644,20068
3504,2091,711,960,-249,711,711,711,700,11,700
3505,4968,4543,4705,-162,4543,4543,4548,4516,32,4516
3506,17131,16222,16080,142,16080,16080,16225,15939,286,15939
3507,5382,5352,5487,-135,5352,5352,5354,5342,12,5342
3508,13563,15460,15906,-446,15460,13563,15464,13555,1909,13555
3509,74719,74703,73199,1504,73199,73199,74692,71010,3682,71010
3510,15246,15257,15077,180,15077,15077,15246,14902,344,14902
3511,350,350,592,-242,350,350,350,396,-46,350
3512,18097,17590,17299,291,17299,17299,17590,17184,406,17184
3513,54984,55966,54970,996,54970,54970,55992,54551,1441,54551
3514,10589,10691,10605,86,10605,10589,10694,10545,149,10545
3515,340837,330019,317360,12659,317360,317360,330075,316685,13390,316685
3516,7013,6947,7255,-308,6947,6947,6949,7013,-64,7013
3517,17117,16536,16230,306,16230,16230,16542,16119,423,16119
3518,44529,43547,42340,1207,42340,42340,43573,42140,1433,42140
3519,60846,58508,55028,3480,55028,55028,58513,54211,4302,54211
3520,64694,63831,63227,604,63227,63227,63828,62111,1717,62111
3521,19454,18133,17440,693,17440,17440,18144,16957,1187,16957
3522,20010,19076,18643,433,18643,18643,19064,18552,512,18552
3523,21638,26230,25786,444,25786,21638,26233,21777,4456,21638
3524,26068,26085,25670,415,25670,25670,26068,25433,635,25433
3525,67096,67413,66174,1239,66174,66174,67435,64758,2677,64758
3526,129224,100114,92814,7300,92814,92814,100183,92111,8072,92111
3527,8184,7104,7291,-187,7104,7104,7103,7070,33,7070
3528,10920,10086,9787,299,9787,9787,10087,9503,584,9503
3529,33724,25631,24802,829,24802,24802,25636,24369,1267,24369
3530,42411,42325,41288,1037,41288,41288,42323,41156,1167,41156
3531,593853,619061,597514,21547,597514,593853,618933,596400,22533,593853
3532,7326,7471,7325,146,7325,7325,7468,7237,231,7237
3533,109973,109088,103868,5220,103868,103868,109088,102916,6172,102916
3534,2047,1984,2175,-191,1984,1984,1983,2011,-28,2011
3535,432392,431386,414800,16586,414800,414800,431501,409011,22490,409011
3536,16300,14780,14331,449,14331,14331,14779,13800,979,13800
3537,20155,19456,19485,-29,19456,19456,19475,19289,186,19289
3538,288989,297046,291628,5418,291628,288989,297079,290147,6932,288989
3539,883,883,1125,-242,883,883,883,928,-45,883
3540,21968,21403,20626,777,20626,20626,21381,20495,886,20495
3541,1865,1410,1599,-189,1410,1410,1410,1450,-40,1450
3542,51295,52640,51284,1356,51284,51284,52649,50719,1930,50719
3543,6077,5563,5695,-132,5563,5563,5565,5545,20,5545
3544,2004,1162,1430,-268,1162,1162,1163,1214,-51,1214
3545,2726,2726,2974,-248,2726,2726,2726,2754,-28,2726
3546,3397,3232,3397,-165,3232,3232,3233,3233,0,3233
3547,92890,54388,52257,2131,52257,52257,54391,51568,2823,51568
3548,298384,297488,285527,11961,285527,285527,297373,281912,15461,281912
3549,11838,11815,11650,165,11650,11650,11816,11550,266,11550
3550,606438,26926,26632,294,26632,26632,26924,26545,379,26545
3551,16664,16654,16262,392,16262,16262,16664,15508,1156,15508
3552,1683,842,1057,-215,842,842,843,880,-37,880
3553,32523,32518,31245,1273,31245,31245,32523,30993,1530,30993
3554,2119511,1904528,1829219,75309,1829219,1829219,1904243,1804099,100144,1804099
3555,112242,99315,102046,-2731,99315,99315,99411,93177,6234,93177
3556,51338,51297,53180,-1883,51297,51297,51338,49224,2114,49224
3557,40366,41918,40361,1557,40361,40361,41917,40185,1732,40185
3558,1171,774,995,-221,774,774,774,821,-47,821
3559,232358,209873,200934,8939,200934,200934,209986,199910,10076,199910
3560,1495,1096,1348,-252,1096,1096,1096,1133,-37,1133
3561,6650,6652,6773,-121,6652,6650,6650,6588,62,6588
3562,12841,12789,12716,73,12716,12716,12795,12522,273,12522
3563,26792,9452,9120,332,9120,9120,9455,9011,444,9011
3564,6254,6250,6350,-100,6250,6250,6254,6126,128,6126
3565,6273,6266,6250,16,6250,6250,6273,6102,171,6102
3566,83432,82219,76142,6077,76142,76142,82182,75521,6661,75521
3567,8436,315,549,-234,315,315,315,347,-32,347
3568,115111,114940,112078,2862,112078,112078,114994,111112,3882,111112
3569,3310,2760,2819,-59,2760,2760,2761,2612,149,2612
3570,4638,3799,4013,-214,3799,3799,3802,3840,-38,3840
3571,29275,27075,28863,-1788,27075,27075,27072,27223,-151,27223
3572,93682,68274,65873,2401,65873,65873,68291,65143,3148,65143
3573,16061,15144,14795,349,14795,14795,15146,14408,738,14408
3574,93337,51539,49288,2251,49288,49288,51541,48888,2653,48888
3575,105890,82168,79679,2489,79679,79679,82159,78254,3905,78254
3576,2030,1968,2174,-206,1968,1968,1968,1982,-14,1982
3577,878,877,1129,-252,877,877,878,935,-57,878
3578,26545,26532,26543,-11,26532,26532,26545,26175,370,26175
3579,8579,8962,9015,-53,8962,8579,8966,7957,1009,7957
3580,6929,6460,6475,-15,6460,6460,6460,6257,203,6257
3581,78934,78934,75596,3338,75596,75596,78934,74459,4475,74459
3582,22061,21219,21111,108,21111,21111,21221,20750,471,20750
3583,40081,40047,40181,-134,40047,40047,40056,39623,433,39623
3584,19653,19116,18614,502,18614,18614,19115,18463,652,18463
3585,60082,50527,48562,1965,48562,48562,50523,47846,2677,47846
3586,12135,11151,11060,91,11060,11060,11153,10929,224,10929
3587,277351,228363,217526,10837,217526,217526,228397,215850,12547,215850
3588,34931,34002,33185,817,33185,33185,34012,31718,2294,31718
3589,3904,3327,3585,-258,3327,3327,3326,3374,-48,3374
3590,12019,5318,5421,-103,5318,5318,5320,5266,54,5266
3591,35099,36226,34807,1419,34807,34807,36233,34643,1590,34643
3592,10146,10128,10056,72,10056,10056,10129,9919,210,9919
3593,30542,29916,29787,129,29787,29787,29929,29382,547,29382
3594,11782,10931,10907,24,10907,10907,10932,10774,158,10774
3595,31606,31625,30598,1027,30598,30598,31606,30425,1181,30425
3596,91559,91561,88655,2906,88655,88655,91546,87792,3754,87792
3597,10122,9580,9359,221,9359,9359,9575,9258,317,9258
3598,21305,21590,21303,287,21303,21303,21589,21116,473,21116
3599,342952,367098,342956,24142,342956,342952,367028,339689,27339,339689
3600,24156,24522,24485,37,24485,24156,24537,23534,1003,23534
3601,61540,42800,40520,2280,40520,40520,42811,39754,3057,39754
3602,6331,5901,5934,-33,5901,5901,5902,5713,189,5713
3603,48625,48628,47416,1212,47416,47416,48625,46783,1842,46783
3604,11451,9667,9556,111,9556,9556,9675,9308,367,9308
3605,16396,16761,16391,370,16391,16391,16758,16288,470,16288
3606,31738,32581,31721,860,31721,31721,32577,31586,991,31586
3607,10016,9997,9782,215,9782,9782,9990,9638,352,9638
3608,48476,20050,19638,412,19638,19638,20043,19493,550,19493
3609,20581,18868,17882,986,17882,17882,18861,17642,1219,17642
3610,34732,33574,33065,509,33065,33065,33587,32627,960,32627
3611,19785,6951,7189,-238,6951,6951,6949,7031,-82,7031
3612,88598,55684,54765,919,54765,54765,55681,54346,1335,54346
3613,8283,8286,8447,-161,8286,8283,8284,8131,153,8131
3614,449570,449374,438734,10640,438734,438734,449570,437325,12245,437325
3615,7042,6197,6214,-17,6197,6197,6195,6020,175,6020
3616,9766,9213,9291,-78,9213,9213,9212,8854,358,8854
3617,15767,15765,15348,417,15348,15348,15767,15146,621,15146
3618,13142,306,537,-231,306,306,306,353,-47,353
3619,257888,265654,260451,5203,260451,257888,265656,257898,7758,257888
3620,2265,1814,1970,-156,1814,1814,1814,1815,-1,1815
3621,10287,10248,10444,-196,10248,10248,10251,10013,238,10013
3622,14776,15082,14875,207,14875,14776,15079,14776,303,14776
3623,6307,5405,5421,-16,5405,5405,5405,5272,133,5272
3624,10623,10019,9659,360,9659,9659,10017,9512,505,9512
3625,57372,58658,57365,1293,57365,57365,58665,56933,1732,56933
3626,31751,12809,12652,157,12652,12652,12807,12398,409,12398
3627,2721,2519,2659,-140,2519,2519,2520,2469,51,2469
3628,289183,276111,261970,14141,261970,261970,276319,261342,14977,261342
3629,234799,244713,234771,9942,234771,234771,244651,233847,10804,233847
3630,1005,1003,1223,-220,1003,1003,1005,1053,-48,1005
3631,37744,36846,36009,837,36009,36009,36859,35746,1113,35746
3632,15800,16009,15835,174,15835,15800,16009,15178,831,15178
3633,22875,22876,22800,76,22800,22800,22875,22516,359,22516
3634,10659,9520,9424,96,9424,9424,9520,9084,436,9084
3635,7000,6998,7056,-58,6998,6998,7000,6931,69,6931
3636,604581,584822,551804,33018,551804,551804,584994,548040,36954,548040
3637,7125,7103,7233,-130,7103,7103,7102,7005,97,7005
3638,7450,7453,7511,-58,7453,7450,7450,7304,146,7304
3639,4859,4452,4525,-73,4452,4452,4449,4393,56,4393
3640,1482,1127,1372,-245,1127,1127,1127,1161,-34,1161
3641,6681,6337,6266,71,6266,6266,6336,6126,210,6126
3642,43000,35273,34608,665,34608,34608,35265,34163,1102,34163
3643,94539,93089,93216,-127,93089,93089,93082,90808,2274,90808
3644,1623,1623,1851,-228,1623,1623,1623,1679,-56,1623
3645,18757,17157,16580,577,16580,16580,17153,16435,718,16435
3646,3769,3767,3970,-203,3767,3767,3769,3831,-62,3769
3647,204387,204257,200628,3629,200628,200628,204387,195481,8906,195481
3648,51634,53842,51445,2397,51445,51445,53846,50768,3078,50768
3649,21575,21862,21567,295,21567,21567,21857,21213,644,21213
3650,6788,6349,6411,-62,6349,6349,6351,6267,84,6267
3651,22394,21471,21307,164,21307,21307,21486,21119,367,21119
3652,81195,32834,31656,1178,31656,31656,32865,31502,1363,31502
3653,10000,9898,10002,-104,9898,9898,9905,9805,100,9805
3654,13324,2028,2261,-233,2028,2028,2029,2067,-38,2067
3655,4302,4304,4359,-55,4304,4302,4302,4227,75,4227
3656,359863,380825,358094,22731,358094,358094,380867,355162,25705,355162
3657,4322,4319,4375,-56,4319,4319,4322,4107,215,4107
3658,2339,1408,1616,-208,1408,1408,1408,1449,-41,1449
3659,60388,41352,41186,166,41186,41186,41376,39558,1818,39558
3660,50814,50813,49461,1352,49461,49461,50814,49160,1654,49160
3661,63339,63318,60254,3064,60254,60254,63362,59575,3787,59575
3662,8173,7260,7233,27,7233,7233,7253,7178,75,7178
3663,12011,11463,11274,189,11274,11274,11475,11064,411,11064
3664,10862,10467,10435,32,10435,10435,10467,10263,204,10263
3665,89323,47574,46862,712,46862,46862,47574,44814,2760,44814
3666,1967,1597,1813,-216,1597,1597,1597,1619,-22,1619
3667,38875,38874,37300,1574,37300,37300,38875,37186,1689,37186
3668,40925,37814,34438,3376,34438,34438,37849,34170,3679,34170
3669,67540,66353,65496,857,65496,65496,66362,64858,1504,64858
3670,9818,9908,9814,94,9814,9814,9911,9657,254,9657
3671,63544,67987,65199,2788,65199,63544,67990,63536,4454,63536
3672,6319,6331,6449,-118,6331,6319,6332,6300,32,6300
3673,33189,14051,13975,76,13975,13975,14053,13839,214,13839
3674,6997,6577,6626,-49,6577,6577,6579,6497,82,6497
3675,8358,8720,8352,368,8352,8352,8726,8119,607,8119
3676,691,671,916,-245,671,671,671,716,-45,691
3677,1670,1201,1486,-285,1201,1201,1201,1242,-41,1242
3678,69689,67735,67301,434,67301,67301,67762,66119,1643,66119
3679,1626,1629,1884,-255,1629,1626,1629,1586,43,1586
3680,43703,15387,15050,337,15050,15050,15378,14909,469,14909
3681,1984,1986,2202,-216,1986,1984,1986,1852,134,1852
3682,57969,41364,39626,1738,39626,39626,41385,38495,2890,38495
3683,121757,128725,121750,6975,121750,121750,128669,120304,8365,120304
3684,81648,81677,77265,4412,77265,77265,81648,77161,4487,77161
3685,19318,20932,19885,1047,19885,19318,20953,19146,1807,19146
3686,292407,303523,293119,10404,293119,292407,303497,292454,11043,292407
3687,20863,21884,20799,1085,20799,20799,21893,20598,1295,20598
3688,47152,47383,47340,43,47340,47152,47421,46477,944,46477
3689,2263,1356,1541,-185,1356,1356,1356,1397,-41,1397
3690,5617,5617,5908,-291,5617,5617,5617,5644,-27,5617
3691,1920,1917,2113,-196,1917,1917,1920,1941,-21,1920
3692,3849,3193,3353,-160,3193,3193,3193,3232,-39,3232
3693,4050,3104,3306,-202,3104,3104,3105,3167,-62,3167
3694,37223,32034,31551,483,31551,31551,32032,31285,747,31285
3695,371,344,590,-246,344,344,344,384,-40,371
3696,42881,25902,25299,603,25299,25299,25910,25205,705,25205
3697,25152,8995,9008,-13,8995,8995,8996,8818,178,8818
3698,93127,95078,93117,1961,93117,93117,95122,91841,3281,91841
3699,4777,1554,1814,-260,1554,1554,1554,1617,-63,1617
3700,12965,814,1093,-279,814,814,814,855,-41,855
3701,10656,9484,8909,575,8909,8909,9486,8751,735,8751
3702,42440,36338,35243,1095,35243,35243,36336,34977,1359,34977
3703,17785,4498,4649,-151,4498,4498,4497,4496,1,4496
3704,4544,4543,4681,-138,4543,4543,4544,4309,235,4309
3705,163367,163291,156643,6648,156643,156643,163367,154513,8854,154513
3706,80715,79680,74071,5609,74071,74071,79710,69788,9922,69788
3707,15124,14544,13927,617,13927,13927,14547,13762,785,13762
3708,15328,14013,13844,169,13844,13844,14023,13687,336,13687
3709,170314,169439,162423,7016,162423,162423,169480,160422,9058,160422
3710,18250,17314,16906,408,16906,16906,17321,16739,582,16739
3711,5314,5274,5408,-134,5274,5274,5272,5181,91,5181
3712,50364,48602,47304,1298,47304,47304,48617,46682,1935,46682
3713,71025,67174,63889,3285,63889,63889,67136,63550,3586,63550
3714,10246,10243,10255,-12,10243,10243,10246,9987,259,9987
3715,5254,4416,4618,-202,4416,4416,4418,4473,-55,4473
3716,68791,22904,21868,1036,21868,21868,22896,21379,1517,21379
3717,57133,43791,43006,785,43006,43006,43803,40800,3003,40800
3718,9865,8630,8666,-36,8630,8630,8629,8581,48,8581
3719,254626,234028,224830,9198,224830,224830,234042,222378,11664,222378
3720,5465,5466,5686,-220,5466,5465,5465,5404,61,5404
3721,6125,5282,5452,-170,5282,5282,5279,5204,75,5204
3722,3722,3723,4030,-307,3723,3722,3722,3728,-6,3722
3723,454,434,669,-235,434,434,434,482,-48,454
3724,95364,94384,95005,-621,94384,94384,94507,93320,1187,93320
3725,38003,37988,36638,1350,36638,36638,37982,36339,1643,36339
3726,45170,46609,45585,1024,45585,45170,46637,45315,1322,45170
3727,10877,10877,10875,2,10875,10875,10874,10705,169,10705
3728,17844,17151,17144,7,17144,17144,17163,16828,335,16828
3729,20574,15335,14637,698,14637,14637,15324,14540,784,14540
3730,275985,274977,262091,12886,262091,262091,274974,259704,15270,259704
3731,4908,4062,4082,-20,4062,4062,4062,3305,757,3305
3732,27762,26055,24928,1127,24928,24928,26065,24780,1285,24780
3733,176564,175545,170779,4766,170779,170779,175566,169949,5617,169949
3734,30468,29618,28508,1110,28508,28508,29623,28245,1378,28245
3735,4244,3846,3965,-119,3846,3846,3847,3846,1,3846
3736,67460,66585,64948,1637,64948,64948,66630,58587,8043,58587
3737,6255,6254,6368,-114,6254,6254,6255,6269,-14,6255
3738,178519,188011,176652,11359,176652,176652,188085,175330,12755,175330
3739,7065,6736,7086,-350,6736,6736,6828,6930,-102,6930
3740,411890,410925,397722,13203,397722,397722,411184,393265,17919,393265
3741,13957,11820,11712,108,11712,11712,11824,11497,327,11497
3742,35526,32474,31217,1257,31217,31217,32484,30382,2102,30382
3743,300278,299072,287471,11601,287471,287471,299017,285022,13995,285022
3744,127654,127558,125581,1977,125581,125581,127654,123586,4068,123586
3745,76751,57143,55713,1430,55713,55713,57126,54392,2734,54392
3746,19281,18741,18047,694,18047,18047,18740,17946,794,17946
3747,9064,9035,8969,66,8969,8969,9032,8827,205,8827
3748,108455,88292,86654,1638,86654,86654,88301,85623,2678,85623
3749,7876,7893,8051,-158,7893,7876,7894,7726,168,7726
3750,10429,10972,10647,325,10647,10429,10960,10429,531,10429
3751,431,430,667,-237,430,430,431,480,-49,431
3752,9299,8018,8181,-163,8018,8018,8018,8017,1,8017
3753,7870,7335,7526,-191,7335,7335,7337,7200,137,7200
3754,4551,3704,3916,-212,3704,3704,3706,3699,7,3699
3755,1220,1238,1459,-221,1238,1220,1238,1213,25,1213
3756,2393,1800,2005,-205,1800,1800,1800,1849,-49,1849
3757,38771,37908,37255,653,37255,37255,37887,37052,835,37052
3758,489599,488738,481261,7477,481261,481261,488948,473737,15211,473737
3759,3261,3215,3459,-244,3215,3215,3216,3271,-55,3261
3760,2743,2217,2374,-157,2217,2217,2219,2232,-13,2232
3761,791,321,555,-234,321,321,321,349,-28,349
3762,27590,26663,26049,614,26049,26049,26684,25097,1587,25097
3763,80664,80627,78367,2260,78367,78367,80630,75391,5239,75391
3764,44528,45241,43543,1698,43543,43543,45248,43240,2008,43240
3765,11755,11752,11803,-51,11752,11752,11755,11594,161,11594
3766,81851,66406,64500,1906,64500,64500,66391,64123,2268,64123
3767,62587,60932,60878,54,60878,60878,60965,60587,378,60587
3768,1417,1052,1269,-217,1052,1052,1053,1098,-45,1098
3769,113492,113400,115812,-2412,113400,113400,113403,105059,8344,105059
3770,11076,11340,11000,340,11000,11000,11341,10661,680,10661
3771,1191,516,638,-122,516,516,515,527,-12,527
3772,2111,1146,1372,-226,1146,1146,1146,1200,-54,1200
3773,116199,115312,114876,436,114876,114876,115368,113325,2043,113325
3774,504,485,746,-261,485,485,485,545,-60,504
3775,19495,19489,19084,405,19084,19084,19478,18956,522,18956
3776,29692,29809,29682,127,29682,29682,29808,28611,1197,28611
3777,149926,97766,101024,-3258,97766,97766,97813,89484,8329,89484
3778,10113,10111,9675,436,9675,9675,10113,9477,636,9477
3779,55488,53493,51316,2177,51316,51316,53523,51184,2339,51184
3780,54592,54546,51945,2601,51945,51945,54553,50141,4412,50141
3781,822755,779467,749900,29567,749900,749900,779493,747721,31772,747721
3782,6828,6364,6402,-38,6364,6364,6366,6144,222,6144
3783,6790,5955,5999,-44,5955,5955,5956,5914,42,5914
3784,1066,1309,1784,-475,1309,1066,1309,1067,242,1066
3785,5049,4648,4682,-34,4648,4648,4648,4553,95,4553
3786,5351,2920,3068,-148,2920,2920,2922,2896,26,2896
3787,5689,5265,5332,-67,5265,5265,5264,5186,78,5186
3788,4863,4799,4838,-39,4799,4799,4802,4712,90,4712
3789,258076,212829,202290,10539,202290,202290,212729,201395,11334,201395
3790,13468,13465,13067,398,13067,13067,13468,12927,541,12927
3791,61165,54976,53137,1839,53137,53137,54997,52652,2345,52652
3792,17966,17149,16417,732,16417,16417,17145,16241,904,16241
3793,2287,2080,2286,-206,2080,2080,2082,2124,-42,2124
3794,5969,3985,4124,-139,3985,3985,3987,4014,-27,4014
3795,21166,21163,20823,340,20823,20823,21166,20648,518,20648
3796,50657,49385,48420,965,48420,48420,49396,47928,1468,47928
3797,5485,4926,4887,39,4887,4887,4925,4693,232,4693
3798,31190,8134,8153,-19,8134,8134,8137,7980,157,7980
3799,21771,20823,20034,789,20034,20034,20834,19829,1005,19829
3800,13133,13131,13006,125,13006,13006,13133,12936,197,12936
3801,106212,102154,97831,4323,97831,97831,102176,96071,6105,96071
3802,73115,73099,68622,4477,68622,68622,73115,66333,6782,66333
3803,4362,3931,4039,-108,3931,3931,3929,3920,9,3920
3804,5364,4992,5069,-77,4992,4992,4995,4943,52,4943
3805,4674,4545,4605,-60,4545,4545,4547,4507,40,4507
3806,15937,16163,15877,286,15877,15877,16166,15720,446,15720
3807,189878,179575,170381,9194,170381,170381,179559,169962,9597,169962
3808,10549,10877,10484,393,10484,10484,10880,10365,515,10365
3809,2701,2390,2585,-195,2390,2390,2391,2431,-40,2431
3810,9762,9759,9743,16,9743,9743,9762,9572,190,9572
3811,87521,87508,83411,4097,83411,83411,87521,81578,5943,81578
3812,13332,12890,12905,-15,12890,12890,12880,12656,224,12656
3813,14173,14173,13996,177,13996,13996,14173,13889,284,13889
3814,27157,27814,27149,665,27149,27149,27823,26933,890,26933
3815,5210,5208,5220,-12,5208,5208,5210,4992,218,4992
3816,1526,1342,1527,-185,1342,1342,1342,1384,-42,1384
3817,839,603,838,-235,603,603,603,653,-50,653
3818,21301,21788,21469,319,21469,21301,21784,20679,1105,20679
3819,10586,9291,9068,223,9068,9068,9297,8966,331,8966
3820,20989,21202,20551,651,20551,20551,21228,19676,1552,19676
3821,30452,30696,30436,260,30436,30436,30704,30229,475,30229
3822,45739,46982,45738,1244,45738,45738,46959,45418,1541,45418
3823,9562,8982,8725,257,8725,8725,8981,8657,324,8657
3824,817,817,1053,-236,817,817,817,869,-52,817
3825,26126,26083,25493,590,25493,25493,26078,25117,961,25117
3826,9601,8916,8921,-5,8916,8916,8920,8742,178,8742
3827,28819,14248,13149,1099,13149,13149,14250,12132,2118,12132
3828,4365,3516,3659,-143,3516,3516,3517,3189,328,3189
3829,65432,62259,59163,3096,59163,59163,62220,58762,3458,58762
3830,2780,2397,2648,-251,2397,2397,2401,2436,-35,2436
3831,59336,58059,57522,537,57522,57522,58089,56982,1107,56982
3832,21391,18713,18025,688,18025,18025,18719,17942,777,17942
3833,42362,41237,41932,-695,41237,41237,41262,40556,706,40556
3834,34442,34437,34683,-246,34437,34437,34442,33841,601,33841
3835,6827,6838,7029,-191,6838,6827,6843,6866,-23,6827
3836,10865,10860,11330,-470,10860,10860,10864,10715,149,10715
3837,138772,138712,135277,3435,135277,135277,138751,132112,6639,132112
3838,4078,2987,3200,-213,2987,2987,2989,2963,26,2963
3839,231262,231173,220224,10949,220224,220224,231206,218084,13122,218084
3840,38969,18335,17898,437,17898,17898,18338,17824,514,17824
3841,34999,34546,34836,-290,34546,34546,34556,33102,1454,33102
3842,3709,3283,3362,-79,3283,3283,3283,3237,46,3237
3843,54310,54305,53846,459,53846,53846,54310,52739,1571,52739
3844,92428,91470,88582,2888,88582,88582,91520,87417,4103,87417
3845,157948,164350,160300,4050,160300,157948,164431,159005,5426,157948
3846,206103,212438,206084,6354,206084,206084,212498,204913,7585,204913
3847,12267,12228,12825,-597,12228,12228,12232,12179,53,12179
3848,34814,34018,33179,839,33179,33179,34024,32950,1074,32950
3849,108894,75690,71659,4031,71659,71659,75702,70921,4781,70921
3850,24075,25264,24073,1191,24073,24073,25262,23954,1308,23954
3851,3796,3419,3542,-123,3419,3419,3422,3407,15,3407
3852,12938,13045,13321,-276,13045,12938,13048,12930,118,12930
3853,19051,19045,18604,441,18604,18604,19051,17884,1167,17884
3854,2187,1246,1463,-217,1246,1246,1246,1299,-53,1299
3855,49613,28322,26879,1443,26879,26879,28299,26763,1536,26763
3856,27874,28887,28297,590,28297,27874,28883,27252,1631,27252
3857,8290,7709,7885,-176,7709,7709,7711,7649,62,7649
3858,443996,448814,443864,4950,443864,443864,449150,434049,15101,434049
3859,151204,134375,129912,4463,129912,129912,134378,128370,6008,128370
3860,447961,446419,424690,21729,424690,424690,446357,419792,26565,419792
3861,62151,58941,58668,273,58668,58668,58948,57606,1342,57606
3862,2296,1906,2106,-200,1906,1906,1908,1950,-42,1950
3863,4412,4394,4515,-121,4394,4394,4394,4283,111,4283
3864,100026,83172,79806,3366,79806,79806,83174,78766,4408,78766
3865,12410,12406,12330,76,12330,12330,12410,12130,280,12130
3866,60957,60013,58065,1948,58065,58065,60009,56781,3228,56781
3867,10323,6918,6705,213,6705,6705,6920,6588,332,6588
3868,347249,278058,272354,5704,272354,272354,278066,270098,7968,270098
3869,5784,5781,5909,-128,5781,5781,5784,5688,96,5688
3870,12814,12838,12810,28,12810,12810,12839,12583,256,12583
3871,70453,65085,61185,3900,61185,61185,65091,60342,4749,60342
3872,216140,198901,189425,9476,189425,189425,198777,188256,10521,188256
3873,61148,61155,58588,2567,58588,58588,61148,58500,2648,58500
3874,8463,8465,8431,34,8431,8431,8463,8310,153,8310
3875,12664,12669,12033,636,12033,12033,12666,11401,1265,11401
3876,155748,155174,148466,6708,148466,148466,155194,148093,7101,148093
3877,541,513,770,-257,513,513,513,566,-53,541
3878,3915,3896,4043,-147,3896,3896,3895,3906,-11,3906
3879,209531,211032,208270,2762,208270,208270,211001,206318,4683,206318
3880,13149,12237,11800,437,11800,11800,12239,11483,756,11483
3881,23131,22657,22364,293,22364,22364,22657,22123,534,22123
3882,8203,4716,4832,-116,4716,4716,4717,4695,22,4695
3883,53706,50521,48249,2272,48249,48249,50544,47173,3371,47173
3884,39711,39700,39039,661,39039,39039,39711,38665,1046,38665
3885,7462,6529,6516,13,6516,6516,6532,6377,155,6377
3886,13555,11214,10799,415,10799,10799,11218,10670,548,10670
3887,8756,8325,8343,-18,8325,8325,8330,8180,150,8180
3888,28168,28088,26743,1345,26743,26743,28107,26610,1497,26610
3889,14286,14825,14284,541,14284,14284,14819,14185,634,14185
3890,45925,15532,15469,63,15469,15469,15537,15320,217,15320
3891,14272,3397,3373,24,3373,3373,3399,3141,258,3141
3892,857976,780013,766875,13138,766875,766875,780110,762935,17175,762935
3893,103791,103745,99398,4347,99398,99398,103791,99111,4680,99111
3894,75821,76845,76962,-117,76845,75821,76848,75793,1055,75793
3895,15244,11890,11952,-62,11890,11890,11891,11857,34,11857
3896,1324,953,1187,-234,953,953,954,1001,-47,1001
3897,83399,79321,81046,-1725,79321,79321,79343,79021,322,79021
3898,969,885,1146,-261,885,885,885,922,-37,922
3899,842610,870428,837498,32930,837498,837498,870962,824387,46575,824387
3900,5433,5257,5372,-115,5257,5257,5258,5220,38,5220
3901,250939,216736,207106,9630,207106,207106,216678,205577,11101,205577
3902,31977,29721,28257,1464,28257,28257,29734,27988,1746,27988
3903,22088,20332,19526,806,19526,19526,20340,19037,1303,19037
3904,101902,101853,94618,7235,94618,94618,101867,89576,12291,89576
3905,56816,56193,54159,2034,54159,54159,56174,53997,2177,53997
3906,23874,24594,24039,555,24039,23874,24580,23892,688,23874
3907,19305,18653,18657,-4,18653,18653,18647,18385,262,18385
3908,36846,36792,36331,461,36331,36331,36815,35805,1010,35805
3909,53957,53053,52291,762,52291,52291,53057,51173,1884,51173
3910,113224,112339,108317,4022,108317,108317,112357,107800,4557,107800
3911,35268,26534,27379,-845,26534,26534,26534,25327,1207,25327
3912,59397,53071,55835,-2764,53071,53071,53040,48925,4115,48925
3913,79185,77682,75989,1693,75989,75989,77699,75268,2431,75268
3914,69021,67830,67297,533,67297,67297,67857,66376,1481,66376
3915,155560,135580,127464,8116,127464,127464,135579,126073,9506,126073
3916,751,751,1019,-268,751,751,751,809,-58,751
3917,14381,14495,14319,176,14319,14319,14495,14109,386,14109
3918,15170,14383,13729,654,13729,13729,14377,13652,725,13652
3919,1692,1936,2200,-264,1936,1692,1936,1648,288,1648
3920,44700,46119,44985,1134,44985,44700,46111,44649,1462,44649
3921,1467,1466,1704,-238,1466,1466,1467,1461,6,1461
3922,4770,4792,4708,84,4708,4708,4791,4613,178,4613
3923,40386,39760,38270,1490,38270,38270,39770,38133,1637,38133
3924,6113,6108,6423,-315,6108,6108,6112,5724,388,5724
3925,20807,20793,19686,1107,19686,19686,20807,19622,1185,19622
3926,37028,36047,36063,-16,36047,36047,36089,35464,625,35464
3927,361121,361085,342712,18373,342712,342712,361098,334929,26169,334929
3928,140521,111721,110310,1411,110310,110310,111713,109405,2308,109405
3929,297744,296896,289341,7555,289341,289341,296743,287755,8988,287755
3930,265274,245060,238164,6896,238164,238164,245156,235703,9453,235703
3931,2917,1918,2090,-172,1918,1918,1916,1878,38,1878
3932,12010,11988,11893,95,11893,11893,11991,11652,339,11652
3933,30418,31091,30419,672,30419,30418,31091,30201,890,30201
3934,1827,1805,2047,-242,1805,1805,1807,1834,-27,1827
3935,187451,186451,177168,9283,177168,177168,186477,175536,10941,175536
3936,104367,103506,101375,2131,101375,101375,103509,100332,3177,100332
3937,6968,6969,6763,206,6763,6763,6968,6331,637,6331
3938,53822,53772,51474,2298,51474,51474,53768,50197,3571,50197
3939,10802,9961,10044,-83,9961,9961,9959,9458,501,9458
3940,73659,54937,53583,1354,53583,53583,54971,53021,1950,53021
3941,8898,7099,7468,-369,7099,7099,7100,6788,312,6788
3942,23354,23544,23351,193,23351,23351,23550,16836,6714,16836
3943,44978,36042,34212,1830,34212,34212,36032,34040,1992,34040
3944,6958,6961,6910,51,6910,6910,6958,6745,213,6745
3945,1470561,1324571,1309704,14867,1309704,1309704,1324692,1266106,58586,1266106
3946,2453,1851,2046,-195,1851,1851,1851,1737,114,1737
3947,11592,11587,11532,55,11532,11532,11592,11425,167,11425
3948,22136,21393,20416,977,20416,20416,21401,20374,1027,20374
3949,23965,23950,23946,4,23946,23946,23950,23642,308,23642
3950,78132,39133,38263,870,38263,38263,39148,33058,6090,33058
3951,13238,12336,12382,-46,12336,12336,12331,12029,302,12029
3952,179789,178994,170297,8697,170297,170297,179125,166513,12612,166513
3953,6756,6440,6519,-79,6440,6440,6441,6134,307,6134
3954,4726,4145,4209,-64,4145,4145,4147,4071,76,4071
3955,658472,648568,619725,28843,619725,619725,648413,618818,29595,618818
3956,51682,50744,50655,89,50655,50655,50753,49779,974,49779
3957,15185,7671,7652,19,7652,7652,7681,7554,127,7554
3958,117439,100692,96565,4127,96565,96565,100724,96344,4380,96344
3959,4077,3236,3391,-155,3236,3236,3236,3174,62,3174
3960,27503,26841,25735,1106,25735,25735,26841,25674,1167,25674
3961,53687,53656,52259,1397,52259,52259,53658,51501,2157,51501
3962,8793,8305,8193,112,8193,8193,8302,8042,260,8042
3963,2291,2292,2446,-154,2292,2291,2291,2306,-15,2291
3964,60269,59317,57759,1558,57759,57759,59322,57187,2135,57187
3965,36880,36870,36368,502,36368,36368,36880,35958,922,35958
3966,43740,43768,43345,423,43345,43345,43740,41752,1988,41752
3967,153127,126273,123929,2344,123929,123929,126284,121867,4417,121867
3968,8963,7976,7990,-14,7976,7976,7975,7789,186,7789
3969,7338,7338,7192,146,7192,7192,7338,6721,617,6721
3970,205157,204291,202664,1627,202664,202664,204385,198543,5842,198543
3971,13182,13159,13051,108,13051,13051,13161,12888,273,12888
3972,1544,1279,1544,-265,1279,1279,1280,1334,-54,1334
3973,22763,8330,8126,204,8126,8126,8327,7911,416,7911
3974,5445,4895,5093,-198,4895,4895,4895,4814,81,4814
3975,56003,56009,53225,2784,53225,53225,56003,52428,3575,52428
3976,1684,1684,1927,-243,1684,1684,1684,1753,-69,1684
3977,4522,4396,4458,-62,4396,4396,4399,4291,108,4291
3978,711,693,944,-251,693,693,693,746,-53,711
3979,215118,214067,204094,9973,204094,204094,214224,202991,11233,202991
3980,17359,6501,6617,-116,6501,6501,6506,6408,98,6408
3981,67986,36804,35304,1500,35304,35304,36813,34544,2269,34544
3982,5853,5681,5849,-168,5681,5681,5681,5573,108,5573
3983,9332,8418,8261,157,8261,8261,8422,8026,396,8026
3984,34125,15422,14979,443,14979,14979,15421,14900,521,14900
3985,67476,36247,33537,2710,33537,33537,36283,31249,5034,31249
3986,7849,7769,7849,-80,7769,7769,7772,7669,103,7669
3987,37468,36491,35651,840,35651,35651,36507,35389,1118,35389
3988,80403,76686,75430,1256,75430,75430,76695,74949,1746,74949
3989,5313,4965,5136,-171,4965,4965,4961,4941,20,4941
3990,4137,3814,3956,-142,3814,3814,3817,3773,44,3773
3991,88981,87337,83606,3731,83606,83606,87346,82800,4546,82800
3992,29225,29219,28327,892,28327,28327,29225,28187,1038,28187
3993,8652,8654,8296,358,8296,8296,8652,8197,455,8197
3994,19645,18841,18158,683,18158,18158,18840,18064,776,18064
3995,18595,18564,18398,166,18398,18398,18561,18320,241,18320
3996,20745,20754,20497,257,20497,20497,20745,20233,512,20233
3997,35038,17186,16249,937,16249,16249,17192,15727,1465,15727
3998,31716,33544,31720,1824,31720,31716,33531,31526,2005,31526
3999,31798,26438,26390,48,26390,26390,26439,25987,452,25987
4000,16722,16725,17102,-377,16725,16722,16722,16506,216,16506
4001,14071,14066,14417,-351,14066,14066,14071,14019,52,14019
4002,10520,9334,9302,32,9302,9302,9344,9052,292,9052
4003,73049,77953,73055,4898,73055,73049,77954,66570,11384,66570
4004,5559,5095,5254,-159,5095,5095,5097,5081,16,5081
4005,12074,12068,12235,-167,12068,12068,12074,11967,107,11967
4006,43746,46016,43737,2279,43737,43737,46036,43085,2951,43085
4007,3767,3744,3934,-190,3744,3744,3747,3822,-75,3767
4008,9528,6338,6324,14,6324,6324,6337,6206,131,6206
4009,113120,102732,97269,5463,97269,97269,102736,95624,7112,95624
4010,9746,8809,8809,0,8809,8809,8807,8596,211,8596
4011,29396,28539,27581,958,27581,27581,28552,26828,1724,26828
4012,32730,33181,32195,986,32195,32195,33184,32108,1076,32108
4013,7292,7295,7435,-140,7295,7292,7292,7254,38,7254
4014,44711,44618,44697,-79,44618,44618,44626,43971,655,43971
4015,31640,31545,29117,2428,29117,29117,31578,29011,2567,29011
4016,34641,16606,16264,342,16264,16264,16609,16045,564,16045
4017,21212,17796,17466,330,17466,17466,17794,17289,505,17289
4018,355734,340186,321723,18463,321723,321723,340296,319242,21054,319242
4019,46986,46088,45217,871,45217,45217,46083,45051,1032,45051
4020,33821,33738,33621,117,33621,33621,33739,33012,727,33012
4021,57800,44540,42151,2389,42151,42151,44520,42055,2465,42055
4022,51102,52101,51095,1006,51095,51095,52101,50118,1983,50118
4023,14442,14517,14601,-84,14517,14442,14516,14442,74,14442
4024,27226,27573,27233,340,27233,27226,27547,26981,566,26981
4025,49179,46488,43623,2865,43623,43623,46512,43479,3033,43479
4026,3600,3216,3327,-111,3216,3216,3216,3192,24,3192
4027,1273,875,1102,-227,875,875,875,909,-34,909
4028,7236,6327,6360,-33,6327,6327,6330,6118,212,6118
4029,25285,25229,24222,1007,24222,24222,25224,24181,1043,24181
4030,19112,18258,18704,-446,18258,18258,18269,18251,18,18251
4031,2979,2936,3161,-225,2936,2936,2938,2977,-39,2977
4032,352192,347493,332394,15099,332394,332394,347571,331246,16325,331246
4033,1221318,1221293,1160678,60615,1160678,1160678,1220984,1153779,67205,1153779
4034,29524,29406,28402,1004,28402,28402,29402,28224,1178,28224
4035,24875,24873,24335,538,24335,24335,24875,24201,674,24201
4036,22942,22934,22019,915,22019,22019,22942,21965,977,21965
4037,22942,22940,22447,493,22447,22447,22942,22310,632,22310
4038,16326,16326,15917,409,15917,15917,16326,15706,620,15706
4039,2168,2166,2331,-165,2166,2166,2168,2152,16,2152
4040,10676,10680,11033,-353,10680,10676,10676,10647,29,10647
4041,26739,27003,26489,514,26489,26489,26989,26612,377,26612
4042,7170,4533,4628,-95,4533,4533,4532,4470,62,4470
4043,281091,280981,270468,10513,270468,270468,281001,267188,13813,267188
4044,11704,11906,11821,85,11821,11704,11901,11637,264,11637
4045,19766,20618,19767,851,19767,19766,20626,18923,1703,18923
4046,11734,11223,10854,369,10854,10854,11224,10745,479,10745
4047,2769,2577,2709,-132,2577,2577,2578,2530,48,2530
4048,1438,1417,1651,-234,1417,1417,1418,1419,-1,1419
4049,32022,32035,31620,415,31620,31620,32022,31425,597,31425
4050,15041,14658,14314,344,14314,14314,14661,14115,546,14115
4051,40128,30686,28807,1879,28807,28807,30698,27598,3100,27598
4052,6151,6146,6088,58,6088,6088,6151,5979,172,5979
4053,59654,58742,55754,2988,55754,55754,58724,55496,3228,55496
4054,21633,22057,21859,198,21859,21633,22064,21011,1053,21011
4055,49079,56902,55991,911,55991,49079,56904,49071,7833,49071
4056,967772,967461,912571,54890,912571,912571,967772,904604,63168,904604
4057,3894,3892,3826,66,3826,3826,3894,3734,160,3734
4058,6608,6605,6858,-253,6605,6605,6608,6290,318,6290
4059,5145,5366,5390,-24,5366,5145,5367,5137,230,5137
4060,20271,19421,19267,154,19267,19267,19428,18974,454,18974
4061,196405,177157,174568,2589,174568,174568,177154,172455,4699,172455
4062,279572,247971,240685,7286,240685,240685,247991,240036,7955,240036
4063,12309,11707,11158,549,11158,11158,11709,11092,617,11092
4064,155489,154331,149337,4994,149337,149337,154382,148315,6067,148315
4065,71172,70212,67252,2960,67252,67252,70234,67016,3218,67016
4066,342368,313349,295392,17957,295392,295392,313161,294271,18890,294271
4067,51224,50381,51800,-1419,50381,50381,50394,48146,2248,48146
4068,8084,7250,7341,-91,7250,7250,7251,7253,-2,7253
4069,10388,9890,9542,348,9542,9542,9894,9311,583,9311
4070,19611,18773,18569,204,18569,18569,18781,18278,503,18278
4071,2087,1249,1463,-214,1249,1249,1248,1274,-26,1274
4072,16160,14779,14259,520,14259,14259,14781,13757,1024,13757
4073,83424,83492,77484,6008,77484,77484,83424,76888,6536,76888
4074,190966,181134,172257,8877,172257,172257,181043,169306,11737,169306
4075,201253,200303,190802,9501,190802,190802,200289,188476,11813,188476
4076,32487,33599,32475,1124,32475,32475,33599,32371,1228,32371
4077,116703,115660,112274,3386,112274,112274,115706,111657,4049,111657
4078,2973,2252,2398,-146,2252,2252,2252,2252,0,2252
4079,2119,1783,2042,-259,1783,1783,1784,1833,-49,1833
4080,7391,6818,6733,85,6733,6733,6818,6636,182,6636
4081,117208,107946,104130,3816,104130,104130,107923,103566,4357,103566
4082,14206,14210,14029,181,14029,14029,14206,13835,371,13835
4083,1301,393,639,-246,393,393,393,443,-50,443
4084,6581,5154,5327,-173,5154,5154,5154,5187,-33,5187
4085,43631,43570,41202,2368,41202,41202,43570,40926,2644,40926
4086,7172,7169,7069,100,7069,7069,7172,7008,164,7008
4087,99043,88872,83455,5417,83455,83455,88889,82966,5923,82966
4088,2088,2103,2364,-261,2103,2088,2104,2137,-33,2088
4089,11881,11205,10853,352,10853,10853,11204,10687,517,10687
4090,1427,729,989,-260,729,729,729,780,-51,780
4091,13069,13370,13229,141,13229,13069,13367,13061,306,13061
4092,36507,12672,12475,197,12475,12475,12676,12428,248,12428
4093,16388,16382,16489,-107,16382,16382,16388,16081,307,16081
4094,2996,1991,2215,-224,1991,1991,1991,2045,-54,2045
4095,16431,15875,15280,595,15280,15280,15876,15131,745,15131
4096,952,284,518,-234,284,284,284,330,-46,330
4097,14082,14046,14043,3,14043,14043,14053,13882,171,13882
4098,15602,15603,15237,366,15237,15237,15602,15194,408,15194
4099,33654,32792,31908,884,31908,31908,32803,31630,1173,31630
4100,2170,1265,1516,-251,1265,1265,1265,1321,-56,1321
4101,19816,19282,18706,576,18706,18706,19284,18633,651,18633
4102,2313,2254,2516,-262,2254,2254,2254,1382,872,1382
4103,2232,1916,2120,-204,1916,1916,1917,1969,-52,1969
4104,4525,3584,3572,12,3572,3572,3587,3169,418,3169
4105,25347,25339,24903,436,24903,24903,25347,24670,677,24670
4106,50813,51295,50612,683,50612,50612,51344,50191,1153,50191
4107,45604,43993,40805,3188,40805,40805,44000,40636,3364,40636
4108,83152,82209,81306,903,81306,81306,82230,80325,1905,80325
4109,4935,4219,4450,-231,4219,4219,4237,4211,26,4211
4110,35624,13023,12845,178,12845,12845,13026,12537,489,12537
4111,42682,40460,38409,2051,38409,38409,40449,38334,2115,38334
4112,11141,11544,11075,469,11075,11075,11545,10839,706,10839
4113,15482,15479,15471,8,15471,15471,15482,15310,172,15310
4114,11350,9623,9674,-51,9623,9623,9627,9595,32,9595
4115,20963,14679,14262,417,14262,14262,14682,13775,907,13775
4116,1587,1526,1749,-223,1526,1526,1526,1586,-60,1586
4117,35585,37337,35593,1744,35593,35585,37334,35129,2205,35129
4118,15228,1961,2197,-236,1961,1961,1961,2028,-67,2028
4119,60781,50902,50310,592,50310,50310,50885,49912,973,49912
4120,4743,3915,4117,-202,3915,3915,3913,3916,-3,3916
4121,135571,135590,129847,5743,129847,129847,135571,129111,6460,129111
4122,26419,25711,24778,933,24778,24778,25708,24687,1021,24687
4123,4428,3664,3815,-151,3664,3664,3664,3605,59,3605
4124,9439,8519,8368,151,8368,8368,8515,8204,311,8204
4125,143740,143769,135953,7816,135953,135953,143740,134376,9364,134376
4126,2293,1915,2195,-280,1915,1915,1915,1978,-63,1978
4127,9325,9668,9574,94,9574,9325,9674,9307,367,9307
4128,2434946,2364323,2282244,82079,2282244,2282244,2363978,2272222,91756,2272222
4129,9843,9095,8957,138,8957,8957,9097,8884,213,8884
4130,4060,3608,3704,-96,3608,3608,3610,3570,40,3570
4131,14118,12681,12519,162,12519,12519,12679,12369,310,12369
4132,104146,99943,95165,4778,95165,95165,99917,94848,5069,94848
4133,8808,7903,7918,-15,7903,7903,7900,7859,41,7859
4134,3318,3288,3510,-222,3288,3288,3289,3214,75,3214
4135,11384,11378,11399,-21,11378,11378,11384,11201,183,11201
4136,8100,7743,8032,-289,7743,7743,7745,7704,41,7704
4137,16423,16397,16155,242,16155,16155,16392,15807,585,15807
4138,12344,12327,12516,-189,12327,12327,12329,12279,50,12279
4139,32735,32128,30886,1242,30886,30886,32130,30802,1328,30802
4140,174699,184966,174663,10303,174663,174663,185031,174384,10647,174384
4141,23607,16215,15433,782,15433,15433,16211,15314,897,15314
4142,18250,17413,17010,403,17010,17010,17413,16819,594,16819
4143,7133,7136,7167,-31,7136,7133,7133,6047,1086,6047
4144,182290,161954,154529,7425,154529,154529,161909,153985,7924,153985
4145,10653,10667,10854,-187,10667,10653,10669,10697,-28,10653
4146,57473,27930,27262,668,27262,27262,27937,26973,964,26973
4147,5153,5140,5204,-64,5140,5140,5143,5056,87,5056
4148,87659,83265,79298,3967,79298,79298,83277,78448,4829,78448
4149,4536,3940,4040,-100,3940,3940,3942,3907,35,3907
4150,84879,12888,13143,-255,12888,12888,12895,12602,293,12602
4151,1463,1463,1698,-235,1463,1463,1463,1503,-40,1463
4152,1731,984,1211,-227,984,984,984,1035,-51,1035
4153,27013,26084,25258,826,25258,25258,26083,25181,902,25181
4154,10109,9619,9463,156,9463,9463,9618,9386,232,9386
4155,9814,10161,9814,347,9814,9814,10160,9727,433,9727
4156,6709,6197,6093,104,6093,6093,6198,6035,163,6035
4157,89794,89798,92053,-2255,89798,89794,89794,85108,4686,85108
4158,118747,117787,112881,4906,112881,112881,117779,112399,5380,112399
4159,144662,144660,138953,5707,138953,138953,144662,136228,8434,136228
4160,87719,89183,87689,1494,87689,87689,89187,86869,2318,86869
4161,128258,130710,128236,2474,128236,128236,130751,125900,4851,125900
4162,32672,32678,31879,799,31879,31879,32672,31465,1207,31465
4163,6612,6617,6701,-84,6617,6612,6612,6522,90,6522
4164,47976,47973,47279,694,47279,47279,47976,46894,1082,46894
4165,9184,8550,8327,223,8327,8327,8556,8099,457,8099
4166,14804,13961,13759,202,13759,13759,13960,13536,424,13536
4167,1307,927,1179,-252,927,927,927,972,-45,972
4168,426348,409353,380654,28699,380654,380654,409193,377735,31458,377735
4169,11401,11387,11343,44,11343,11343,11391,11108,283,11108
4170,9981,9981,10101,-120,9981,9981,9981,9559,422,9559
4171,168317,167859,164092,3767,164092,164092,167838,163504,4334,163504
4172,19423,18721,17946,775,17946,17946,18721,17915,806,17915
4173,28958,9696,9800,-104,9696,9696,9702,9623,79,9623
4174,3734,2012,2189,-177,2012,2012,2007,1949,58,1949
4175,125634,94159,91163,2996,91163,91163,94201,89782,4419,89782
4176,111701,118021,111658,6363,111658,111658,118050,111241,6809,111241
4177,43855,27086,28510,-1424,27086,27086,27095,25982,1113,25982
4178,8328,4240,4455,-215,4240,4240,4238,4288,-50,4288
4179,27771,26702,26031,671,26031,26031,26686,25735,951,25735
4180,2469,2087,2296,-209,2087,2087,2086,2132,-46,2132
4181,16417,17173,16921,252,16921,16417,17189,15795,1394,15795
4182,84123,45532,44711,821,44711,44711,45535,44216,1319,44216
4183,105844,104957,103427,1530,103427,103427,104956,102143,2813,102143
4184,36423,19312,18846,466,18846,18846,19313,18638,675,18638
4185,1730,888,1133,-245,888,888,888,932,-44,932
4186,100327,99527,94760,4767,94760,94760,99523,94312,5211,94312
4187,12794,12789,12945,-156,12789,12789,12794,10058,2736,10058
4188,5660,5656,5789,-133,5656,5656,5660,5597,63,5597
4189,7726,7272,7158,114,7158,7158,7271,7063,208,7063
4190,144630,143749,143578,171,143578,143578,143849,140536,3313,140536
4191,3387,3369,3564,-195,3369,3369,3368,3322,46,3322
4192,56168,58208,56146,2062,56146,56146,58217,56040,2177,56040
4193,1095,1096,1403,-307,1096,1095,1095,1084,11,1084
4194,4194,2802,3038,-236,2802,2802,2802,2778,24,2778
4195,3081,2699,2947,-248,2699,2699,2700,2765,-65,2765
4196,26083,25228,24641,587,24641,24641,25236,24560,676,24560
4197,6286,5445,5412,33,5412,5412,5447,5109,338,5109
4198,6785,6461,6379,82,6379,6379,6457,6219,238,6219
4199,1731,1052,1264,-212,1052,1052,1050,1104,-54,1104
4200,29730,28711,27809,902,27809,27809,28713,27443,1270,27443
4201,9697,8857,9484,-627,8857,8857,8857,7532,1325,7532
4202,34341,6756,6818,-62,6756,6756,6755,6636,119,6636
4203,18863,19423,19267,156,19267,18863,19422,18241,1181,18241
4204,8123,6501,6666,-165,6501,6501,6502,6561,-59,6561
4205,27950,27121,26369,752,26369,26369,27118,26124,994,26124
4206,2623,2161,2338,-177,2161,2161,2161,2170,-9,2170
4207,4643,3901,4012,-111,3901,3901,3899,3682,217,3682
4208,6230,5224,5280,-56,5224,5224,5226,5189,37,5189
4209,6929,6934,6837,97,6837,6837,6929,6594,335,6594
4210,44207,38642,37291,1351,37291,37291,38624,36629,1995,36629
4211,7620,7049,7164,-115,7049,7049,7050,7011,39,7011
4212,13012,11531,11290,241,11290,11290,11538,11099,439,11099
4213,34263,30526,28876,1650,28876,28876,30517,28692,1825,28692
4214,33694,34209,33688,521,33688,33688,34212,33233,979,33233
4215,102040,102010,98457,3553,98457,98457,102040,98215,3825,98215
4216,6973,6132,6296,-164,6132,6132,6134,6138,-4,6138
4217,408672,407523,386143,21380,386143,386143,407476,382007,25469,382007
4218,332003,313090,295868,17222,295868,295868,312960,295220,17740,295220
4219,7496,7006,6904,102,6904,6904,7015,6811,204,6811
4220,2718,1791,2059,-268,1791,1791,1792,1634,158,1634
4221,191195,166442,166390,52,166390,166390,166446,163914,2532,163914
4222,2840,2270,2422,-152,2270,2270,2269,2147,122,2147
4223,106036,105868,101354,4514,101354,101354,105946,100996,4950,100996
4224,16089,13918,13748,170,13748,13748,13914,13546,368,13546
4225,371,371,608,-237,371,371,371,417,-46,371
4226,11859,11862,11684,178,11684,11684,11859,11563,296,11563
4227,20772,19913,19981,-68,19913,19913,19922,19734,188,19734
4228,20308,19456,18535,921,18535,18535,19463,18498,965,18498
4229,13547,13762,13649,113,13649,13547,13765,13561,204,13547
4230,5046,5039,5186,-147,5039,5039,5046,4982,64,4982
4231,16788,17658,16721,937,16721,16721,17671,16551,1120,16551
4232,45252,42816,40876,1940,40876,40876,42822,40666,2156,40666
4233,71084,70350,67153,3197,67153,67153,70389,66932,3457,66932
4234,187962,155434,153456,1978,153456,153456,155333,151047,4286,151047
4235,5193,5198,5251,-53,5198,5193,5193,5013,180,5013
4236,2986,2943,2992,-49,2943,2943,2944,2848,96,2848
4237,20218,20222,19541,681,19541,19541,20218,19514,704,19514
4238,331268,330189,316853,13336,316853,316853,330199,315207,14992,315207
4239,2524,1598,1839,-241,1598,1598,1598,1662,-64,1662
4240,13252,1265,1542,-277,1265,1265,1268,1328,-60,1328
4241,22491,21749,21532,217,21532,21532,21761,21282,479,21282
4242,8011,7994,8027,-33,7994,7994,7994,7841,153,7841
4243,41146,39722,37547,2175,37547,37547,39708,37402,2306,37402
4244,107575,104273,96860,7413,96860,96860,104315,96098,8217,96098
4245,12105,9678,9846,-168,9678,9678,9683,9659,24,9659
4246,3576,3182,3355,-173,3182,3182,3185,3166,19,3166
4247,120175,121723,121868,-145,121723,120175,121748,119553,2195,119553
4248,148548,120605,121761,-1156,120605,120605,120643,119354,1289,119354
4249,6726,5819,5856,-37,5819,5819,5819,5705,114,5705
4250,4457,1275,1500,-225,1275,1275,1274,1328,-54,1328
4251,846537,845556,808492,37064,808492,808492,845700,806418,39282,806418
4252,10681,9989,9617,372,9617,9617,9993,9544,449,9544
4253,3362,3290,3366,-76,3290,3290,3291,3114,177,3114
4254,219279,214628,205518,9110,205518,205518,214660,204185,10475,204185
4255,4886,4902,5205,-303,4902,4886,4902,4790,112,4790
4256,8882,2568,2711,-143,2568,2568,2567,2569,-2,2569
4257,827,800,1048,-248,800,800,800,851,-51,827
4258,31690,31640,31410,230,31410,31410,31660,31124,536,31124
4259,19467,6154,6300,-146,6154,6154,6159,6158,1,6158
4260,33886,22849,21656,1193,21656,21656,22842,21277,1565,21277
4261,9369,9582,9364,218,9364,9364,9580,9213,367,9213
4262,78728,82675,78694,3981,78694,78694,82683,78524,4159,78524
4263,415,354,603,-249,354,354,354,407,-53,407
4264,4639,3641,3838,-197,3641,3641,3640,3694,-54,3694
4265,10659,2001,2220,-219,2001,2001,2001,2057,-56,2057
4266,16551,15646,15587,59,15587,15587,15648,15301,347,15301
4267,23055,10193,10061,132,10061,10061,10195,9974,221,9974
4268,1665,1285,1508,-223,1285,1285,1286,1340,-54,1340
4269,38811,38768,38086,682,38086,38086,38787,37615,1172,37615
4270,1473,1454,1731,-277,1454,1454,1455,1521,-66,1473
4271,17493,16738,16031,707,16031,16031,16742,16002,740,16002
4272,4216,4197,4386,-189,4197,4197,4198,4213,-15,4213
4273,10551,9539,9406,133,9406,9406,9548,9127,421,9127
4274,31581,31549,31302,247,31302,31302,31548,30749,799,30749
4275,9085,8628,8718,-90,8628,8628,8630,8391,239,8391
4276,3317,3198,3359,-161,3198,3198,3199,3214,-15,3214
4277,54732,38107,36498,1609,36498,36498,38137,34991,3146,34991
4278,6529,6135,6208,-73,6135,6135,6135,6033,102,6033
4279,15812,15641,15354,287,15354,15354,15651,15190,461,15190
4280,40344,40336,37402,2934,37402,37402,40344,35258,5086,35258
4281,189652,176454,168352,8102,168352,168352,176466,167817,8649,167817
4282,86146,84487,84724,-237,84487,84487,84459,82516,1943,82516
4283,30675,29665,28134,1531,28134,28134,29652,28054,1598,28054
4284,16767,1922,2165,-243,1922,1922,1923,1946,-23,1946
4285,12644,12631,12471,160,12471,12471,12634,12369,265,12369
4286,2160,2138,2421,-283,2138,2138,2139,2216,-77,2160
4287,210097,191728,181266,10462,181266,181266,191672,179382,12290,179382
4288,11490,10494,10180,314,10180,10180,10496,10123,373,10123
4289,129224,128127,125070,3057,125070,125070,128135,124136,3999,124136
4290,89915,88529,83231,5298,83231,83231,88508,83087,5421,83087
4291,141335,138129,134636,3493,134636,134636,138152,133539,4613,133539
4292,72094,71187,69740,1447,69740,69740,71198,69134,2064,69134
4293,3317,3316,3516,-200,3316,3316,3317,3238,79,3238
4294,70931,70921,68091,2830,68091,68091,70931,67604,3327,67604
4295,7812,7274,7301,-27,7274,7274,7278,7119,159,7119
4296,66585,65638,63397,2241,63397,63397,65656,62586,3070,62586
4297,11481,11460,11175,285,11175,11175,11460,10845,615,10845
4298,5470,5811,5940,-129,5811,5470,5822,5462,360,5462
4299,16509,16527,16302,225,16302,16302,16509,16153,356,16153
4300,12276,11876,11803,73,11803,11803,11875,11629,246,11629
4301,2640,2640,2821,-181,2640,2640,2640,2660,-20,2640
4302,3701,3616,3702,-86,3616,3616,3617,3549,68,3549
4303,19231,16404,16183,221,16183,16183,16410,15855,555,15855
4304,23638,22961,23195,-234,22961,22961,22974,22752,222,22752
4305,19676,19668,19656,12,19656,19656,19676,19404,272,19404
4306,76050,75050,72145,2905,72145,72145,75076,71345,3731,71345
4307,9631,9609,9277,332,9277,9277,9609,9223,386,9223
4308,144254,148761,142107,6654,142107,142107,148796,141478,7318,141478
4309,195971,201060,192656,8404,192656,192656,201077,192544,8533,192544
4310,110366,106772,100757,6015,100757,100757,106781,100293,6488,100293
4311,3008,2103,2356,-253,2103,2103,2104,2168,-64,2168
4312,2139,1968,2184,-216,1968,1968,1967,2031,-64,2031
4313,20656,20650,20029,621,20029,20029,20650,19933,717,19933
4314,2092,2071,2344,-273,2071,2071,2073,2128,-55,2092
4315,9148,9165,8508,657,8508,8508,9166,8011,1155,8011
4316,5395,4554,4677,-123,4554,4554,4554,4486,68,4486
4317,13893,14123,13828,295,13828,13828,14123,13731,392,13731
4318,24321,24119,23014,1105,23014,23014,24123,21896,2227,21896
4319,52885,52903,51403,1500,51403,51403,52885,51261,1624,51261
4320,16062,16060,15768,292,15768,15768,16062,15631,431,15631
4321,113375,71207,68563,2644,68563,68563,71173,68290,2883,68290
4322,45411,48130,44562,3568,44562,44562,48163,43855,4308,43855
4323,22539,22505,22133,372,22133,22133,22504,21873,631,21873
4324,8629,8441,8623,-182,8441,8441,8439,8427,12,8427
4325,9266,9177,9101,76,9101,9101,9181,8960,221,8960
4326,6727,2672,2886,-214,2672,2672,2671,2718,-47,2718
4327,8939,5069,5241,-172,5069,5069,5070,5086,-16,5086
4328,2816,2813,3058,-245,2813,2813,2816,2817,-1,2816
4329,16213,14832,14395,437,14395,14395,14844,14049,795,14049
4330,39370,38435,38427,8,38427,38427,38455,37968,487,37968
4331,1661,358,590,-232,358,358,358,402,-44,402
4332,55348,19411,19122,289,19122,19122,19427,19036,391,19036
4333,185890,176022,172871,3151,172871,172871,176072,169602,6470,169602
4334,12478,12052,11949,103,11949,11949,12051,11818,233,11818
4335,33626,30035,28265,1770,28265,28265,30051,28190,1861,28190
4336,103370,103364,100591,2773,100591,100591,103408,99861,3547,99861
4337,665,410,665,-255,410,410,410,460,-50,460
4338,11274,11252,11008,244,11008,11008,11252,10622,630,10622
4339,33941,21457,20726,731,20726,20726,21460,20082,1378,20082
4340,11960,11948,11679,269,11679,11679,11943,11579,364,11579
4341,65660,63051,61092,1959,61092,61092,63056,60905,2151,60905
4342,18178,14653,14328,325,14328,14328,14653,14159,494,14159
4343,3191,3169,3394,-225,3169,3169,3170,3124,46,3124
4344,56376,56374,54748,1626,54748,54748,56368,54360,2008,54360
4345,35909,16397,16417,-20,16397,16397,16406,15721,685,15721
4346,22862,21855,21021,834,21021,21021,21854,20989,865,20989
4347,3509,3488,3751,-263,3488,3488,3489,3528,-39,3509
4348,10074,10017,9937,80,9937,9937,10023,9796,227,9796
4349,1363534,1307170,1246946,60224,1246946,1246946,1306680,1232615,74065,1232615
4350,223920,188570,180014,8556,180014,180014,188593,176822,11771,176822
4351,2933,2951,3268,-317,2951,2933,2951,2772,179,2772
4352,2948,2577,2690,-113,2577,2577,2578,2531,47,2531
4353,40512,22011,21650,361,21650,21650,22020,21471,549,21471
4354,7527,6999,6823,176,6823,6823,6993,6668,325,6668
4355,1424,810,1072,-262,810,810,809,802,7,802
4356,359,340,582,-242,340,340,340,384,-44,359
4357,52278,51070,49305,1765,49305,49305,51078,49225,1853,49225
4358,12462,11154,10615,539,10615,10615,11163,10483,680,10483
4359,56980,29623,29057,566,29057,29057,29625,28638,987,28638
4360,20829,20282,19745,537,19745,19745,20277,19657,620,19657
4361,4930,3811,3988,-177,3811,3811,3815,3841,-26,3841
4362,19759,18877,18296,581,18296,18296,18858,16712,2146,16712
4363,12317,12305,11961,344,11961,11961,12300,11838,462,11838
4364,13659,12656,12142,514,12142,12142,12650,12063,587,12063
4365,23573,9432,9449,-17,9432,9432,9432,9333,99,9333
4366,217415,217443,210352,7091,210352,210352,217349,209004,8345,209004
4367,48328,47447,45086,2361,45086,45086,47467,44892,2575,44892
4368,116187,110607,103749,6858,103749,103749,110583,103665,6918,103665
4369,7932,7914,8082,-168,7914,7914,7912,7896,16,7896
4370,1185,588,844,-256,588,588,588,608,-20,608
4371,23592,23571,23244,327,23244,23244,23562,23212,350,23212
4372,47625,38938,37422,1516,37422,37422,38921,36892,2029,36892
4373,218609,217717,208752,8965,208752,208752,217691,207698,9993,207698
4374,3329,3329,3572,-243,3329,3329,3329,3367,-38,3329
4375,11891,12413,11821,592,11821,11821,12403,11744,659,11744
4376,68599,39300,38377,923,38377,38377,39310,37905,1405,37905
4377,8106,7506,7581,-75,7506,7506,7507,7484,23,7484
4378,1697,1333,1588,-255,1333,1333,1333,1381,-48,1381
4379,14636,13386,12877,509,12877,12877,13387,12318,1069,12318
4380,15254,15226,15404,-178,15226,15226,15231,15111,120,15111
4381,883700,883202,835913,47289,835913,835913,883373,832229,51144,832229
4382,65174,63726,63005,721,63005,63005,63698,62583,1115,62583
4383,15777,14925,14898,27,14898,14898,14932,14648,284,14648
4384,2704,2681,2919,-238,2681,2681,2681,2585,96,2585
4385,5642,5625,5853,-228,5625,5625,5627,5561,66,5561
4386,48572,29041,28571,470,28571,28571,29034,28209,825,28209
4387,80626,66306,67587,-1281,66306,66306,66303,63738,2565,63738
4388,5977,5975,6249,-274,5975,5975,5977,5592,385,5592
4389,26542,26468,26070,398,26070,26070,26474,25920,554,25920
4390,515529,496828,469636,27192,469636,469636,496877,467471,29406,467471
4391,15235,14001,13236,765,13236,13236,14003,12962,1041,12962
4392,152380,151394,143692,7702,143692,143692,151407,143062,8345,143062
4393,7763,7144,7187,-43,7144,7144,7143,6999,144,6999
4394,145322,150030,145288,4742,145288,145288,150044,144670,5374,144670
4395,4105,4102,4125,-23,4102,4102,4105,3988,117,3988
4396,12128,11570,11540,30,11540,11540,11569,11324,245,11324
4397,9287,8771,9105,-334,8771,8771,8778,8826,-48,8826
4398,909,908,1131,-223,908,908,909,942,-33,909
4399,60161,43836,42084,1752,42084,42084,43813,41981,1832,41981
4400,28170,29974,28411,1563,28411,28170,29979,28180,1799,28170
4401,45654,44737,43181,1556,43181,43181,44746,42437,2309,42437
4402,45373,45264,44796,468,44796,44796,45273,44585,688,44585
4403,100093,88769,84562,4207,84562,84562,88778,84146,4632,84146
4404,10517,7125,7211,-86,7125,7125,7125,6994,131,6994
4405,5776,5355,5440,-85,5355,5355,5357,5278,79,5278
4406,4806,4470,4501,-31,4470,4470,4469,4375,94,4375
4407,10732,10709,10593,116,10593,10593,10702,10422,280,10422
4408,22555,7207,7316,-109,7207,7207,7202,7142,60,7142
4409,8365,8366,8427,-61,8366,8365,8365,8222,143,8222
4410,4838,1434,1677,-243,1434,1434,1435,1494,-59,1494
4411,301,301,534,-233,301,301,301,345,-44,301
4412,13686,13686,14039,-353,13686,13686,13686,10992,2694,10992
4413,32998,33006,32509,497,32509,32509,32998,32081,917,32081
4414,10078,10020,10194,-174,10020,10020,10017,9978,39,9978
4415,8367,8365,8370,-5,8365,8365,8367,8221,146,8221
4416,6480,5669,5785,-116,5669,5669,5673,5670,3,5670
4417,29749,28751,27870,881,27870,27870,28711,26768,1943,26768
4418,6319,6319,6227,92,6227,6227,6319,6121,198,6121
4419,9816,9784,9820,-36,9784,9784,9790,9587,203,9587
4420,45211,43403,41643,1760,41643,41643,43407,40816,2591,40816
4421,24753,26555,24762,1793,24762,24753,26565,24131,2434,24131
4422,6378,6354,6578,-224,6354,6354,6354,6391,-37,6378
4423,3347,3322,3556,-234,3322,3322,3321,3400,-79,3347
4424,17092,17068,16956,112,16956,16956,17068,15897,1171,15897
4425,76432,56438,53945,2493,53945,53945,56462,53742,2720,53742
4426,6675,6673,6671,2,6671,6671,6675,6162,513,6162
4427,725604,525867,531874,-6007,525867,525867,525756,468603,57153,468603
4428,4761,4739,4968,-229,4739,4739,4737,4732,5,4732
4429,73078,72229,67451,4778,67451,67451,72233,62081,10152,62081
4430,14599,14617,14384,233,14384,14384,14617,14257,360,14257
4431,11857,11832,11530,302,11530,11530,11833,11222,611,11222
4432,12306,12129,11845,284,11845,11845,12132,11684,448,11684
4433,219788,212043,204564,7479,204564,204564,212094,203136,8958,203136
4434,33865,33871,32677,1194,32677,32677,33865,32502,1363,32502
4435,42101,42044,40724,1320,40724,40724,42047,40418,1629,40418
4436,17332,17307,17081,226,17081,17081,17308,16919,389,16919
4437,2430,2056,2246,-190,2056,2056,2057,2080,-23,2080
4438,12633,12636,12708,-72,12636,12633,12633,12546,87,12546
4439,79654,82930,79618,3312,79618,79618,82942,79508,3434,79508
4440,134309,134219,130224,3995,130224,130224,134275,129415,4860,129415
4441,10094,10095,10232,-137,10095,10094,10094,9961,133,9961
4442,352,352,595,-243,352,352,352,402,-50,352
4443,5198,4772,4929,-157,4772,4772,4773,4694,79,4694
4444,17123,16872,16742,130,16742,16742,16877,16587,290,16587
4445,31115,11232,11125,107,11125,11125,11236,11017,219,11017
4446,201255,2833,3061,-228,2833,2833,2832,2899,-67,2899
4447,3716,3715,3891,-176,3715,3715,3716,3717,-1,3716
4448,19027,5654,5848,-194,5654,5654,5655,5694,-39,5694
4449,7464,7043,7155,-112,7043,7043,7046,6975,71,6975
4450,329,308,540,-232,308,308,308,352,-44,329
4451,33922,33918,32482,1436,32482,32482,33922,32426,1496,32426
4452,87253,87043,85729,1314,85729,85729,87053,84702,2351,84702
4453,532,513,763,-250,513,513,513,572,-59,532
4454,11004,10929,10932,-3,10929,10929,10933,10765,168,10765
4455,22691,22698,22175,523,22175,22175,22691,22103,588,22103
4456,43805,42798,42729,69,42729,42729,42816,40972,1844,40972
4457,1661,1677,1914,-237,1677,1661,1677,1726,-49,1661
4458,502736,471530,446918,24612,446918,446918,471642,443505,28137,443505
4459,32167,32165,31754,411,31754,31754,32167,30527,1640,30527
4460,2264,1416,1736,-320,1416,1416,1416,1307,109,1307
4461,349313,329411,311398,18013,311398,311398,329419,307308,22111,307308
4462,89279,88371,85757,2614,85757,85757,88411,84924,3487,84924
4463,73172,74893,72753,2140,72753,72753,74921,72550,2371,72550
4464,27322,13699,13352,347,13352,13352,13696,13285,411,13285
4465,20310,366,604,-238,366,366,366,387,-21,387
4466,7528,6989,6843,146,6843,6843,6987,6781,206,6781
4467,9991,497,739,-242,497,497,497,507,-10,507
4468,6145,6150,6130,20,6130,6130,6145,6030,115,6030
4469,1419,1045,1285,-240,1045,1045,1045,1096,-51,1096
4470,13512,13645,13640,5,13640,13512,13648,13460,188,13460
4471,20736,20069,19974,95,19974,19974,20079,19773,306,19773
4472,8614,7775,7739,36,7739,7739,7775,7546,229,7546
4473,244148,208987,197941,11046,197941,197941,208977,194993,13984,194993
4474,5739,5263,5371,-108,5263,5263,5267,5201,66,5201
4475,43913,42164,40799,1365,40799,40799,42183,40123,2060,40123
4476,2344,1505,1691,-186,1505,1505,1505,1316,189,1316
4477,2968,2704,2887,-183,2704,2704,2708,2724,-16,2724
4478,1575987,1550642,1533120,17522,1533120,1533120,1551203,1521229,29974,1521229
4479,6042,5205,5415,-210,5205,5205,5204,5228,-24,5228
4480,848463,799339,750805,48534,750805,750805,798978,740046,58932,740046
4481,13541,13597,13539,58,13539,13539,13595,13282,313,13282
4482,18155,15680,14605,1075,14605,14605,15683,14156,1527,14156
4483,8039,8037,8095,-58,8037,8037,8039,7923,116,7923
4484,11837,11836,11655,181,11655,11655,11837,11442,395,11442
4485,866,569,805,-236,569,569,569,610,-41,610
4486,2773,2299,2558,-259,2299,2299,2298,2362,-64,2362
4487,56128,56091,52628,3463,52628,52628,56128,51255,4873,51255
4488,19367,19364,18832,532,18832,18832,19367,18737,630,18737
4489,6302,5374,5407,-33,5374,5374,5377,5337,40,5337
4490,251594,250557,242437,8120,242437,242437,250607,239691,10916,239691
4491,221151,220243,220914,-671,220243,220243,220267,210530,9737,210530
4492,93621,98318,93635,4683,93635,93621,98328,93253,5075,93253
4493,10373,9635,9495,140,9495,9495,9630,9296,334,9296
4494,9255,8848,8912,-64,8848,8848,8850,8761,89,8761
4495,28583,28335,28918,-583,28335,28335,28341,28217,124,28217
4496,22001,21954,21425,529,21425,21425,21966,21079,887,21079
4497,15885,2637,2805,-168,2637,2637,2639,2623,16,2623
4498,306,287,521,-234,287,287,287,333,-46,306
4499,1760,1390,1626,-236,1390,1390,1393,1447,-54,1447
4500,60820,60809,59657,1152,59657,59657,60820,59048,1772,59048
4501,4422,3551,3724,-173,3551,3551,3547,3601,-54,3601
4502,6325,6338,6538,-200,6338,6325,6341,6330,11,6325
4503,62932,62878,61425,1453,61425,61425,62921,61157,1764,61157
4504,814,380,619,-239,380,380,380,426,-46,426
4505,16311,15174,14756,418,14756,14756,15174,14611,563,14611
4506,9217,8730,8689,41,8689,8689,8729,8519,210,8519
4507,6793,6203,6213,-10,6203,6203,6206,6091,115,6091
4508,33485,27203,26589,614,26589,26589,27213,26462,751,26462
4509,25098,1958,2206,-248,1958,1958,1960,1948,12,1948
4510,64285,48713,46768,1945,46768,46768,48708,45476,3232,45476
4511,5479,5478,5425,53,5425,5425,5479,5267,212,5267
4512,1473,568,824,-256,568,568,568,620,-52,620
4513,36148,33229,31536,1693,31536,31536,33230,31487,1743,31487
4514,51516,51475,50519,956,50519,50519,51498,50005,1493,50005
4515,1021,707,952,-245,707,707,707,755,-48,755
4516,9135,899,1135,-236,899,899,900,952,-52,952
4517,3757,3720,3866,-146,3720,3720,3719,3718,1,3718
4518,1508,1509,1745,-236,1509,1508,1508,1559,-51,1508
4519,6670,3364,3526,-162,3364,3364,3364,3348,16,3348
4520,257722,251856,257627,-5771,251856,251856,251952,252297,-345,252297
4521,5348,4376,4372,4,4372,4372,4377,4206,171,4206
4522,15963,5465,5786,-321,5465,5465,5466,3647,1819,3647
4523,51789,36494,36286,208,36286,36286,36497,35373,1124,35373
4524,16546,15882,15641,241,15641,15641,15888,15571,317,15571
4525,994,974,1228,-254,974,974,974,1016,-42,994
4526,2964,2573,2766,-193,2573,2573,2574,2605,-31,2605
4527,3536,3511,3684,-173,3511,3511,3512,3483,29,3483
4528,1639,1612,1845,-233,1612,1612,1611,1661,-50,1639
4529,12572,10784,10659,125,10659,10659,10784,10535,249,10535
4530,327221,299226,289429,9797,289429,289429,299305,287015,12290,287015
4531,12032,7249,7228,21,7228,7228,7247,7106,141,7106
4532,4509,4070,4074,-4,4070,4070,4072,3988,84,3988
4533,13391,13351,14049,-698,13351,13351,13354,13372,-18,13372
4534,33684,32763,32030,733,32030,32030,32770,31854,916,31854
4535,379,379,621,-242,379,379,379,429,-50,379
4536,3700,2788,3001,-213,2788,2788,2788,2824,-36,2824
4537,43392,31097,30282,815,30282,30282,31118,30016,1102,30016
4538,3330,3308,3495,-187,3308,3308,3308,3323,-15,3323
4539,5992,5633,5738,-105,5633,5633,5634,5370,264,5370
4540,94538,92597,88707,3890,88707,88707,92567,87856,4711,87856
4541,19029,17511,17397,114,17397,17397,17510,16908,602,16908
4542,4272,4275,4392,-117,4275,4272,4272,4225,47,4225
4543,21995,22001,21235,766,21235,21235,21995,21144,851,21144
4544,5984,5605,5679,-74,5605,5605,5605,5523,82,5523
4545,2776,2776,2966,-190,2776,2776,2776,2707,69,2707
4546,10519,10494,10177,317,10177,10177,10504,9908,596,9908
4547,19346,19339,19152,187,19152,19152,19346,18981,365,18981
4548,19404,14614,14687,-73,14614,14614,14624,14197,427,14197
4549,4520,4536,4781,-245,4536,4520,4536,4595,-59,4520
4550,30574,33406,30516,2890,30516,30516,33416,26376,7040,26376
4551,13438,593,866,-273,593,593,593,654,-61,654
4552,20680,17385,17010,375,17010,17010,17389,16893,496,16893
4553,22890,22087,21676,411,21676,21676,22092,21488,604,21488
4554,13120,1419,1655,-236,1419,1419,1419,1475,-56,1475
4555,1427,1434,1628,-194,1434,1427,1435,1435,0,1427
4556,1784,1765,2030,-265,1765,1765,1766,1808,-42,1784
4557,5143,4775,4820,-45,4775,4775,4773,4653,120,4653
4558,18738,369,610,-241,369,369,369,417,-48,417
4559,6393,5941,5893,48,5893,5893,5943,5752,191,5752
4560,226065,210327,195987,14340,195987,195987,210310,195757,14553,195757
4561,2978,2826,2978,-152,2826,2826,2825,2838,-13,2838
4562,645,626,870,-244,626,626,626,669,-43,645
4563,1502,463,711,-248,463,463,463,517,-54,517
4564,13024,13000,12623,377,12623,12623,13001,12529,472,12529
4565,12979,5706,5822,-116,5706,5706,5707,5701,6,5701
4566,48283,41431,42634,-1203,41431,41431,41463,41410,53,41410
4567,17894,17890,17058,832,17058,17058,17889,16617,1272,16617
4568,3343,2917,3104,-187,2917,2917,2918,2957,-39,2957
4569,396762,396748,385161,11587,385161,385161,396762,377580,19182,377580
4570,75665,72159,68593,3566,68593,68593,72166,67518,4648,67518
4571,799,779,1012,-233,779,779,779,803,-24,799
4572,38368,38326,39175,-849,38326,38326,38339,37531,808,37531
4573,8453,8469,8653,-184,8469,8453,8469,8354,115,8354
4574,17717,17953,17720,233,17720,17717,17960,17358,602,17358
4575,1169,847,1100,-253,847,847,846,884,-38,884
4576,17990,17989,17779,210,17779,17779,17990,17699,291,17699
4577,36203,36158,34701,1457,34701,34701,36162,34090,2072,34090
4578,6280,6280,6578,-298,6280,6280,6280,5072,1208,5072
4579,1994,1975,2167,-192,1975,1975,1975,1949,26,1949
4580,50887,38681,37900,781,37900,37900,38691,37426,1265,37426
4581,26909,28223,26910,1313,26910,26909,28225,26571,1654,26571
4582,1829,1496,1696,-200,1496,1496,1498,1528,-30,1528
4583,25240,24073,23726,347,23726,23726,24083,23127,956,23127
4584,1180,342,585,-243,342,342,342,389,-47,389
4585,40164,40175,40172,3,40172,40164,40164,39136,1028,39136
4586,62900,61579,59692,1887,59692,59692,61580,59288,2292,59288
4587,21879,21236,20521,715,20521,20521,21237,20459,778,20459
4588,5713,4809,4899,-90,4809,4809,4808,4792,16,4792
4589,660,642,891,-249,642,642,641,690,-49,660
4590,28145,28149,27010,1139,27010,27010,28145,26946,1199,26946
4591,413797,376644,364173,12471,364173,364173,376569,359697,16872,359697
4592,40995,12334,12174,160,12174,12174,12334,12107,227,12107
4593,17955,17953,17713,240,17713,17713,17955,17626,329,17626
4594,43360,44269,43276,993,43276,43276,44259,42738,1521,42738
4595,18866,18852,18421,431,18421,18421,18866,18114,752,18114
4596,15327,15320,15324,-4,15320,15320,15327,15064,263,15064
4597,7308,6275,6507,-232,6275,6275,6279,6333,-54,6333
4598,6777,6314,6396,-82,6314,6314,6311,6164,147,6164
4599,35309,35292,34593,699,34593,34593,35309,34257,1052,34257
4600,8364,8372,8405,-33,8372,8364,8374,8125,249,8125
4601,23284,22434,22101,333,22101,22101,22435,20591,1844,20591
4602,111975,111914,109171,2743,109171,109171,111964,107939,4025,107939
4603,8099,8095,8160,-65,8095,8095,8099,7957,142,7957
4604,34482,34061,34068,-7,34061,34061,34087,33860,227,33860
4605,4641,4065,4177,-112,4065,4065,4064,4031,33,4031
4606,7294,7274,7320,-46,7274,7274,7271,7244,27,7244
4607,14574,14097,13990,107,13990,13990,14090,13776,314,13776
4608,219469,195947,186402,9545,186402,186402,195912,185194,10718,185194
4609,97112,97113,95633,1480,95633,95633,97112,94496,2616,94496
4610,3242051,3168377,3060915,107462,3060915,3060915,3168475,3020901,147574,3020901
4611,73884,34066,32718,1348,32718,32718,34073,32563,1510,32563
4612,43404,14692,14327,365,14327,14327,14685,14109,576,14109
4613,2066,1077,1363,-286,1077,1077,1078,1133,-55,1133
4614,10985,10532,10100,432,10100,10100,10532,10040,492,10040
4615,20505,20434,19937,497,19937,19937,20433,19883,550,19883
4616,18129,16423,16183,240,16183,16183,16425,16043,382,16043
4617,88836,57062,55370,1692,55370,55370,57064,54107,2957,54107
4618,57060,59936,57041,2895,57041,57041,59939,56755,3184,56755
4619,26001,3299,3540,-241,3299,3299,3298,3301,-3,3301
4620,1590,1571,1836,-265,1571,1571,1571,1598,-27,1590
4621,67282,67274,65427,1847,65427,65427,67282,65196,2086,65196
4622,16455,17017,16455,562,16455,16455,17028,16316,712,16316
4623,94692,91815,87993,3822,87993,87993,91877,87586,4291,87586
4624,44278,36455,36332,123,36332,36332,36463,35658,805,35658
4625,3423,3421,3632,-211,3421,3421,3423,3467,-44,3423
4626,5103,4444,4599,-155,4444,4444,4447,4481,-34,4481
4627,1071,1070,1307,-237,1070,1070,1071,1122,-51,1071
4628,46345,46359,45421,938,45421,45421,46358,44968,1390,44968
4629,4066,3366,3563,-197,3366,3366,3367,3415,-48,3415
4630,21131,21095,20867,228,20867,20867,21099,20585,514,20585
4631,2860,2859,3109,-250,2859,2859,2860,2917,-57,2860
4632,3525,2982,3135,-153,2982,2982,2983,3003,-20,3003
4633,3267,2926,3068,-142,2926,2926,2926,2932,-6,2932
4634,78240,34473,33077,1396,33077,33077,34491,32781,1710,32781
4635,24158,3418,3582,-164,3418,3418,3416,3476,-60,3476
4636,1936,1915,2125,-210,1915,1915,1916,1969,-53,1936
4637,92709,106980,98052,8928,98052,92709,107014,92087,14927,92087
4638,8688,8684,8604,80,8604,8604,8688,8480,208,8480
4639,7448,7445,7355,90,7355,7355,7448,7255,193,7255
4640,1255,1051,1255,-204,1051,1051,1051,1029,22,1029
4641,9735,9164,9261,-97,9164,9164,9159,9112,47,9112
4642,10134,10107,10102,5,10102,10102,10110,9934,176,9934
4643,42390,41183,39582,1601,39582,39582,41197,39299,1898,39299
4644,2227,2012,2231,-219,2012,2012,2010,2060,-50,2060
4645,501,482,728,-246,482,482,482,488,-6,488
4646,14553,14822,14495,327,14495,14495,14820,14295,525,14295
4647,9441,8364,8326,38,8326,8326,8363,8243,120,8243
4648,9954,9954,9805,149,9805,9805,9954,9564,390,9564
4649,4545,329,570,-241,329,329,329,373,-44,373
4650,316333,315349,298690,16659,298690,298690,315451,294656,20795,294656
4651,990,971,1242,-271,971,971,970,1003,-33,990
4652,31617,13355,13025,330,13025,13025,13365,13004,361,13004
4653,15502,15487,15144,343,15144,15144,15485,15020,465,15020
4654,11615,10972,10883,89,10883,10883,10969,10762,207,10762
4655,1346,1124,1354,-230,1124,1124,1124,1079,45,1079
4656,4284,3950,4093,-143,3950,3950,3952,3947,5,3947
4657,17500,3296,3466,-170,3296,3296,3300,3316,-16,3316
4658,4052,4052,4101,-49,4052,4052,4052,4026,26,4026
4659,6277,6274,6597,-323,6274,6274,6277,6174,103,6174
4660,14311,13511,13869,-358,13511,13511,13516,13572,-56,13572
4661,5767,6764,6649,115,6649,5767,6768,5774,994,5767
4662,26164,6527,6783,-256,6527,6527,6528,6577,-49,6577
4663,7602,4421,4637,-216,4421,4421,4422,4445,-23,4445
4664,24320,3999,4153,-154,3999,3999,4001,4015,-14,4015
4665,13616,5943,6091,-148,5943,5943,5943,5937,6,5937
4666,14899,2586,2841,-255,2586,2586,2585,2633,-48,2633
4667,66894,66917,64045,2872,64045,64045,66912,62773,4139,62773
4668,2328,624,868,-244,624,624,624,535,89,535
4669,106420,88906,85083,3823,85083,85083,88927,84289,4638,84289
4670,2938,2936,3120,-184,2936,2936,2938,2967,-29,2938
4671,3105,2392,2541,-149,2392,2392,2394,2315,79,2315
4672,28573,26772,25574,1198,25574,25574,26775,25418,1357,25418
4673,10213,10186,10206,-20,10186,10186,10193,10080,113,10080
4674,416,416,659,-243,416,416,416,433,-17,416
4675,16578,15647,15562,85,15562,15562,15653,15256,397,15256
4676,8526,1805,2073,-268,1805,1805,1805,1858,-53,1858
4677,37165,8812,8880,-68,8812,8812,8810,8754,56,8754
4678,23847,24485,24103,382,24103,23847,24496,23225,1271,23225
4679,4142,4125,4139,-14,4125,4125,4129,3978,151,3978
4680,4391,6531,7299,-768,6531,4391,6531,4391,2140,4391
4681,17911,17452,17175,277,17175,17175,17468,16985,483,16985
4682,735,322,556,-234,322,322,322,366,-44,366
4683,1880,1880,2079,-199,1880,1880,1880,1922,-42,1880
4684,86856,86852,83279,3573,83279,83279,86856,82782,4074,82782
4685,24140,24133,23681,452,23681,23681,24123,23300,823,23300
4686,23894,23896,23728,168,23728,23728,23894,23528,366,23528
4687,4434,4007,4054,-47,4007,4007,4007,3928,79,3928
4688,42679,42002,41098,904,41098,41098,42017,40603,1414,40603
4689,68233,63235,59823,3412,59823,59823,63242,59631,3611,59631
4690,2384,2014,2221,-207,2014,2014,2013,2059,-46,2059
4691,20236,4258,4427,-169,4258,4258,4255,4263,-8,4263
4692,23592,23552,23413,139,23413,23413,23556,23125,431,23125
4693,70995,71005,67850,3155,67850,67850,70989,66589,4400,66589
4694,4134,3082,3148,-66,3082,3082,3082,2881,201,2881
4695,21983,397,632,-235,397,397,397,445,-48,445
4696,16393,3386,3676,-290,3386,3386,3386,3416,-30,3416
4697,346325,350921,346249,4672,346249,346249,351226,339874,11352,339874
4698,5721,5326,5412,-86,5326,5326,5327,5265,62,5265
4699,2185,641,872,-231,641,641,640,677,-37,677
4700,58761,60656,58749,1907,58749,58749,60655,58407,2248,58407
4701,22558,21194,20395,799,20395,20395,21180,20259,921,20259
4702,26001,24659,23965,694,23965,23965,24666,23843,823,23843
4703,8275,8272,8117,155,8117,8117,8275,8016,259,8016
4704,1963,1941,2129,-188,1941,1941,1943,1878,65,1878
4705,20092,20098,20112,-14,20098,20092,20092,19913,179,19913
4706,4764,4746,4953,-207,4746,4746,4743,4769,-26,4764
4707,7742,301,538,-237,301,301,301,347,-46,347
4708,1739,1719,1936,-217,1719,1719,1719,1478,241,1478
4709,37908,18865,18493,372,18493,18493,18864,18349,515,18349
4710,2517,2366,2579,-213,2366,2366,2367,2375,-8,2375
4711,16331,17172,16076,1096,16076,16076,17179,15709,1470,15709
4712,18786,18219,18714,-495,18219,18219,18237,18135,102,18135
4713,13109,13112,12950,162,12950,12950,13109,12774,335,12774
4714,2281,2260,2482,-222,2260,2260,2260,2296,-36,2281
4715,11225,11225,11169,56,11169,11169,11225,11042,183,11042
4716,2123,2138,2414,-276,2138,2123,2139,2201,-62,2123
4717,11632,11616,11417,199,11417,11417,11615,11158,457,11158
4718,199422,202890,196504,6386,196504,196504,202895,192293,10602,192293
4719,2915,2549,2729,-180,2549,2549,2547,2530,17,2530
4720,4334,3568,3803,-235,3568,3568,3566,3607,-41,3607
4721,375,375,607,-232,375,375,375,424,-49,375
4722,50161,47080,45758,1322,45758,45758,47095,45143,1952,45143
4723,455,436,694,-258,436,436,436,492,-56,455
4724,681,348,594,-246,348,348,348,395,-47,395
4725,46416,46379,45310,1069,45310,45310,46383,44433,1950,44433
4726,681,450,705,-255,450,450,450,506,-56,506
4727,2814,2505,2688,-183,2505,2505,2504,2541,-37,2541
4728,1166,328,565,-237,328,328,328,375,-47,375
4729,4305,4068,4300,-232,4068,4068,4067,4055,12,4055
4730,1399,1181,1399,-218,1181,1181,1181,1229,-48,1229
4731,18674,3315,3542,-227,3315,3315,3319,3289,30,3289
4732,1575,957,1178,-221,957,957,957,1010,-53,1010
4733,57897,37586,35855,1731,35855,35855,37597,35316,2281,35316
4734,7858,7805,7605,200,7605,7605,7806,7555,251,7555
4735,5443,5423,5618,-195,5423,5423,5423,5448,-25,5443
4736,72928,71334,70280,1054,70280,70280,71351,69209,2142,69209
4737,8670,8442,8573,-131,8442,8442,8446,8370,76,8370
4738,15557,15521,15336,185,15336,15336,15521,15069,452,15069
4739,7319,7292,7809,-517,7292,7292,7295,6941,354,6941
4740,2266,2262,2423,-161,2262,2262,2266,2168,98,2168
4741,1280,1280,1500,-220,1280,1280,1280,1288,-8,1280
4742,870671,791214,749564,41650,749564,749564,791258,741560,49698,741560
4743,5857,5832,5969,-137,5832,5832,5834,5833,1,5833
4744,7111,7125,7232,-107,7125,7111,7127,7102,25,7102
4745,165695,141197,134697,6500,134697,134697,141238,133278,7960,133278
4746,22398,20016,19450,566,19450,19450,20022,19262,760,19262
4747,9997,9971,9851,120,9851,9851,9975,9392,583,9392
4748,31207,32488,32182,306,32182,31207,32491,30585,1906,30585
4749,23971,24747,23967,780,23967,23967,24743,23619,1124,23619
4750,1324,1325,1548,-223,1325,1324,1324,1365,-41,1324
4751,24862,12342,12118,224,12118,12118,12343,11993,350,11993
4752,1040,1019,1253,-234,1019,1019,1019,1022,-3,1022
4753,4096,3226,3485,-259,3226,3226,3224,3285,-61,3285
4754,511,511,756,-245,511,511,511,556,-45,511
4755,3766,604,860,-256,604,604,605,661,-56,661
4756,8661,1133,1385,-252,1133,1133,1132,1189,-57,1189
4757,1424,1194,1424,-230,1194,1194,1194,1253,-59,1253
4758,1501,1481,1694,-213,1481,1481,1483,1540,-57,1501
4759,2098,1961,2184,-223,1961,1961,1963,2010,-47,2010
4760,31025,30487,29744,743,29744,29744,30480,29489,991,29489
4761,4575,4577,4792,-215,4577,4575,4575,4604,-29,4575
4762,1531,1548,1800,-252,1548,1531,1547,1606,-59,1531
4763,21584,20639,20337,302,20337,20337,20638,20144,494,20144
4764,7325,6312,6445,-133,6312,6312,6312,6096,216,6096
4765,46460,51600,48790,2810,48790,46460,51605,46460,5145,46460
4766,25502,25481,24910,571,24910,24910,25499,24775,724,24775
4767,99490,99476,97545,1931,97545,97545,99400,97157,2243,97157
4768,16562,16548,16231,317,16231,16231,16557,15923,634,15923
4769,12267,12249,12104,145,12104,12104,12250,11898,352,11898
4770,32630,26411,26061,350,26061,26061,26432,25855,577,25855
4771,523,523,770,-247,523,523,523,528,-5,523
4772,2828,2827,3003,-176,2827,2827,2828,2597,231,2597
4773,3134,2387,2604,-217,2387,2387,2386,2434,-48,2434
4774,2967,2303,2461,-158,2303,2303,2302,2298,4,2298
4775,177044,185811,176983,8828,176983,176983,185742,176274,9468,176274
4776,1202,966,1202,-236,966,966,966,1006,-40,1006
4777,7139,7147,7107,40,7107,7107,7148,6942,206,6942
4778,41636,41636,40136,1500,40136,40136,41627,39475,2152,39475
4779,509,485,716,-231,485,485,485,532,-47,509
4780,19023,18988,19167,-179,18988,18988,19009,18758,251,18758
4781,1533,1516,1729,-213,1516,1516,1517,1524,-7,1524
4782,20848,20952,20895,57,20895,20848,20957,20380,577,20380
4783,3981,3982,4170,-188,3982,3981,3981,3997,-16,3981
4784,3875,3828,4043,-215,3828,3828,3828,3891,-63,3875
4785,1599,1288,1530,-242,1288,1288,1288,1343,-55,1343
4786,32866,34629,33143,1486,33143,32866,34639,32244,2395,32244
4787,46554,40194,38257,1937,38257,38257,40195,38009,2186,38009
4788,184903,174711,163347,11364,163347,163347,174734,162516,12218,162516
4789,4221,3808,4035,-227,3808,3808,3815,3876,-61,3876
4790,83939,82494,78068,4426,78068,78068,82516,77714,4802,77714
4791,1404,1383,1648,-265,1383,1383,1383,1439,-56,1404
4792,11854,3230,3461,-231,3230,3230,3226,3237,-11,3237
4793,46675,46669,45855,814,45855,45855,46675,45473,1202,45473
4794,373,354,589,-235,354,354,354,393,-39,373
4795,54733,19698,19673,25,19673,19673,19702,19259,443,19259
4796,1508,1151,1421,-270,1151,1151,1151,1197,-46,1197
4797,49088,49033,46641,2392,46641,46641,49042,46176,2866,46176
4798,5799,5796,5952,-156,5796,5796,5799,5802,-3,5799
4799,868,632,868,-236,632,632,632,663,-31,663
4800,1740,1740,2004,-264,1740,1740,1740,1824,-84,1740
4801,794,794,1060,-266,794,794,794,832,-38,794
4802,1131,1131,1403,-272,1131,1131,1131,1182,-51,1131
4803,1131,1131,1403,-272,1131,1131,1131,1182,-51,1131
4804,1131,1131,1403,-272,1131,1131,1131,1182,-51,1131
4805,1131,1131,1403,-272,1131,1131,1131,1182,-51,1131
4806,1149,955,1150,-195,955,955,956,985,-29,985
4807,1938,1515,1748,-233,1515,1515,1515,1546,-31,1546
4808,76418,73327,72386,941,72386,72386,73330,71504,1826,71504
4809,44209,44231,44025,206,44025,44025,44244,43587,657,43587
4810,22526,21719,21837,-118,21719,21719,21715,21327,388,21327
4811,18643,2014,2267,-253,2014,2014,2013,2046,-33,2046
4812,1141832,1094107,1045233,48874,1045233,1045233,1094015,1042042,51973,1042042
4813,2866,2278,2457,-179,2278,2278,2278,2314,-36,2314
4814,42996,46237,42991,3246,42991,42991,46244,41271,4973,41271
4815,31704,31733,32017,-284,31733,31704,31737,31250,487,31250
4816,3015,2396,2555,-159,2396,2396,2397,2404,-7,2404
4817,8578,8572,8511,61,8511,8511,8578,8392,186,8392
4818,560057,532523,497355,35168,497355,497355,532451,492479,39972,492479
4819,134381,129038,123568,5470,123568,123568,129043,123158,5885,123158
4820,2877,2755,2879,-124,2755,2755,2757,2752,5,2752
4821,8709,7900,7702,198,7702,7702,7902,7617,285,7617
4822,6802,2999,3201,-202,2999,2999,3002,3005,-3,3005
4823,36110,35173,34408,765,34408,34408,35159,34073,1086,34073
4824,18472,18615,18551,64,18551,18472,18624,17850,774,17850
4825,6253,5622,5786,-164,5622,5622,5622,5631,-9,5631
4826,4814,4772,4848,-76,4772,4772,4768,4716,52,4716
4827,272671,275998,261635,14363,261635,261635,276194,254991,21203,254991
4828,18751,18198,17977,221,17977,17977,18209,17627,582,17627
4829,113637,90171,85400,4771,85400,85400,90187,83950,6237,83950
4830,120528,113599,106970,6629,106970,106970,113566,106519,7047,106519
4831,23164,23122,23248,-126,23122,23122,23130,22758,372,22758
4832,15928,15926,15926,0,15926,15926,15931,15441,490,15441
4833,71570,68449,67870,579,67870,67870,68460,66596,1864,66596
4834,447072,444479,445049,-570,444479,444479,444510,431040,13470,431040
4835,1677,1370,1598,-228,1370,1370,1368,1423,-55,1423
4836,8547,8543,8721,-178,8543,8543,8547,8383,164,8383
4837,6475,6455,6475,-20,6455,6455,6458,6372,86,6372
4838,5032,4383,4541,-158,4383,4383,4384,4410,-26,4410
4839,90466,94007,90450,3557,90450,90450,93996,89844,4152,89844
4840,167343,166305,164765,1540,164765,164765,166336,161368,4968,161368
4841,252862,250759,238256,12503,238256,238256,250954,237679,13275,237679
4842,2288,2289,2551,-262,2289,2288,2288,2321,-33,2288
4843,96095,67482,65222,2260,65222,65222,67489,65139,2350,65139
4844,232697,223683,232672,-8989,223683,223683,223737,222219,1518,222219
4845,107350,109598,107319,2279,107319,107319,109581,106416,3165,106416
4846,333147,346342,333093,13249,333093,333093,346210,332525,13685,332525
4847,1722,1536,1724,-188,1536,1536,1536,1580,-44,1580
4848,65408,65374,64098,1276,64098,64098,65370,63358,2012,63358
4849,279337,287083,276048,11035,276048,276048,287110,273909,13201,273909
4850,209075,212875,200918,11957,200918,200918,213031,200507,12524,200507
4851,23350,18343,18191,152,18191,18191,18362,17837,525,17837
4852,18573,18279,18021,258,18021,18021,18283,17951,332,17951
4853,3296,3255,3447,-192,3255,3255,3256,3248,8,3248
4854,232783,214465,208468,5997,208468,208468,214532,207156,7376,207156
4855,163082,153407,147636,5771,147636,147636,153398,145395,8003,145395
4856,15331,15834,15720,114,15720,15331,15844,14709,1135,14709
4857,20814,21675,20799,876,20799,20799,21682,20192,1490,20192
4858,1106,1024,1292,-268,1024,1024,1026,1064,-38,1064
4859,44107,40933,39978,955,39978,39978,40941,39584,1357,39584
4860,7917,7487,7519,-32,7487,7487,7494,7295,199,7295
4861,75498,75478,73185,2293,73185,73185,75491,72525,2966,72525
4862,281856,257883,245567,12316,245567,245567,257854,244723,13131,244723
4863,18199,17834,17818,16,17818,17818,17846,17577,269,17577
4864,469416,548383,555161,-6778,548383,469416,548503,469408,79095,469408
4865,38153,41063,40263,800,40263,38153,41061,37531,3530,37531
4866,516962,528573,518236,10337,518236,516962,528769,516340,12429,516340
4867,29940,30876,30146,730,30146,29940,30892,29318,1574,29318
4868,8801,8865,8734,131,8734,8734,8865,8576,289,8576
4869,36711,37679,36303,1376,36303,36303,37679,36089,1590,36089
4870,42109,42088,40005,2083,40005,40005,42105,39632,2473,39632
4871,68532,68459,66305,2154,66305,66305,68476,65659,2817,65659
4872,36937,36888,36107,781,36107,36107,36902,35669,1233,35669
4873,14344,14322,14297,25,14297,14297,14326,14164,162,14164
4874,2116,1820,2055,-235,1820,1820,1818,1777,41,1777
4875,37272,37228,36187,1041,36187,36187,37230,35855,1375,35855
4876,10147,9686,9834,-148,9686,9686,9695,9577,118,9577
4877,1166,1081,1343,-262,1081,1081,1083,1124,-41,1124
4878,26230,25934,26097,-163,25934,25934,25937,25608,329,25608
4879,69919,78800,74651,4149,74651,69919,78812,69297,9515,69297
4880,153502,155971,153461,2510,153461,153461,156070,149872,6198,149872
4881,22192,22309,21934,375,21934,21934,22308,21570,738,21570
4882,28695,28568,28147,421,28147,28147,28576,28073,503,28073
4883,51476,51417,49788,1629,49788,49788,51439,49412,2027,49412
4884,17792,18230,17069,1161,17069,17069,18258,16553,1705,16553
4885,29154,28710,28884,-174,28710,28710,28710,28532,178,28532
4886,275213,290888,275196,15692,275196,275196,290885,274853,16032,274853
4887,212720,192023,189104,2919,189104,189104,192120,180157,11963,180157
4888,103465,102855,98063,4792,98063,98063,102833,96126,6707,96126
4889,29241,29100,28797,303,28797,28797,29107,28619,488,28619
4890,4853,4854,4897,-43,4854,4853,4853,4761,92,4761
4891,6409,5616,5843,-227,5616,5616,5619,5540,79,5540
4892,346,346,582,-236,346,346,346,390,-44,346
4893,482073,496345,481980,14365,481980,481980,496312,480373,15939,480373
4894,108260,88945,84621,4324,84621,84621,88930,83706,5224,83706
4895,52078,51954,50462,1492,50462,50462,51937,50015,1922,50015
4896,138076,112027,108574,3453,108574,108574,112044,107709,4335,107709
4897,3510,3360,3509,-149,3360,3360,3360,3365,-5,3365
4898,20489,12137,11851,286,11851,11851,12140,11414,726,11414
4899,29834,29185,28266,919,28266,28266,29190,28028,1162,28028
4900,32128,33156,32138,1018,32138,32128,33184,31211,1973,31211
4901,3390,3390,3571,-181,3390,3390,3390,3399,-9,3390
4902,17334,17248,16902,346,16902,16902,17242,14941,2301,14941
4903,323541,304910,296654,8256,296654,296654,304889,293018,11871,293018
4904,72091,70335,68343,1992,68343,68343,70356,67917,2439,67917
4905,1808,1705,1931,-226,1705,1705,1705,1761,-56,1761
4906,8892,9049,8894,155,8894,8892,9046,8808,238,8808
4907,45517,45977,45035,942,45035,45035,45975,44895,1080,44895
4908,4470,4426,4515,-89,4426,4426,4426,4403,23,4403
4909,269327,282522,269278,13244,269278,269278,282528,261156,21372,261156
4910,3092,2405,2632,-227,2405,2405,2406,2470,-64,2470
4911,34818,36126,34835,1291,34835,34818,36115,34676,1439,34676
4912,49500,52632,49764,2868,49764,49500,52645,48878,3767,48878
4913,77847,80062,77523,2539,77523,77523,80104,77225,2879,77225
4914,96123,102298,96686,5612,96686,96123,102304,95501,6803,95501
4915,94278,96478,93954,2524,93954,93954,96481,93656,2825,93656
4916,205843,209163,206659,2504,206659,205843,209097,205221,3876,205221
4917,84216,67504,64507,2997,64507,64507,67498,62993,4505,62993
4918,100741,100558,96513,4045,96513,96513,100538,94374,6164,94374
4919,38631,37795,36698,1097,36698,36698,37777,36561,1216,36561
4920,82088,71053,67151,3902,67151,67151,71075,65553,5522,65553
4921,1306,1200,1457,-257,1200,1200,1200,1260,-60,1260
4922,49160,50222,48604,1618,48604,48604,50235,48538,1697,48538
4923,43989,43938,42814,1124,42814,42814,43955,42546,1409,42546
4924,29603,29562,29125,437,29125,29125,29570,28981,589,28981
4925,4889,3964,4180,-216,3964,3964,3965,3933,32,3933
4926,17283,17293,16974,319,16974,16974,17296,16656,640,16656
4927,19289,19694,19277,417,19277,19277,19692,19034,658,19034
4928,18702,18139,18218,-79,18139,18139,18160,17658,502,17658
4929,47320,46772,44554,2218,44554,44554,46778,43756,3022,43756
4930,64675,65787,64488,1299,64488,64488,65792,64053,1739,64053
4931,40783,40829,38919,1910,38919,38919,40814,38395,2419,38395
4932,30786,31945,31228,717,31228,30786,31969,30164,1805,30164
4933,5889,5285,5310,-25,5285,5285,5283,5180,103,5180
4934,102299,107168,102273,4895,102273,102273,107185,101011,6174,101011
4935,121468,119553,113960,5593,113960,113960,119593,113122,6471,113122
4936,10819,10986,10987,-1,10986,10819,10990,10197,793,10197
4937,4269,4238,4356,-118,4238,4238,4237,4263,-26,4263
4938,1070,818,1070,-252,818,818,817,879,-62,879
4939,115499,115471,108948,6523,108948,108948,115499,107398,8101,107398
4940,707,707,934,-227,707,707,707,758,-51,707
4941,1686,1069,1330,-261,1069,1069,1069,1064,5,1064
4942,65161,68573,65152,3421,65152,65152,68557,65101,3456,65101
4943,1597,1577,1835,-258,1577,1577,1577,1601,-24,1597
4944,83012,87509,83977,3532,83977,83012,87554,82390,5164,82390
4945,98856,102988,98610,4378,98610,98610,103009,98234,4775,98234
4946,215800,238341,224860,13481,224860,215800,238476,215178,23298,215178
4947,25831,26154,25271,883,25271,25271,26160,25209,951,25209
4948,227986,221568,207786,13782,207786,207786,221602,206404,15198,206404
4949,72049,59734,56851,2883,56851,56851,59722,56786,2936,56786
4950,15728,15693,15401,292,15401,15401,15695,15130,565,15130
4951,45651,46119,45164,955,45164,45164,46123,45029,1094,45029
4952,124803,124666,122582,2084,122582,122582,124707,121599,3108,121599
4953,35055,35309,34544,765,34544,34544,35314,34433,881,34433
4954,18144,17145,16465,680,16465,16465,17138,16411,727,16411
4955,30214,29196,28615,581,28615,28615,29214,28266,948,28266
4956,33640,35961,35074,887,35074,33640,35960,33018,2942,33018
4957,10343,10494,10340,154,10340,10340,10499,10049,450,10049
4958,17821,18467,17878,589,17878,17821,18470,17199,1271,17199
4959,4138,3415,3603,-188,3415,3415,3417,3478,-61,3478
4960,14408,13870,13486,384,13486,13486,13870,13321,549,13321
4961,109683,109648,100795,8853,100795,100795,109683,96909,12774,96909
4962,13077,13089,12946,143,12946,12946,13090,12653,437,12653
4963,14047,14472,14199,273,14199,14047,14468,13425,1043,13425
4964,865,622,865,-243,622,622,622,673,-51,673
4965,13079,6296,6519,-223,6296,6296,6295,6361,-66,6361
4966,13396,13386,13290,96,13290,13290,13394,12966,428,12966
4967,928,706,929,-223,706,706,706,751,-45,751
4968,20050,20714,20027,687,20027,20027,20716,19428,1288,19428
4969,88334,88300,88414,-114,88300,88300,88324,87700,624,87700
4970,20057,19716,20070,-354,19716,19716,19719,19435,284,19435
4971,30063,30057,28910,1147,28910,28910,30067,28565,1502,28565
4972,8343,8363,8232,131,8232,8232,8361,7933,428,7933
4973,123701,124894,121244,3650,121244,121244,124917,120763,4154,120763
4974,1728,1520,1729,-209,1520,1520,1519,1580,-61,1580
4975,18902,17093,17229,-136,17093,17093,17096,16892,204,16892
4976,155348,153104,146980,6124,146980,146980,153163,146664,6499,146664
4977,14573,15228,14576,652,14576,14573,15238,14384,854,14384
4978,26063,26019,25231,788,25231,25231,26017,24891,1126,24891
4979,36049,35997,35396,601,35396,35396,36017,35063,954,35063
4980,67355,64171,61760,2411,61760,61760,64139,61637,2502,61637
4981,5210,4658,4697,-39,4658,4658,4659,4625,34,4625
4982,43121,43140,43093,47,43093,43093,43141,42499,642,42499
4983,136035,137779,136013,1766,136013,136013,137759,134362,3397,134362
4984,1368,1197,1495,-298,1197,1197,1196,1262,-66,1262
4985,6731,6639,6727,-88,6639,6639,6635,6553,82,6553
4986,28001,29537,28751,786,28751,28001,29547,27379,2168,27379
4987,8566,8120,8223,-103,8120,8120,8119,7944,175,7944
4988,284,284,519,-235,284,284,284,331,-47,284
4989,3689,3411,3626,-215,3411,3411,3409,3441,-32,3441
4990,86651,83515,81616,1899,81616,81616,83521,80298,3223,80298
4991,26897,26869,26257,612,26257,26257,26876,25972,904,25972
4992,26922,27677,26908,769,26908,26908,27686,26300,1386,26300
4993,31158,31162,30829,333,30829,30829,31158,30566,592,30566
4994,44539,44820,44128,692,44128,44128,44829,43987,842,43987
4995,181773,168989,161061,7928,161061,161061,168990,159830,9160,159830
4996,3076,3080,3235,-155,3080,3076,3077,3095,-18,3076
4997,4902,4404,4518,-114,4404,4404,4404,4280,124,4280
4998,48741,42776,40712,2064,40712,40712,42751,40619,2132,40619
4999,19386,20157,19815,342,19815,19386,20166,18764,1402,18764
5000,14071,14842,14117,725,14117,14071,14838,13449,1389,13449
5001,31172,30245,29188,1057,29188,29188,30240,28788,1452,28788
5002,388611,387787,367625,20162,367625,367625,387735,364584,23151,364584
5003,20362,20425,20357,68,20357,20357,20422,19917,505,19917
5004,52850,54057,52255,1802,52255,52255,54024,52228,1796,52228
5005,139024,138445,133486,4959,133486,133486,138482,133219,5263,133219
5006,84246,79544,75479,4065,75479,75479,79572,73363,6209,73363
5007,3294,2618,2805,-187,2618,2618,2620,2672,-52,2672
5008,26532,20856,20470,386,20470,20470,20864,20313,551,20313
5009,284,284,519,-235,284,284,284,331,-47,284
5010,15846,15924,15561,363,15561,15561,15928,15224,704,15224
5011,438370,417248,408507,8741,408507,408507,417204,405800,11404,405800
5012,398,398,640,-242,398,398,398,448,-50,398
5013,21123,17093,15637,1456,15637,15637,17090,14809,2281,14809
5014,17778,17783,17326,457,17326,17326,17787,17156,631,17156
5015,4895,4854,4868,-14,4854,4854,4856,4558,298,4558
5016,33269,33273,33227,46,33227,33227,33287,32413,874,32413
5017,6590,6368,6424,-56,6368,6368,6368,5968,400,5968
5018,4967,4932,4994,-62,4932,4932,4932,4883,49,4883
5019,4664,4231,4492,-261,4231,4231,4232,4231,1,4231
5020,7789,7246,7650,-404,7246,7246,7251,7167,84,7167
5021,3385,3256,3371,-115,3256,3256,3257,3236,21,3236
5022,375601,363776,349324,14452,349324,349324,364012,343117,20895,343117
5023,8563,8373,8734,-361,8373,8373,8370,7941,429,7941
5024,83002,84819,82689,2130,82689,82689,84839,82448,2391,82448
5025,400689,400216,377102,23114,377102,377102,400147,374332,25815,374332
5026,16067,15651,14957,694,14957,14957,15661,14837,824,14837
5027,93442,90086,86493,3593,86493,86493,90090,86345,3745,86345
5028,952,283,518,-235,283,283,283,330,-47,330
5029,17410,17361,17641,-280,17361,17361,17370,17164,206,17164
5030,3950,3954,4139,-185,3954,3950,3956,3960,-4,3950
5031,900,572,818,-246,572,572,572,618,-46,618
5032,33269,16502,16103,399,16103,16103,16507,15879,628,15879
5033,27231,27090,26914,176,26914,26914,27106,26389,717,26389
5034,80146,80137,76131,4006,76131,76131,80146,75845,4301,75845
5035,23029,19791,19152,639,19152,19152,19799,18886,913,18886
5036,116163,116118,117352,-1234,116118,116118,116163,105484,10679,105484
5037,5020,5022,5078,-56,5022,5020,5020,4968,52,4968
5038,1149,1052,1311,-259,1052,1052,1053,1106,-53,1106
5039,26884,26842,26496,346,26496,26496,26850,26044,806,26044
5040,57249,57150,56408,742,56408,56408,57154,55302,1852,55302
5041,96165,96168,95792,376,95792,95792,96164,93033,3131,93033
5042,92890,54388,52257,2131,52257,52257,54391,51568,2823,51568
5043,11866,12013,11866,147,11866,11866,12006,11709,297,11709
5044,4802,4771,4801,-30,4771,4771,4775,4693,82,4693
5045,1298,1193,1462,-269,1193,1193,1193,1252,-59,1252
5046,116251,129117,119561,9556,119561,116251,129173,116261,12912,116251
5047,2179,2141,2391,-250,2141,2141,2140,2211,-71,2179
5048,25974,25431,24383,1048,24383,24383,25432,22728,2704,22728
5049,28718,28733,27258,1475,27258,27258,28738,26767,1971,26767
5050,91535,91559,86134,5425,86134,86134,91535,85929,5606,85929
5051,10245,10244,10590,-346,10244,10244,10253,10276,-23,10245
5052,20950,17791,16766,1025,16766,16766,17788,15975,1813,15975
5053,4091,4044,4123,-79,4044,4044,4044,3986,58,3986
5054,138937,142188,141036,1152,141036,138937,142197,138929,3268,138929
5055,52545,53456,52535,921,52535,52535,53451,52024,1427,52024
5056,16982,16994,17178,-184,16994,16982,16999,16360,639,16360
5057,394963,402284,396205,6079,396205,394963,402461,394341,8120,394341
5058,3189,3015,3147,-132,3015,3015,3017,2685,332,2685
5059,2502,2501,2656,-155,2501,2501,2502,2489,13,2489
5060,21926,21904,21398,506,21398,21398,21929,21114,815,21114
5061,12633,12116,12230,-114,12116,12116,12114,12011,103,12011
5062,403,403,529,-126,403,403,403,413,-10,403
5063,47216,47792,47238,554,47238,47216,47799,46594,1205,46594
5064,28625,29673,28333,1340,28333,28333,29681,28003,1678,28003
5065,1520,1434,1688,-254,1434,1434,1435,1471,-36,1471
5066,29647,28825,27965,860,27965,27965,28830,27390,1440,27390
5067,109992,120898,109951,10947,109951,109951,120889,105311,15578,105311
5068,29516,29377,28325,1052,28325,28325,29382,28270,1112,28270
5069,267520,265030,259972,5058,259972,259972,265024,257010,8014,257010
5070,19820,18911,17979,932,17979,17979,18921,16548,2373,16548
5071,1380,1338,1556,-218,1338,1338,1339,1401,-62,1380
5072,163280,163239,159404,3835,159404,159404,163255,158488,4767,158488
5073,8108,8180,8173,7,8173,8108,8179,8060,119,8060
5074,16156,16483,15831,652,15831,15831,16484,15534,950,15534
5075,9633,9524,9417,107,9417,9417,9527,9011,516,9011
5076,29783,29765,28226,1539,28226,28226,29772,26767,3005,26767
5077,29556,31477,29666,1811,29666,29556,31499,28934,2565,28934
5078,5334,5337,5377,-40,5337,5334,5334,5148,186,5148
5079,22992,22102,22346,-244,22102,22102,22104,21830,274,21830
5080,20016,20020,19394,626,19394,19394,20021,18942,1079,18942
5081,95711,93423,92844,579,92844,92844,93393,91419,1974,91419
5082,39714,41992,40345,1647,40345,39714,42021,39092,2929,39092
5083,53927,50700,50925,-225,50700,50700,50716,49535,1181,49535
5084,26210,27600,26135,1465,26135,26135,27621,25588,2033,25588
5085,3467,3295,3405,-110,3295,3295,3295,3305,-10,3305
5086,97683,99784,97657,2127,97657,97657,99806,95099,4707,95099
5087,13030,13028,12602,426,12602,12602,13030,12485,545,12485
5088,40058,40054,39505,549,39505,39505,40066,39139,927,39139
5089,11497,11491,11604,-113,11491,11491,11503,11299,204,11299
5090,31227,32493,31233,1260,31233,31227,32515,31139,1376,31139
5091,23054,23058,22063,995,22063,22063,23054,21977,1077,21977
5092,139719,142404,139332,3072,139332,139332,142412,139097,3315,139097
5093,52032,51973,50686,1287,50686,50686,51990,50375,1615,50375
5094,23603,24484,24494,-10,24484,23603,24481,22981,1500,22981
5095,69820,70396,69890,506,69890,69820,70429,69198,1231,69198
5096,21551,21884,21827,57,21827,21551,21886,21458,428,21458
5097,101197,101170,97616,3554,97616,97616,101197,97003,4194,97003
5098,25405,26170,25139,1031,25139,25139,26185,24783,1402,24783
5099,1660,1008,1273,-265,1008,1008,1007,1038,-31,1038
5100,286494,294072,287978,6094,287978,286494,294098,285872,8226,285872
5101,4836,4777,4891,-114,4777,4777,4777,4821,-44,4821
5102,18561,18509,18002,507,18002,18002,18514,16760,1754,16760
5103,153791,157477,154973,2504,154973,153791,157474,153169,4305,153169
5104,96845,98681,95077,3604,95077,95077,98674,94490,4184,94490
5105,148110,147214,141056,6158,141056,141056,147207,140031,7176,140031
5106,18329,18332,17884,448,17884,17884,18337,17676,661,17676
5107,4016,2993,3197,-204,2993,2993,2994,3025,-31,3025
5108,7822,612,850,-238,612,612,612,498,114,498
5109,14921,13976,13260,716,13260,13260,13971,12760,1211,12760
5110,450686,474665,453017,21648,453017,450686,474408,450064,24344,450064
5111,7528,7545,7371,174,7371,7371,7546,7048,498,7048
5112,424764,392992,380370,12622,380370,380370,392994,376457,16537,376457
5113,204079,208709,204056,4653,204056,204056,208687,202466,6221,202466
5114,8224,8103,8201,-98,8103,8103,8114,8097,17,8097
5115,24597,24866,25010,-144,24866,24597,24871,23975,896,23975
5116,4734,4690,4732,-42,4690,4690,4698,4610,88,4610
5117,1610,928,1166,-238,928,928,928,988,-60,988
5118,107808,106678,101485,5193,101485,101485,106713,101328,5385,101328
5119,45473,45493,44151,1342,44151,44151,45473,44084,1389,44084
5120,24775,25016,24466,550,24466,24466,25026,24153,873,24153
5121,4593,4463,4591,-128,4463,4463,4464,4448,16,4448
5122,460768,471834,487828,-15994,471834,460768,471755,460146,11609,460146
5123,20024,19971,19470,501,19470,19470,19970,19302,668,19302
5124,42908,42897,40917,1980,40917,40917,42915,40517,2398,40517
5125,8409,7899,7868,31,7868,7868,7906,7787,119,7787
5126,9749,9310,9483,-173,9310,9310,9314,9127,187,9127
5127,45544,48242,45835,2407,45835,45544,48272,44922,3350,44922
5128,125591,129071,125477,3594,125477,125477,129136,124938,4198,124938
5129,756,682,955,-273,682,682,682,718,-36,718
5130,127813,132501,123690,8811,123690,123690,132463,123133,9330,123133
5131,65344,67409,65008,2401,65008,65008,67413,64722,2691,64722
5132,10533,10487,10629,-142,10487,10487,10490,10439,51,10439
5133,4406,4001,4199,-198,4001,4001,4001,3982,19,3982
5134,4575,4531,4689,-158,4531,4531,4534,4553,-19,4553
5135,13241,12305,11969,336,11969,11969,12309,11790,519,11790
5136,27090,27047,26489,558,26489,26489,27049,26231,818,26231
5137,8460,8456,8694,-238,8456,8456,8460,8425,35,8425
5138,4852,4865,4889,-24,4865,4852,4870,4574,296,4574
5139,9053,8498,8616,-118,8498,8498,8498,8431,67,8431
5140,26855,26762,26192,570,26192,26192,26763,25960,803,25960
5141,77462,77448,73098,4350,73098,73098,77446,72868,4578,72868
5142,35922,19498,19476,22,19476,19476,19505,17949,1556,17949
5143,152206,152038,147267,4771,147267,147267,152050,147067,4983,147067
5144,284,284,519,-235,284,284,284,331,-47,284
5145,14574,13911,14183,-272,13911,13911,13920,13952,-32,13952
5146,60465,47397,45894,1503,45894,45894,47408,45177,2231,45177
5147,68527,68426,66990,1436,66990,66990,68450,66219,2231,66219
5148,92861,91919,89733,2186,89733,89733,91946,88990,2956,88990
5149,26445,27056,26156,900,26156,26156,27077,25823,1254,25823
5150,2599215,2536830,2406773,130057,2406773,2406773,2536358,2381907,154451,2381907
5151,14004,11237,10919,318,10919,10919,11250,10842,408,10842
5152,75157,60456,59737,719,59737,59737,60433,59268,1165,59268
5153,54518,51258,48807,2451,48807,48807,51289,48646,2643,48646
5154,122735,125066,122521,2545,122521,122521,125084,122113,2971,122113
5155,27982,29598,29241,357,29241,27982,29617,27360,2257,27360
5156,1013153,1053867,1009998,43869,1009998,1009998,1054252,1002014,52238,1002014
5157,80135,80121,77365,2756,77365,77365,80130,74672,5458,74672
5158,2799,2628,2887,-259,2628,2628,2627,2664,-37,2664
5159,28167,27234,27150,84,27150,27150,27235,26892,343,26892
5160,31581,32050,31359,691,31359,31359,32048,30959,1089,30959
5161,64702,67804,64684,3120,64684,64684,67792,64469,3323,64469
5162,10009,9857,10003,-146,9857,9857,9860,9647,213,9647
5163,14307,14301,14302,-1,14301,14301,14307,14031,276,14031
5164,87965,70202,67155,3047,67155,67155,70215,66432,3783,66432
5165,199486,198954,194481,4473,194481,194481,198935,193532,5403,193532
5166,20945,18741,17966,775,17966,17966,18744,17840,904,17840
5167,284,284,519,-235,284,284,284,331,-47,284
5168,16120,16567,16119,448,16119,16119,16563,16038,525,16038
5169,80863,82266,80850,1416,80850,80850,82275,80501,1774,80501
5170,11310,11007,11067,-60,11007,11007,11011,10688,323,10688
5171,6008,5596,5609,-13,5596,5596,5598,5477,121,5477
5172,165329,174321,165303,9018,165303,165303,174274,164986,9288,164986
5173,3621,3489,3673,-184,3489,3489,3489,2999,490,2999
5174,16229,16515,16675,-160,16515,16229,16519,15607,912,15607
5175,4824,4832,4788,44,4788,4788,4828,4456,372,4456
5176,47763,47762,46796,966,46796,46796,47755,46149,1606,46149
5177,11179,8020,8115,-95,8020,8020,8023,7932,91,7932
5178,127346,108937,109218,-281,108937,108937,108888,107643,1245,107643
5179,37605,37547,37526,21,37526,37526,37555,36249,1306,36249
5180,11382,11391,11323,68,11323,11323,11392,11118,274,11118
5181,90165,91501,90161,1340,90161,90161,91554,89543,2011,89543
5182,6878,6405,6576,-171,6405,6405,6408,6256,152,6256
5183,308631,308619,299301,9318,299301,299301,308595,296681,11914,296681
5184,21971,7829,7441,388,7441,7441,7833,6734,1099,6734
5185,1006712,1005831,961532,44299,961532,961532,1005809,956379,49430,956379
5186,2902,2865,3085,-220,2865,2865,2866,2897,-31,2897
5187,100643,106493,101365,5128,101365,100643,106484,100021,6463,100021
5188,20762,20545,20517,28,20517,20517,20549,20140,409,20140
5189,499,342,467,-125,342,342,341,352,-11,352
5190,26884,26847,26003,844,26003,26003,26857,25623,1234,25623
5191,19329,19303,19329,-26,19303,19303,19307,18978,329,18978
5192,2707,2346,2523,-177,2346,2346,2346,2359,-13,2359
5193,21506,21396,20403,993,20403,20403,21415,19431,1984,19431
5194,5424,5049,5053,-4,5049,5049,5054,4933,121,4933
5195,5390,4887,4852,35,4852,4852,4887,4585,302,4585
5196,925,670,925,-255,670,670,669,723,-54,723
5197,72666,74642,72128,2514,72128,72128,74649,71455,3194,71455
5198,151721,151646,153808,-2162,151646,151646,151678,151099,579,151099
5199,97569,97506,93644,3862,93644,93644,97511,93094,4417,93094
5200,138550,138467,129756,8711,129756,129756,138422,128094,10328,128094
5201,18644,18658,18199,459,18199,18199,18644,18001,643,18001
5202,29986,30001,28501,1500,28501,28501,29986,27531,2455,27531
5203,53565,53559,50571,2988,50571,50571,53565,49861,3704,49861
5204,89359,89673,86072,3601,86072,86072,89636,85773,3863,85773
5205,53340,53631,53158,473,53158,53158,53655,52718,937,52718
5206,4104,3984,4112,-128,3984,3984,3982,3985,-3,3985
5207,1427,1390,1622,-232,1390,1390,1390,1459,-69,1427
5208,4971,4091,4244,-153,4091,4091,4093,3746,347,3746
5209,34587,33739,33501,238,33501,33501,33754,33134,620,33134
5210,4994,4787,4992,-205,4787,4787,4792,4792,0,4792
5211,17885,17848,17974,-126,17848,17848,17857,17692,165,17692
5212,10095,10051,10134,-83,10051,10051,10054,9958,96,9958
5213,2345,1634,1782,-148,1634,1634,1635,1480,155,1480
5214,14385,14283,14374,-91,14283,14283,14290,14121,169,14121
5215,6244,5888,5860,28,5860,5860,5886,5741,145,5741
5216,162094,161940,162059,-119,161940,161940,162021,157309,4712,157309
5217,54410,54606,54402,204,54402,54402,54613,53009,1604,53009
5218,3728,3729,3836,-107,3729,3728,3728,3705,23,3705
5219,107213,107047,104403,2644,104403,104403,107105,103243,3862,103243
5220,46802,47524,46400,1124,46400,46400,47490,46180,1310,46180
5221,43045,43045,40293,2752,40293,40293,43045,38741,4304,38741
5222,23621,23589,23442,147,23442,23442,23583,23129,454,23129
5223,83786,82178,77132,5046,77132,77132,82220,76835,5385,76835
5224,23077,23685,23073,612,23073,23073,23693,22958,735,22958
5225,31019,18019,17698,321,17698,17698,18018,17466,552,17466
5226,16900,17268,16901,367,16901,16900,17262,16761,501,16761
5227,2776,2332,2541,-209,2332,2332,2334,2307,27,2307
5228,22034,17620,17323,297,17323,17323,17629,16963,666,16963
5229,5696,5587,5953,-366,5587,5587,5586,5628,-42,5628
5230,22767,23722,23189,533,23189,22767,23727,22145,1582,22145
5231,18607,18604,18456,148,18456,18456,18607,18007,600,18007
5232,20597,20105,20895,-790,20105,20105,20121,19975,146,19975
5233,84902,84319,83187,1132,83187,83187,84334,81083,3251,81083
5234,407649,439234,414350,24884,414350,407649,439228,407027,32201,407027
5235,11353,11346,11092,254,11092,11092,11353,10757,596,10757
5236,121367,111026,105538,5488,105538,105538,111055,104533,6522,104533
5237,5882,5112,5239,-127,5112,5112,5113,5100,13,5100
5238,59943,59341,56187,3154,56187,56187,59377,55998,3379,55998
5239,10196,9768,9767,1,9767,9767,9766,9597,169,9597
5240,4494,3870,4085,-215,3870,3870,3870,3872,-2,3872
5241,69346,70642,70196,446,70196,69346,70665,69834,831,69346
5242,15153,15125,14719,406,14719,14719,15128,14464,664,14464
5243,1831,1829,2027,-198,1829,1829,1831,1810,21,1810
5244,55241,55644,56197,-553,55644,55241,55631,55150,481,55150
5245,60643,62309,60622,1687,60622,60622,62323,60507,1816,60507
5246,11980,11989,11796,193,11796,11796,11991,11602,389,11602
5247,4372,3609,3792,-183,3609,3609,3609,3650,-41,3650
5248,33085,33939,33083,856,33083,33083,33950,32463,1487,32463
5249,5701,5646,5701,-55,5646,5646,5647,5525,122,5525
5250,7933,7934,7815,119,7815,7815,7933,7745,188,7745
5251,5761,5351,5588,-237,5351,5351,5352,5139,213,5139
5252,6302,6264,6210,54,6210,6210,6263,6099,164,6099
5253,4810,4427,4598,-171,4427,4427,4423,4420,3,4420
5254,25888,25871,25751,120,25751,25751,25888,25646,242,25646
5255,4824,4832,4788,44,4788,4788,4828,4456,372,4456
5256,97008,98711,97263,1448,97263,97008,98768,96386,2382,96386
5257,4573,4206,4422,-216,4206,4206,4203,4228,-25,4228
5258,8018,8008,8330,-322,8008,8008,8008,7396,612,7396
5259,227893,222822,217771,5051,217771,217771,223019,211338,11681,211338
5260,43009,44576,42977,1599,42977,42977,44583,42387,2196,42387
5261,105167,108280,105804,2476,105804,105167,108264,104545,3719,104545
5262,66058,66051,62516,3535,62516,62516,66056,61800,4256,61800
5263,3640,3238,3471,-233,3238,3238,3238,3267,-29,3267
5264,15323,14728,14677,51,14677,14677,14723,14478,245,14478
5265,30473,32599,31690,909,31690,30473,32606,29851,2755,29851
5266,59858,56753,54174,2579,54174,54174,56752,52120,4632,52120
5267,104627,106315,104563,1752,104563,104563,106309,104005,2304,104005
5268,18596,18821,18645,176,18645,18596,18819,17974,845,17974
5269,17910,17390,17324,66,17324,17324,17388,17288,100,17288
5270,102023,102011,95117,6894,95117,95117,101983,92875,9108,92875
5271,79565,82558,79554,3004,79554,79554,82584,79474,3110,79474
5272,8134,8363,8377,-14,8363,8134,8374,7512,862,7512
5273,168350,175476,168317,7159,168317,168317,175399,167148,8251,167148
5274,61719,61738,61694,44,61694,61694,61737,60966,771,60966
5275,27124,26827,26744,83,26744,26744,26833,26502,331,26502
5276,12485,12480,12484,-4,12480,12480,12485,12265,220,12265
5277,741369,761220,740967,20253,740967,740967,761190,729841,31349,729841
5278,4456,4832,4788,44,4788,4456,4828,4456,372,4456
5279,20733,15850,14764,1086,14764,14764,15856,14203,1653,14203
5280,3420,3205,3360,-155,3205,3205,3206,3096,110,3096
5281,82011,81993,79482,2511,79482,79482,81983,78844,3139,78844
5282,7206,6648,6731,-83,6648,6648,6644,6584,60,6584
5283,3126,2451,2646,-195,2451,2451,2451,2504,-53,2504
5284,3324,3402,3325,77,3325,3324,3402,2985,417,2985
5285,9599,8637,8950,-313,8637,8637,8634,8641,-7,8641
5286,5433,5059,5256,-197,5059,5059,5060,5057,3,5057
5287,36852,38686,37340,1346,37340,36852,38714,36230,2484,36230
5288,46247,46193,44632,1561,44632,44632,46195,44282,1913,44282
5289,21391,21837,21388,449,21388,21388,21836,21265,571,21265
5290,7733,7521,7733,-212,7521,7521,7520,6103,1417,6103
5291,78473,78493,77505,988,77505,77505,78473,76806,1667,76806
5292,49514,49497,48415,1082,48415,48415,49522,47566,1956,47566
5293,8651,7701,7665,36,7665,7665,7701,7548,153,7548
5294,163525,172531,165265,7266,165265,163525,172577,162903,9674,162903
5295,107373,110560,107386,3174,107386,107373,110545,105901,4644,105901
5296,26688,27510,26676,834,26676,26676,27521,26066,1455,26066
5297,13295,13470,13119,351,13119,13119,13466,13066,400,13066
5298,119892,125887,119841,6046,119841,119841,125992,116578,9414,116578
5299,30770,29421,29758,-337,29421,29421,29427,29220,207,29220
5300,5896,5328,5288,40,5288,5288,5330,4983,347,4983
5301,104261,106434,104620,1814,104620,104261,106477,103639,2838,103639
5302,15769,15924,16036,-112,15924,15769,15930,15769,161,15769
5303,11090,11047,10871,176,10871,10871,11047,10743,304,10743
5304,1784,1103,1371,-268,1103,1103,1103,1162,-59,1162
5305,124013,123923,121637,2286,121637,121637,123967,119433,4534,119433
5306,953,285,518,-233,285,285,285,331,-46,331
5307,6854,6810,7083,-273,6810,6810,6813,6232,581,6232
5308,74871,76965,74860,2105,74860,74860,76975,74249,2726,74249
5309,12518,12541,12495,46,12495,12495,12545,11896,649,11896
5310,1170,384,628,-244,384,384,384,433,-49,433
5311,2770,2732,2923,-191,2732,2732,2732,2774,-42,2770
5312,29144,30323,29134,1189,29134,29134,30328,29038,1290,29038
5313,4824,4832,4788,44,4788,4788,4828,4456,372,4456
5314,10290,10754,10176,578,10176,10176,10754,9668,1086,9668
5315,325802,333827,323672,10155,323672,323672,333933,322025,11908,322025
5316,325802,333827,323672,10155,323672,323672,333933,322025,11908,322025
5317,136790,126487,122659,3828,122659,122659,126539,120882,5657,120882
5318,139269,142979,138710,4269,138710,138710,142981,138338,4643,138338
5319,140209,148569,140193,8376,140193,140193,148596,140098,8498,140098
5320,36475,36505,36459,46,36459,36459,36518,36049,469,36049
5321,12070,1743,1983,-240,1743,1743,1744,1798,-54,1798
5322,2206,2032,2206,-174,2032,2032,2033,2054,-21,2054
5323,27098,9607,9727,-120,9607,9607,9611,9416,195,9416
5324,118652,111895,109495,2400,109495,109495,111931,108219,3712,108219
5325,363176,352542,342769,9773,342769,342769,352475,337603,14872,337603
5326,73779,76866,73871,2995,73871,73779,76916,73157,3759,73157
5327,3649,3649,3786,-137,3649,3649,3653,3652,1,3649
5328,254591,254371,247696,6675,247696,247696,254419,247149,7270,247149
5329,17158,17342,17153,189,17153,17153,17344,16975,369,16975
5330,48539,48479,47097,1382,47097,47097,48498,46627,1871,46627
5331,33722,32883,33622,-739,32883,32883,32904,33100,-196,33100
5332,13593,12868,12643,225,12643,12643,12869,12428,441,12428
5333,13218,13395,13157,238,13157,13157,13399,13058,341,13058
5334,39969,39962,38368,1594,38368,38368,39969,38249,1720,38249
5335,69821,69825,65581,4244,65581,65581,69839,64295,5544,64295
5336,33336,32778,31533,1245,31533,31533,32794,31443,1351,31443
5337,187636,187625,183602,4023,183602,183602,187589,182116,5473,182116
5338,3656,3615,3732,-117,3615,3615,3615,3574,41,3574
5339,59928,59374,59826,-452,59374,59374,59401,59306,95,59306
5340,11284,11274,11749,-475,11274,11274,11285,11072,213,11072
5341,71588,72378,71532,846,71532,71532,72394,70966,1428,70966
5342,41335,40689,39288,1401,39288,39288,40686,39132,1554,39132
5343,386276,360846,343533,17313,343533,343533,360661,341356,19305,341356
5344,1723,1066,1298,-232,1066,1066,1064,1101,-37,1101
5345,4482,4489,4600,-111,4489,4482,4489,4451,38,4451
5346,100888,92132,93909,-1777,92132,92132,92148,88785,3363,88785
5347,64933,65983,64918,1065,64918,64918,66003,64286,1717,64286
5348,1138,751,1024,-273,751,751,751,811,-60,811
5349,10183,7023,6935,88,6935,6935,7021,6797,224,6797
5350,27108,28212,27674,538,27674,27108,28217,26486,1731,26486
5351,990804,934756,895975,38781,895975,895975,934833,892054,42779,892054
5352,8617,8620,9087,-467,8620,8617,8622,8289,333,8289
5353,11129,10696,10354,342,10354,10354,10711,10270,441,10270
5354,19199,19716,19191,525,19191,19191,19715,19096,619,19096
5355,19843,20782,19839,943,19839,19839,20786,18758,2028,18758
5356,43405,47650,44226,3424,44226,43405,47659,42783,4876,42783
5357,93838,90697,88411,2286,88411,88411,90716,87696,3020,87696
5358,2371,1687,1943,-256,1687,1687,1686,1749,-63,1749
5359,10398,10274,10233,41,10233,10233,10274,9895,379,9895
5360,17017,18096,18063,33,18063,17017,18092,16395,1697,16395
5361,954,285,519,-234,285,285,285,332,-47,332
5362,17265,17260,16932,328,16932,16932,17265,16809,456,16809
5363,15624,15614,15472,142,15472,15472,15624,15292,332,15292
5364,37545,36989,37125,-136,36989,36989,37003,36593,410,36593
5365,1297,1297,1447,-150,1297,1297,1297,1308,-11,1297
5366,9459,9054,8972,82,8972,8972,9052,8837,215,8837
5367,199309,191795,181587,10208,181587,181587,191762,180435,11327,180435
5368,22437,21634,20482,1152,20482,20482,21644,20276,1368,20276
5369,37545,36989,37125,-136,36989,36989,37003,36593,410,36593
5370,84432,84423,82649,1774,82649,82649,84392,81122,3270,81122
5371,2491,1558,1765,-207,1558,1558,1558,1620,-62,1620
5372,18794,18607,18342,265,18342,18342,18631,18172,459,18172
5373,8617,8399,8368,31,8368,8368,8401,7995,406,7995
5374,98723,98738,96043,2695,96043,96043,98741,95544,3197,95544
5375,25191,24265,22196,2069,22196,22196,24260,19080,5180,19080
5376,46526,45430,44638,792,44638,44638,45440,44671,769,44671
5377,62682,41196,39617,1579,39617,39617,41191,39467,1724,39467
5378,30021,30465,30013,452,30013,30013,30475,29235,1240,29235
5379,16289,16655,16288,367,16288,16288,16648,16153,495,16153
5380,99856,96732,94456,2276,94456,94456,96709,93253,3456,93253
5381,24791,19063,19512,-449,19063,19063,19068,18015,1053,18015
5382,7434,6952,7339,-387,6952,6952,6954,6812,142,6812
5383,14761,14722,14645,77,14645,14645,14721,14461,260,14461
5384,14515,14021,14124,-103,14021,14021,14021,13870,151,13870
5385,80465,82425,80701,1724,80701,80465,82400,79843,2557,79843
5386,954,285,519,-234,285,285,285,332,-47,332
5387,50549,51335,50269,1066,50269,50269,51347,49927,1420,49927
5388,444458,415157,413217,1940,413217,413217,415272,407497,7775,407497
5389,357179,356916,351031,5885,351031,351031,357118,345123,11995,345123
5390,54000,42562,40603,1959,40603,40603,42571,40419,2152,40419
5391,31065,31901,31557,344,31557,31065,31903,30443,1460,30443
5392,254184,264805,255819,8986,255819,254184,264755,253562,11193,253562
5393,986751,809944,806473,3471,806473,806473,810056,766695,43361,766695
5394,15264,15631,15679,-48,15631,15264,15629,15264,365,15264
5395,290363,307499,286883,20616,286883,286883,307372,285038,22334,285038
5396,1447,1238,1448,-210,1238,1238,1238,1289,-51,1289
5397,69013,70675,70039,636,70039,69013,70672,69023,1649,69013
5398,3624,2935,3127,-192,2935,2935,2935,3002,-67,3002
5399,33801,30889,29808,1081,29808,29808,30894,29578,1316,29578
5400,12893,12337,12586,-249,12337,12337,12341,12271,70,12271
5401,3750,3429,3726,-297,3429,3429,3430,3492,-62,3492
5402,1914,1363,1560,-197,1363,1363,1360,1414,-54,1414
5403,952,283,517,-234,283,283,283,330,-47,330
5404,9421,8486,8155,331,8155,8155,8486,7997,489,7997
5405,38222,39183,38485,698,38485,38222,39178,38214,964,38214
5406,38730,45809,45800,9,45800,38730,45796,38108,7688,38108
5407,10344,10115,10440,-325,10115,10115,10119,9722,397,9722
5408,45583,44126,42419,1707,42419,42419,44133,42354,1779,42354
5409,12880,12882,12863,19,12863,12863,12880,12606,274,12606
5410,11465,10751,10714,37,10714,10714,10751,10486,265,10486
5411,10448,10445,10472,-27,10445,10445,10448,10219,229,10219
5412,16716,16993,16629,364,16629,16629,16988,16094,894,16094
5413,31280,30341,29864,477,29864,29864,30339,29693,646,29693
5414,181862,185614,181779,3835,181779,181779,185606,181240,4366,181240
5415,2233,1547,1796,-249,1547,1547,1547,1611,-64,1611
5416,6579,6558,6573,-15,6558,6558,6558,6425,133,6425
5417,357645,370879,362215,8664,362215,357645,370865,357023,13842,357023
5418,14863,14343,14538,-195,14343,14343,14343,14241,102,14241
5419,82133,83077,82712,365,82712,82133,83117,82392,725,82133
5420,25849,25567,25343,224,25343,25343,25565,25227,338,25227
5421,952,284,519,-235,284,284,284,330,-46,330
5422,2111,1217,1419,-202,1217,1217,1216,1269,-53,1269
5423,19282,19630,20031,-401,19630,19282,19637,18660,977,18660
5424,49241,50114,48928,1186,48928,48928,50130,48619,1511,48619
5425,3210,2520,2788,-268,2520,2520,2518,2588,-70,2588
5426,9995,9517,9376,141,9376,9376,9512,9250,262,9250
5427,47498,48316,47198,1118,47198,47198,48330,46876,1454,46876
5428,13842,13876,13776,100,13776,13776,13882,13668,214,13668
5429,2338,2111,2277,-166,2111,2111,2109,2130,-21,2130
5430,6756,6401,6460,-59,6401,6401,6404,6134,270,6134
5431,112232,113689,112188,1501,112188,112188,113728,111456,2272,111456
5432,92804,64311,61003,3308,61003,61003,64292,59874,4418,59874
5433,9068,1903,2123,-220,1903,1903,1903,1945,-42,1945
5434,39453,40562,39449,1113,39449,39449,40558,39166,1392,39166
5435,120804,117628,114592,3036,114592,114592,117679,113453,4226,113453
5436,16954,18221,18081,140,18081,16954,18228,16332,1896,16332
5437,22051,21632,21842,-210,21632,21632,21646,21429,217,21429
5438,9674,10538,10582,-44,10538,9674,10534,9052,1482,9052
5439,192472,200976,194452,6524,194452,192472,201013,193219,7794,192472
5440,9260,8842,8847,-5,8842,8842,8845,8697,148,8697
5441,359493,350873,330915,19958,330915,330915,350872,329022,21850,329022
5442,56467,56411,55333,1078,55333,55333,56439,54958,1481,54958
5443,11076,10542,10096,446,10096,10096,10538,10007,531,10007
5444,65604,67130,65028,2102,65028,65028,67150,64982,2168,64982
5445,16747,16500,16398,102,16398,16398,16503,16125,378,16125
5446,1706,1304,1520,-216,1304,1304,1305,1346,-41,1346
5447,36383,38126,36854,1272,36854,36383,38149,35761,2388,35761
5448,84652,87688,84340,3348,84340,84340,87686,84030,3656,84030
5449,55748,55193,53752,1441,53752,53752,55194,53143,2051,53143
5450,67521,72814,69185,3629,69185,67521,72794,66899,5895,66899
5451,3058,2380,2703,-323,2380,2380,2382,2436,-54,2436
5452,202639,210516,203603,6913,203603,202639,210506,202017,8489,202017
5453,10378,10375,10270,105,10270,10270,10378,10031,347,10031
5454,2996,2337,2537,-200,2337,2337,2339,2374,-35,2374
5455,6936,6741,6936,-195,6741,6741,6741,6605,136,6605
5456,14626,14169,14046,123,14046,14046,14165,13896,269,13896
5457,37419,36107,34551,1556,34551,34551,36130,34491,1639,34491
5458,100827,109192,102344,6848,102344,100827,109202,100205,8997,100205
5459,9067,9235,9070,165,9070,9067,9232,8925,307,8925
5460,133871,136652,133472,3180,133472,133472,136634,133249,3385,133249
5461,11749,11757,11704,53,11704,11704,11759,11640,119,11640
5462,72262,75785,72673,3112,72673,72262,75771,71640,4131,71640
5463,1883,953,1182,-229,953,953,952,995,-43,995
5464,24490,24978,24131,847,24131,24131,24986,23868,1118,23868
5465,18486,17570,16998,572,16998,16998,17568,15931,1637,15931
5466,27981,27661,27792,-131,27661,27661,27670,27359,311,27359
5467,3137,2513,2712,-199,2513,2513,2513,2515,-2,2515
5468,56109,56386,55298,1088,55298,55298,56401,54935,1466,54935
5469,25575,26559,25426,1133,25426,25426,26562,24953,1609,24953
5470,10498,11212,10627,585,10627,10498,11211,9876,1335,9876
5471,15236,15333,15241,92,15241,15236,15335,14952,383,14952
5472,3334,3024,3274,-250,3024,3024,3022,2797,225,2797
5473,11181,11186,11108,78,11108,11108,11181,10929,252,10929
5474,43803,41358,41197,161,41197,41197,41350,40783,567,40783
5475,15582,15078,15016,62,15016,15016,15081,14781,300,14781
5476,98392,101855,98475,3380,98475,98392,101832,97770,4062,97770
5477,11446,11460,11590,-130,11460,11446,11464,11301,163,11301
5478,42083,41259,40496,763,40496,40496,41253,40258,995,40258
5479,19300,19421,19979,-558,19421,19300,19419,18678,741,18678
5480,11917,11366,11320,46,11320,11320,11369,11164,205,11164
5481,363,363,591,-228,363,363,363,407,-44,363
5482,4535,4158,4279,-121,4158,4158,4158,4135,23,4135
5483,7883,7432,7481,-49,7432,7432,7433,7305,128,7305
5484,952,283,517,-234,283,283,283,330,-47,330
5485,19969,20129,20389,-260,20129,19969,20120,19951,169,19951
5486,28017,29223,28531,692,28531,28017,29234,27395,1839,27395
5487,953,284,519,-235,284,284,284,331,-47,331
5488,45861,46122,45399,723,45399,45399,46118,45239,879,45239
5489,19526,19371,18934,437,18934,18934,19367,18904,463,18904
5490,39716,48288,45215,3073,45215,39716,48281,39094,9187,39094
5491,102133,102053,98904,3149,98904,98904,102073,97819,4254,97819
5492,21574,21845,21566,279,21566,21566,21845,21413,432,21413
5493,13269,12858,12270,588,12270,12270,12872,12146,726,12146
5494,1294,939,1159,-220,939,939,939,956,-17,956
5495,1161,491,732,-241,491,491,491,539,-48,539
5496,34611,36362,34423,1939,34423,34423,36362,33989,2373,33989
5497,13541,13540,13476,64,13476,13476,13541,13236,305,13236
5498,231017,216653,209233,7420,209233,209233,216707,207936,8771,207936
5499,31228,31239,29557,1682,29557,29557,31228,29331,1897,29331
5500,953,284,518,-234,284,284,284,331,-47,331
5501,9714,9055,9132,-77,9055,9055,9055,8901,154,8901
5502,12046,11642,11495,147,11495,11495,11639,11424,215,11424
5503,6644,6133,6343,-210,6133,6133,6132,6149,-17,6149
5504,14606,14378,14408,-30,14378,14378,14373,13984,389,13984
5505,128856,127685,122106,5579,122106,122106,127688,121509,6179,121509
5506,9855,9967,9939,28,9939,9855,9970,9233,737,9233
5507,338886,346982,342080,4902,342080,338886,347064,338264,8800,338264
5508,63751,62412,60916,1496,60916,60916,62463,60448,2015,60448
5509,8760,7869,7978,-109,7869,7869,7863,7573,290,7573
5510,3291,2694,2909,-215,2694,2694,2690,2669,21,2669
5511,42066,42057,40657,1400,40657,40657,42061,40197,1864,40197
5512,26241,28201,26842,1359,26842,26241,28210,25619,2591,25619
5513,29139,29129,27994,1135,27994,27994,29139,27631,1508,27631
5514,3833,3339,3684,-345,3339,3339,3341,3414,-73,3414
5515,27847,26315,25945,370,25945,25945,26314,25578,736,25578
5516,108187,89341,85967,3374,85967,85967,89365,85577,3788,85577
5517,42146,44730,42906,1824,42906,42146,44743,41524,3219,41524
5518,31269,31395,30740,655,30740,30740,31386,30647,739,30647
5519,58346,59935,59928,7,59928,58346,59920,57724,2196,57724
5520,48806,50045,48321,1724,48321,48321,50031,48184,1847,48184
5521,20154,20123,19541,582,19541,19541,20137,19532,605,19532
5522,21672,22817,21595,1222,21595,21595,22836,21050,1786,21050
5523,8138,7863,7949,-86,7863,7863,7863,7516,347,7516
5524,103210,109619,103641,5978,103641,103210,109611,102588,7023,102588
5525,47158,47761,46737,1024,46737,46737,47795,46536,1259,46536
5526,2090,1672,1890,-218,1672,1672,1670,1728,-58,1728
5527,12443,11803,12222,-419,11803,11803,11816,11821,-5,11821
5528,10350,9818,9934,-116,9818,9818,9823,9728,95,9728
5529,8504,8769,8945,-176,8769,8504,8768,7882,886,7882
5530,955,285,519,-234,285,285,285,333,-48,333
5531,5043,5148,5205,-57,5148,5043,5147,5043,104,5043
5532,252933,281056,262743,18313,262743,252933,281102,252311,28791,252311
5533,3085,2709,2876,-167,2709,2709,2706,2717,-11,2717
5534,40439,40430,38603,1827,38603,38603,40429,38093,2336,38093
5535,99058,104246,99036,5210,99036,99036,104298,98594,5704,98594
5536,2527,2078,2271,-193,2078,2078,2080,2051,29,2051
5537,16466,16647,16960,-313,16647,16466,16650,16466,184,16466
5538,108788,115901,109131,6770,109131,108788,115894,108166,7728,108166
5539,85883,90685,86437,4248,86437,85883,90715,85261,5454,85261
5540,2664,2043,2288,-245,2043,2043,2045,2042,3,2042
5541,19640,19642,19294,348,19294,19294,19640,19109,531,19109
5542,2214,1759,1855,-96,1759,1759,1759,1659,100,1659
5543,29282,27721,26045,1676,26045,26045,27700,25904,1796,25904
5544,35051,36035,34805,1230,34805,34805,36038,34429,1609,34429
5545,4194,3639,3777,-138,3639,3639,3641,3572,69,3572
5546,131654,137486,132174,5312,132174,131654,137523,131032,6491,131032
5547,9793,10125,9734,391,9734,9734,10133,9171,962,9171
5548,8858,8512,8767,-255,8512,8512,8516,8236,280,8236
5549,17929,19816,18222,1594,18222,17929,19828,17307,2521,17307
5550,13991,14137,13985,152,13985,13985,14144,13858,286,13858
5551,111272,111189,107124,4065,107124,107124,111226,106432,4794,106432
5552,105054,102543,102110,433,102110,102110,102588,101071,1517,101071
5553,52845,55250,52909,2341,52909,52845,55249,52223,3026,52223
5554,2575,1961,2205,-244,1961,1961,1963,1953,10,1953
5555,6740,6691,6736,-45,6691,6691,6691,6581,110,6581
5556,137425,144069,136969,7100,136969,136969,144123,136803,7320,136803
5557,155720,123016,119137,3879,119137,119137,122956,118185,4771,118185
5558,9116,8661,8522,139,8522,8522,8661,8494,167,8494
5559,11816,12592,12357,235,12357,11816,12590,11194,1396,11194
5560,92725,88754,83545,5209,83545,83545,88736,83118,5618,83118
5561,7142,7143,7126,17,7126,7126,7142,7019,123,7019
5562,22604,22658,22045,613,22045,22045,22651,21982,669,21982
5563,19147,19144,18584,560,18584,18584,19147,18405,742,18405
5564,25650,25807,25123,684,25123,25123,25803,25028,775,25028
5565,18425,3184,3313,-129,3184,3184,3182,3134,48,3134
5566,7228,6845,7055,-210,6845,6845,6843,6606,237,6606
5567,71132,72831,71121,1710,71121,71121,72847,70492,2355,70492
5568,8666,8277,8351,-74,8277,8277,8274,8164,110,8164
5569,86266,90647,87887,2760,87887,86266,90646,85644,5002,85644
5570,7660,6979,7149,-170,6979,6979,6979,7038,-59,7038
5571,5021,5003,5090,-87,5003,5003,5002,5003,-1,5003
5572,147164,150855,147105,3750,147105,147105,150897,143820,7077,143820
5573,37010,16881,16432,449,16432,16432,16884,16269,615,16269
5574,90347,95930,93374,2556,93374,90347,95960,89725,6235,89725
5575,19265,19599,19289,310,19289,19265,19600,19080,520,19080
5576,11650,11339,11834,-495,11339,11339,11342,11028,314,11028
5577,32749,32576,32161,415,32161,32161,32596,32127,469,32127
5578,3052,3948,4116,-168,3948,3052,3949,3048,901,3048
5579,1925,1334,1551,-217,1334,1334,1334,1303,31,1303
5580,38472,38821,38001,820,38001,38001,38824,37850,974,37850
5581,953,284,519,-235,284,284,284,331,-47,331
5582,2537,1869,2101,-232,1869,1869,1869,1915,-46,1915
5583,48306,48730,47883,847,47883,47883,48757,47684,1073,47684
5584,20750,21897,21444,453,21444,20750,21913,20128,1785,20128
5585,6292,6405,6375,30,6375,6292,6408,5670,738,5670
5586,112741,102194,96993,5201,96993,96993,102243,96634,5609,96634
5587,2628,1975,2244,-269,1975,1975,1973,2006,-33,2006
5588,14713,15615,15539,76,15539,14713,15625,14091,1534,14091
5589,954,285,521,-236,285,285,285,332,-47,332
5590,3717,3717,3843,-126,3717,3717,3717,3721,-4,3717
5591,21249,21030,20696,334,20696,20696,21035,20627,408,20627
5592,23781,24300,24138,162,24138,23781,24309,23159,1150,23159
5593,65130,66530,64726,1804,64726,64726,66542,64508,2034,64508
5594,78016,49462,47352,2110,47352,47352,49483,47315,2168,47315
5595,2016,1326,1596,-270,1326,1326,1327,1394,-67,1394
5596,16447,18998,20321,-1323,18998,16447,18998,15825,3173,15825
5597,18292,18017,17809,208,17809,17809,18010,17670,340,17670
5598,1362,689,933,-244,689,689,688,740,-52,740
5599,12179,11680,11449,231,11449,11449,11677,11294,383,11294
5600,7719,7921,7737,184,7737,7719,7919,7564,355,7564
5601,2555,1865,2119,-254,1865,1865,1865,1933,-68,1933
5602,20366,19762,20152,-390,19762,19762,19769,19744,25,19744
5603,14796,14787,14632,155,14632,14632,14796,14448,348,14448
5604,11150,11091,10849,242,10849,10849,11097,10528,569,10528
5605,106845,113388,112318,1070,112318,106845,113490,106223,7267,106223
5606,12038,12050,12095,-45,12050,12038,12049,11870,179,11870
5607,4519,4435,4669,-234,4435,4435,4437,4511,-74,4511
5608,953,284,518,-234,284,284,284,331,-47,331
5609,108668,114078,108666,5412,108666,108666,114059,108536,5523,108536
5610,123395,126717,123601,3116,123601,123395,126728,122773,3955,122773
5611,51558,56843,52890,3953,52890,51558,56852,50936,5916,50936
5612,9547,10059,9768,291,9768,9547,10059,8925,1134,8925
5613,68054,67079,66126,953,66126,66126,67086,65578,1508,65578
5614,1415,1202,1445,-243,1202,1202,1202,793,409,793
5615,6611,6535,6612,-77,6535,6535,6538,6465,73,6465
5616,43697,49156,47530,1626,47530,43697,49212,43075,6137,43075
5617,63227,64429,62862,1567,62862,62862,64442,62605,1837,62605
5618,25120,25494,24646,848,24646,24646,25490,24498,992,24498
5619,19288,19787,19431,356,19431,19288,19795,19270,525,19270
5620,59559,52925,51828,1097,51828,51828,52956,51086,1870,51086
5621,20868,20890,20342,548,20342,20342,20886,20128,758,20128
5622,163950,158360,156267,2093,156267,156267,158368,154458,3910,154458
5623,954,285,519,-234,285,285,285,332,-47,332
5624,35571,36465,35214,1251,35214,35214,36468,34949,1519,34949
5625,97090,111668,105981,5687,105981,97090,111652,96468,15184,96468
5626,26654,28623,27030,1593,27030,26654,28635,26032,2603,26032
5627,953,285,519,-234,285,285,285,331,-46,331
5628,846,453,684,-231,453,453,453,496,-43,496
5629,7511,8900,8764,136,8764,7511,8902,6889,2013,6889
5630,3261,2792,2926,-134,2792,2792,2793,2777,16,2777
5631,62684,65593,62563,3030,62563,62563,65607,62062,3545,62062
5632,32532,32360,31459,901,31459,31459,32360,31387,973,31387
5633,209811,215083,209634,5449,209634,209634,215126,209189,5937,209189
5634,1655,1001,1274,-273,1001,1001,1002,1033,-31,1033
5635,23909,23941,23358,583,23358,23358,23937,23287,650,23287
5636,29063,28605,28048,557,28048,28048,28604,27821,783,27821
5637,5787,5149,5247,-98,5149,5149,5153,5165,-12,5165
5638,33078,14716,14772,-56,14716,14716,14715,14605,110,14605
5639,41469,41707,41033,674,41033,41033,41753,40847,906,40847
5640,4725,4764,4966,-202,4764,4725,4762,4707,55,4707
5641,6340,6270,6357,-87,6270,6270,6272,6090,182,6090
5642,626,626,868,-242,626,626,626,676,-50,626
5643,996629,953602,906544,47058,906544,906544,953624,901315,52309,901315
5644,137921,136937,134271,2666,134271,134271,136921,133009,3912,133009
5645,41680,43827,42874,953,42874,41680,43836,41058,2778,41058
5646,13115,13112,13027,85,13027,13027,13115,12878,237,12878
5647,9564,9075,9000,75,9000,9000,9079,8942,137,8942
5648,44026,44711,44354,357,44354,44026,44731,43404,1327,43404
5649,61793,63787,61958,1829,61958,61793,63770,61171,2599,61171
5650,4741,4673,4870,-197,4673,4673,4671,4723,-52,4723
5651,134167,105134,101627,3507,101627,101627,105160,97885,7275,97885
5652,10171,9975,10150,-175,9975,9975,9979,9549,430,9549
5653,3685,3589,3683,-94,3589,3589,3590,3540,50,3540
5654,21980,22726,22263,463,22263,21980,22742,21358,1384,21358
5655,224628,229466,225931,3535,225931,224628,229537,224006,5531,224006
5656,28759,31052,29766,1286,29766,28759,31083,28137,2946,28137
5657,7117,6256,6610,-354,6256,6256,6268,6208,60,6208
5658,20923,22151,21832,319,21832,20923,22162,20923,1239,20923
5659,499,342,467,-125,342,342,341,352,-11,352
5660,26606,26852,26090,762,26090,26090,26866,25984,882,25984
5661,1408,1377,1606,-229,1377,1377,1380,1390,-10,1390
5662,42553,43674,42343,1331,42343,42343,43671,41931,1740,41931
5663,7741,8596,8376,220,8376,7741,8597,7723,874,7723
5664,41779,41786,40368,1418,40368,40368,41790,39790,2000,39790
5665,1401,1027,1267,-240,1027,1027,1026,1074,-48,1074
5666,101542,96682,89274,7408,89274,89274,96729,88650,8079,88650
5667,69657,65947,64491,1456,64491,64491,65957,63972,1985,63972
5668,17421,17140,17139,1,17139,17139,17144,16799,345,16799
5669,5792,5657,5575,82,5575,5575,5661,5170,491,5170
5670,5471,5132,5259,-127,5132,5132,5130,5079,51,5079
5671,22617,21124,19986,1138,19986,19986,21133,19863,1270,19863
5672,320319,340036,324867,15169,324867,320319,339892,322603,17289,320319
5673,30504,31370,31306,64,31306,30504,31369,29882,1487,29882
5674,63578,65504,63576,1928,63576,63576,65486,63342,2144,63342
5675,6386,5781,5851,-70,5781,5781,5779,5764,15,5764
5676,26866,27859,26802,1057,26802,26802,27857,26165,1692,26165
5677,5365,5231,5366,-135,5231,5231,5232,5210,22,5210
5678,111470,111542,106909,4633,106909,106909,111488,105708,5780,105708
5679,4988,4446,4617,-171,4446,4446,4453,4366,87,4366
5680,47958,49102,47940,1162,47940,47940,49114,47336,1778,47336
5681,30668,22912,21999,913,21999,21999,22925,21948,977,21948
5682,128491,132506,129733,2773,129733,128491,132542,128483,4059,128483
5683,35554,35530,35912,-382,35530,35530,35554,35016,538,35016
5684,34145,34685,33628,1057,33628,33628,34690,33523,1167,33523
5685,952,284,518,-234,284,284,284,330,-46,330
5686,2429,1748,2006,-258,1748,1748,1750,1807,-57,1807
5687,138068,146612,138086,8526,138086,138068,146641,137821,8820,137821
5688,26110,26096,25695,401,25695,25695,26110,25013,1097,25013
5689,81459,82541,81105,1436,81105,81105,82548,80837,1711,80837
5690,7783,7798,7980,-182,7798,7783,7799,7721,78,7721
5691,36727,38550,36717,1833,36717,36717,38549,33582,4967,33582
5692,2916,2236,2427,-191,2236,2236,2234,2294,-60,2294
5693,2912,2233,2444,-211,2233,2233,2232,2290,-58,2290
5694,9688,9683,9851,-168,9683,9683,9682,9688,-6,9688
5695,18096,18050,17801,249,17801,17801,18055,17649,406,17649
5696,162268,167495,162718,4777,162718,162268,167513,162268,5245,162268
5697,19889,19823,19740,83,19740,19740,19831,19267,564,19267
5698,116859,123500,116812,6688,116812,116812,123441,115691,7750,115691
5699,84060,84057,81364,2693,81364,81364,84071,81123,2948,81123
5700,137413,137407,133364,4043,133364,133364,137335,132833,4502,132833
5701,30148,31393,30141,1252,30141,30141,31383,30020,1363,30020
5702,304755,301487,290500,10987,290500,290500,301555,289857,11698,289857
5703,2018,1788,2019,-231,1788,1788,1790,1835,-45,1835
5704,70136,74134,70458,3676,70458,70136,74106,70136,3970,70136
5705,4071,4075,4181,-106,4075,4071,4075,4062,13,4062
5706,10944,10938,11208,-270,10938,10938,10944,10900,44,10900
5707,111159,110228,108260,1968,108260,108260,110232,107550,2682,107550
5708,26376,25861,24926,935,24926,24926,25860,24738,1122,24738
5709,613711,647567,613613,33954,613613,613613,647675,604232,43443,604232
5710,97590,102747,97485,5262,97485,97485,102758,96313,6445,96313
5711,117751,124719,117694,7025,117694,117694,124678,116893,7785,116893
5712,6646,6092,6154,-62,6092,6092,6092,6024,68,6024
5713,2879,2189,2437,-248,2189,2189,2188,2257,-69,2257
5714,91528,45954,44308,1646,44308,44308,45935,41711,4224,41711
5715,1533,1158,1385,-227,1158,1158,1158,1208,-50,1208
5716,593,594,839,-245,594,593,593,644,-51,593
5717,22313,21966,21667,299,21667,21667,21956,21691,265,21691
5718,8550,7913,8084,-171,7913,7913,7919,7928,-9,7928
5719,139207,152743,142110,10633,142110,139207,152800,139481,13319,139207
5720,8924,8494,8347,147,8347,8347,8492,8184,308,8184
5721,19902,20942,20687,255,20687,19902,20952,19280,1672,19280
5722,7462,4375,4475,-100,4375,4375,4373,4331,42,4331
5723,3146,2787,3010,-223,2787,2787,2787,2833,-46,2833
5724,1240,1005,1240,-235,1005,1005,1005,1054,-49,1054
5725,37233,36771,36522,249,36522,36522,36755,36611,144,36611
5726,22594,21747,21519,228,21519,21519,21748,21394,354,21394
5727,90724,75980,73435,2545,73435,73435,76003,73111,2892,73111
5728,67179,63791,62110,1681,62110,62110,63817,61757,2060,61757
5729,68461,61764,59830,1934,59830,59830,61773,56988,4785,56988
5730,119999,124298,119893,4405,119893,119893,124277,119377,4900,119377
5731,20635,21354,21027,327,21027,20635,21354,20013,1341,20013
5732,17729,17734,17358,376,17358,17358,17729,17176,553,17176
5733,6168,4514,4705,-191,4514,4514,4515,4257,258,4257
5734,242022,240507,234568,5939,234568,234568,240563,233001,7562,233001
5735,37215,37862,36620,1242,36620,36620,37881,36593,1288,36593
5736,19443,18895,18462,433,18462,18462,18903,18204,699,18204
5737,6095,5197,5160,37,5160,5160,5197,4822,375,4822
5738,19605,16644,15884,760,15884,15884,16642,14686,1956,14686
5739,242537,238227,222396,15831,222396,222396,238227,221462,16765,221462
5740,5072,4517,4550,-33,4517,4517,4517,4385,132,4385
5741,33369,33524,33108,416,33108,33108,33506,32747,759,32747
5742,8322,8306,8322,-16,8306,8306,8308,8105,203,8105
5743,35034,34988,33314,1674,33314,33314,35008,33288,1720,33288
5744,9204,9220,9163,57,9163,9163,9222,9007,215,9007
5745,200149,159543,154753,4790,154753,154753,159455,153213,6242,153213
5746,92171,98093,93974,4119,93974,92171,98118,92163,5955,92163
5747,5567,4807,4938,-131,4807,4807,4806,4813,-7,4813
5748,1621,1637,1884,-247,1637,1621,1639,1686,-47,1621
5749,5343,4657,4649,8,4649,4649,4658,4397,261,4397
5750,250702,226105,220390,5715,220390,220390,226126,218404,7722,218404
5751,19605,19587,19515,72,19515,19515,19605,19368,237,19368
5752,17135,17357,17129,228,17129,17129,17360,16873,487,16873
5753,1063,831,1063,-232,831,831,831,874,-43,874
5754,374529,387253,372234,15019,372234,372234,387261,369477,17784,369477
5755,245883,214402,203914,10488,203914,203914,214471,198119,16352,198119
5756,191999,208222,196987,11235,196987,191999,208413,192948,15465,191999
5757,15036,15453,15030,423,15030,15030,15451,14970,481,14970
5758,82023,74094,73396,698,73396,73396,74079,73132,947,73132
5759,2240,1628,1864,-236,1628,1628,1628,1618,10,1618
5760,83468,82907,78198,4709,78198,78198,82914,77752,5162,77752
5761,63724,65396,63884,1512,63884,63724,65361,63706,1655,63706
5762,14909,15452,15285,167,15285,14909,15454,14287,1167,14287
5763,12490,11649,11447,202,11447,11447,11650,11046,604,11046
5764,72016,70803,69411,1392,69411,69411,70808,68390,2418,68390
5765,34257,35350,34257,1093,34257,34257,35359,33588,1771,33588
5766,38346,37057,35263,1794,35263,35263,37062,35096,1966,35096
5767,20179,20886,20366,520,20366,20179,20883,20179,704,20179
5768,104599,100841,96545,4296,96545,96545,100835,95771,5064,95771
5769,277640,277625,268812,8813,268812,268812,277640,266368,11272,266368
5770,9302,8790,8457,333,8457,8457,8783,8346,437,8346
5771,36973,37535,38991,-1456,37535,36973,37551,37383,168,36973
5772,40309,39121,38163,958,38163,38163,39130,37694,1436,37694
5773,32435,31890,30054,1836,30054,30054,31899,29929,1970,29929
5774,3985,3986,4244,-258,3986,3985,3985,4003,-18,3985
5775,4276,3983,4094,-111,3983,3983,3981,3949,32,3949
5776,41236,39182,38883,299,38883,38883,39206,37941,1265,37941
5777,44950,45203,44910,293,44910,44910,45213,44138,1075,44138
5778,10826,10194,9921,273,9921,9921,10195,9856,339,9856
5779,2161,1769,1960,-191,1769,1769,1769,1816,-47,1816
5780,4685,4179,4275,-96,4179,4179,4180,4135,45,4135
5781,50569,51431,50089,1342,50089,50089,51421,49947,1474,49947
5782,9393,9389,9423,-34,9389,9389,9393,9275,118,9275
5783,8360,8360,8925,-565,8360,8360,8360,8535,-175,8360
5784,11936,12250,12010,240,12010,11936,12258,11314,944,11314
5785,38947,36517,33513,3004,33513,33513,36519,33454,3065,33454
5786,12384,13159,12828,331,12828,12384,13154,11762,1392,11762
5787,31507,29443,28902,541,28902,28902,29441,27901,1540,27901
5788,73492,77567,76514,1053,76514,73492,77602,73502,4100,73492
5789,28307,28281,28483,-202,28281,28281,28275,28033,242,28033
5790,20562,20550,20582,-32,20550,20550,20562,20342,220,20342
5791,3201,2556,2780,-224,2556,2556,2558,2579,-21,2579
5792,19882,21028,20002,1026,20002,19882,21032,19882,1150,19882
5793,1017,1017,1144,-127,1017,1017,1017,979,38,979
5794,204571,201601,195170,6431,195170,195170,201575,194179,7396,194179
5795,22935,23111,23233,-122,23111,22935,23118,22313,805,22313
5796,18660,18656,19166,-510,18656,18656,18660,18014,646,18014
5797,5789,5750,5783,-33,5750,5750,5755,5601,154,5601
5798,9587,6422,6359,63,6359,6359,6425,6120,305,6120
5799,15893,16423,15897,526,15897,15893,16427,15706,721,15706
5800,1698,1714,1903,-189,1714,1698,1714,1745,-31,1698
5801,1237,832,1060,-228,832,832,832,878,-46,878
5802,233805,247570,238745,8825,238745,233805,247566,233797,13769,233797
5803,373501,347254,345260,1994,345260,345260,347598,336921,10677,336921
5804,84995,63333,63720,-387,63333,63333,63332,61409,1923,61409
5805,12786,9624,9693,-69,9624,9624,9624,9507,117,9507
5806,68376,69439,68369,1070,68369,68369,69444,67334,2110,67334
5807,2345,1668,1896,-228,1668,1668,1668,1723,-55,1723
5808,202175,177703,172032,5671,172032,172032,177765,169693,8072,169693
5809,5658,4984,5104,-120,4984,4984,4983,5036,-53,5036
5810,40043,42061,39975,2086,39975,39975,42062,39421,2641,39421
5811,17031,16820,16483,337,16483,16483,16812,16409,403,16409
5812,6109,4965,5074,-109,4965,4965,4967,4917,50,4917
5813,9969,9393,9331,62,9331,9331,9389,9166,223,9166
5814,190994,198446,194553,3893,194553,190994,198558,190372,8186,190372
5815,1473,804,1050,-246,804,804,804,851,-47,851
5816,1082,409,638,-229,409,409,409,460,-51,460
5817,185877,195422,185857,9565,185857,185857,195331,185358,9973,185358
5818,53563,55532,53294,2238,53294,53294,55552,52941,2611,52941
5819,47971,34471,33095,1376,33095,33095,34457,32035,2422,32035
5820,3344,3342,3461,-119,3342,3342,3344,3301,43,3301
5821,58130,57466,54867,2599,54867,54867,57484,54723,2761,54723
5822,57629,55541,54096,1445,54096,54096,55559,53701,1858,53701
5823,13667,12073,11664,409,11664,11664,12076,10907,1169,10907
5824,8748,8944,8748,196,8748,8748,8948,8686,262,8686
5825,11812,11361,11302,59,11302,11302,11369,11076,293,11076
5826,208704,204591,194325,10266,194325,194325,204556,192600,11956,192600
5827,4971,4164,4396,-232,4164,4164,4165,4050,115,4050
5828,757,367,605,-238,367,367,367,414,-47,414
5829,707,707,940,-233,707,707,707,750,-43,707
5830,4191,4187,4206,-19,4187,4187,4191,4042,149,4042
5831,17434,17432,16861,571,16861,16861,17434,16486,948,16486
5832,33696,35261,33627,1634,33627,33627,35282,33512,1770,33512
5833,40905,40905,40160,745,40160,40160,40911,39586,1325,39586
5834,44049,44565,43522,1043,43522,43522,44581,43427,1154,43427
5835,10434,10006,9905,101,9905,9905,10009,9669,340,9669
5836,1061,382,631,-249,382,382,382,439,-57,439
5837,86970,93290,86971,6319,86971,86970,93254,86692,6562,86692
5838,10630,10127,10160,-33,10127,10127,10121,9889,232,9889
5839,116435,119696,116397,3299,116397,116397,119717,114653,5064,114653
5840,119156,120802,119057,1745,119057,119057,120812,117746,3066,117746
5841,19156,19682,19151,531,19151,19151,19679,19022,657,19022
5842,116014,114505,108779,5726,108779,108779,114513,107398,7115,107398
5843,7720,7667,7658,9,7658,7658,7665,7517,148,7517
5844,2930,2819,2946,-127,2819,2819,2818,2795,23,2795
5845,24366,21633,21008,625,21008,21008,21633,20222,1411,20222
5846,27185,27162,26826,336,26826,26826,27185,26214,971,26214
5847,90200,94232,90191,4041,90191,90191,94262,89740,4522,89740
5848,9190,8789,8789,0,8789,8789,8784,8672,112,8672
5849,216434,216403,206321,10082,206321,206321,216434,205509,10925,205509
5850,6043,5996,5971,25,5971,5971,5997,5421,576,5421
5851,1756,1079,1338,-259,1079,1079,1081,1134,-53,1134
5852,1445,1446,1679,-233,1446,1445,1445,1490,-45,1445
5853,33467,34176,33323,853,33323,33323,34194,32845,1349,32845
5854,37161,39220,37252,1968,37252,37161,39234,37161,2073,37161
5855,25784,25458,25619,-161,25458,25458,25448,25162,286,25162
5856,12835,13034,12836,198,12836,12835,13021,12733,288,12733
5857,235440,250401,239577,10824,239577,235440,250528,234818,15710,234818
5858,14841,14836,14608,228,14608,14608,14841,14428,413,14428
5859,21591,16470,15716,754,15716,15716,16481,15248,1233,15248
5860,939,875,1101,-226,875,875,875,931,-56,931
5861,3620,3171,3321,-150,3171,3171,3170,3172,-2,3172
5862,51120,51326,50564,762,50564,50564,51333,49990,1343,49990
5863,328582,327689,314461,13228,314461,314461,327755,314522,13233,314522
5864,7095,7088,7116,-28,7088,7088,7095,6916,179,6916
5865,19807,19775,19042,733,19042,19042,19780,18572,1208,18572
5866,2470,2424,2676,-252,2424,2424,2424,2452,-28,2452
5867,25413,24729,23859,870,23859,23859,24734,23767,967,23767
5868,8796,8596,8733,-137,8596,8596,8604,8477,127,8477
5869,1054,646,886,-240,646,646,647,694,-47,694
5870,8462,8451,8364,87,8364,8364,8462,8074,388,8074
5871,14832,13841,13596,245,13596,13596,13849,13093,756,13093
5872,721020,704402,677914,26488,677914,677914,704496,669683,34813,669683
5873,291,291,522,-231,291,291,291,337,-46,291
5874,13941,14057,14253,-196,14057,13941,14059,13937,122,13937
5875,7115,7233,7232,1,7232,7115,7231,7076,155,7076
5876,12571,12905,12575,330,12575,12571,12908,12392,516,12392
5877,994,742,994,-252,742,742,744,782,-38,782
5878,33597,33317,33585,-268,33317,33317,33343,32944,399,32944
5879,29888,27944,27093,851,27093,27093,27947,26834,1113,26834
5880,10525,9239,9464,-225,9239,9239,9233,8988,245,8988
5881,49036,47896,46807,1089,46807,46807,47938,45348,2590,45348
5882,457478,236073,226572,9501,226572,226572,236000,207517,28483,207517
5883,468458,474083,471612,2471,471612,468458,473966,468404,5562,468404
5884,5661,5662,5735,-73,5662,5661,5661,5461,200,5461
5885,31092,7720,7899,-179,7720,7720,7726,7696,30,7696
5886,36269,34218,33734,484,33734,33734,34200,33247,953,33247
5887,3935,3933,4056,-123,3933,3933,3933,3913,20,3913
5888,22943,22947,22960,-13,22947,22943,22943,22553,390,22553
5889,525204,529814,519243,10571,519243,519243,529847,515583,14264,515583
5890,18649,18661,18781,-120,18661,18649,18667,18340,327,18340
5891,69135,66421,64336,2085,64336,64336,66444,63705,2739,63705
5892,2102,1568,1760,-192,1568,1568,1570,1621,-51,1621
5893,58061,38196,36740,1456,36740,36740,38201,36350,1851,36350
5894,13406,12999,12737,262,12737,12737,13000,12589,411,12589
5895,7261,6562,6601,-39,6562,6562,6565,6335,230,6335
5896,80806,80049,77477,2572,77477,77477,80060,77165,2895,77165
5897,13160,13166,13280,-114,13166,13160,13160,13032,128,13032
5898,16372,16380,15834,546,15834,15834,16372,15745,627,15745
5899,1278,291,525,-234,291,291,291,336,-45,336
5900,9591,9087,8947,140,8947,8947,9083,8724,359,8724
5901,19111,19022,18927,95,18927,18927,19033,18572,461,18572
5902,174314,162130,154818,7312,154818,154818,162131,153232,8899,153232
5903,31226,28678,27780,898,27780,27780,28643,27652,991,27652
5904,43828,47210,45168,2042,45168,43828,47219,43286,3933,43286
5905,1461,1415,1679,-264,1415,1415,1415,1443,-28,1443
5906,55152,57854,55266,2588,55266,55152,57842,55241,2601,55152
5907,109846,103578,98214,5364,98214,98214,103582,98031,5551,98031
5908,296671,262703,250709,11994,250709,250709,262803,247179,15624,247179
5909,13316,13283,13415,-132,13283,13283,13284,12821,463,12821
5910,61249,61241,58934,2307,58934,58934,61249,58355,2894,58355
5911,4745,4655,4743,-88,4655,4655,4656,4499,157,4499
5912,161594,190049,180235,9814,180235,161594,190144,161576,28568,161576
5913,14590,14806,15107,-301,14806,14590,14816,14557,259,14557
5914,34033,39649,42189,-2540,39649,34033,39675,33411,6264,33411
5915,8740,8738,8795,-57,8738,8738,8742,8687,55,8687
5916,1484,1268,1484,-216,1268,1268,1268,1320,-52,1320
5917,7747,6767,6937,-170,6767,6767,6761,6471,290,6471
5918,87143,75359,72370,2989,72370,72370,75371,72295,3076,72295
5919,108646,110943,109555,1388,109555,108646,110987,108024,2963,108024
5920,60539,59609,59003,606,59003,59003,59617,58004,1613,58004
5921,191990,196925,191932,4993,191932,191932,197003,190426,6577,190426
5922,29986,19584,19570,14,19570,19570,19585,19353,232,19353
5923,6021,6020,6171,-151,6020,6020,6021,5994,27,5994
5924,3286,2645,2795,-150,2645,2645,2644,2588,56,2588
5925,8549,8257,8401,-144,8257,8257,8261,7927,334,7927
5926,234533,186607,181427,5180,181427,181427,186585,180282,6303,180282
5927,51382,51394,49244,2150,49244,49244,51382,49028,2354,49028
5928,8335,7706,7825,-119,7706,7706,7719,7597,122,7597
5929,709,710,955,-245,710,709,709,762,-53,709
5930,63616,62560,62472,88,62472,62472,62571,61563,1008,61563
5931,26810,26640,25870,770,25870,25870,26638,25510,1128,25510
5932,83420,62598,61063,1535,61063,61063,62593,59979,2614,59979
5933,26532,27186,26613,573,26613,26532,27189,26532,657,26532
5934,3867,3323,3492,-169,3323,3323,3322,3279,43,3279
5935,374945,373914,365359,8555,365359,365359,374133,363414,10719,363414
5936,2103,1128,1367,-239,1128,1128,1128,1184,-56,1184
5937,38174,40240,39155,1085,39155,38174,40223,38156,2067,38156
5938,36093,33638,31860,1778,31860,31860,33610,31557,2053,31557
5939,15441,15442,15338,104,15338,15338,15441,15118,323,15118
5940,12670,12216,12168,48,12168,12168,12222,12014,208,12014
5941,11920,11929,11904,25,11904,11904,11938,11582,356,11582
5942,73756,58329,57920,409,57920,57920,58354,52654,5700,52654
5943,178880,186677,178773,7904,178773,178773,186734,177495,9239,177495
5944,118057,114440,111637,2803,111637,111637,114479,111234,3245,111234
5945,825,783,1027,-244,783,783,783,825,-42,825
5946,1546,1363,1547,-184,1363,1363,1364,1415,-51,1415
5947,11754,12097,11754,343,11754,11754,12095,11644,451,11644
5948,43320,41479,37998,3481,37998,37998,41484,37456,4028,37456
5949,22313,19554,20382,-828,19554,19554,19561,19390,171,19390
5950,7633,7206,6955,251,6955,6955,7202,6801,401,6801
5951,309850,352729,317709,35020,317709,309850,352690,309228,43462,309228
5952,88570,79843,78667,1176,78667,78667,79900,78022,1878,78022
5953,68795,67589,64783,2806,64783,64783,67575,64442,3133,64442
5954,3298,3071,3276,-205,3071,3071,3073,3127,-54,3127
5955,367305,357472,338388,19084,338388,338388,357616,336556,21060,336556
5956,4171,4378,4546,-168,4378,4171,4379,4203,176,4171
5957,24706,23768,22667,1101,22667,22667,23771,22607,1164,22607
5958,38159,35691,33635,2056,33635,33635,35698,33405,2293,33405
5959,5009,4266,4345,-79,4266,4266,4264,4231,33,4231
5960,22747,22753,21858,895,21858,21858,22747,21765,982,21765
5961,3743,3744,3874,-130,3744,3743,3743,3757,-14,3743
5962,13517,10466,10353,113,10353,10353,10457,10112,345,10112
5963,5168,4591,4703,-112,4591,4591,4592,4546,46,4546
5964,45137,38139,37673,466,37673,37673,38146,37488,658,37488
5965,85537,86256,85462,794,85462,85462,86242,81985,4257,81985
5966,6019,5508,5685,-177,5508,5508,5507,5483,24,5483
5967,44519,40681,38696,1985,38696,38696,40679,38426,2253,38426
5968,20111,18825,18922,-97,18825,18825,18832,16050,2782,16050
5969,81874,20039,20079,-40,20039,20039,20047,19506,541,19506
5970,62990,64380,62914,1466,62914,62914,64358,62613,1745,62613
5971,969353,926812,896446,30366,896446,896446,926984,889666,37318,889666
5972,389851,362724,340642,22082,340642,340642,362758,338806,23952,338806
5973,13351,13302,13144,158,13144,13144,13297,12528,769,12528
5974,7479,6785,6679,106,6679,6679,6789,6592,197,6592
5975,4443,4010,4173,-163,4010,4010,4011,3947,64,3947
5976,5368,4716,4853,-137,4716,4716,4719,4746,-27,4746
5977,32124,27795,26964,831,26964,26964,27804,26685,1119,26685
5978,17071,17378,17100,278,17100,17071,17378,17063,315,17063
5979,232999,245908,232999,12909,232999,232999,245900,228458,17442,228458
5980,27971,27154,26582,572,26582,26582,27156,26279,877,26279
5981,178761,177848,173086,4762,173086,173086,177824,168796,9028,168796
5982,323530,308892,314744,-5852,308892,308892,308977,291344,17633,291344
5983,293979,289821,280631,9190,280631,280631,289913,279317,10596,279317
5984,183017,146600,139764,6836,139764,139764,146616,138727,7889,138727
5985,8838,6986,7443,-457,6986,6986,6981,6807,174,6807
5986,3014,2341,2552,-211,2341,2341,2338,2392,-54,2392
5987,6023,6022,6060,-38,6022,6022,6023,5923,100,5923
5988,86745,95230,88201,7029,88201,86745,95222,86737,8485,86737
5989,5764,5275,5380,-105,5275,5275,5270,5142,128,5142
5990,707,707,940,-233,707,707,707,750,-43,707
5991,23547,8794,8713,81,8713,8713,8799,8612,187,8612
5992,43535,42690,40682,2008,40682,40682,42704,39904,2800,39904
5993,270138,258107,251822,6285,251822,251822,258320,245893,12427,245893
5994,8690,8783,8674,109,8674,8674,8784,8068,716,8068
5995,58287,57352,55427,1925,55427,55427,57359,54912,2447,54912
5996,58612,55315,52143,3172,52143,52143,55323,51639,3684,51639
5997,53041,48186,46219,1967,46219,46219,48174,45402,2772,45402
5998,12154,12352,12159,193,12159,12154,12359,11953,406,11953
5999,9312,8055,8022,33,8022,8022,8054,7921,133,7921
6000,19247,18690,19019,-329,18690,18690,18698,18625,73,18625
6001,8920,8866,8857,9,8857,8857,8877,8532,345,8532
6002,23478,2762,3108,-346,2762,2762,2765,2849,-84,2849
6003,17763,16797,16516,281,16516,16516,16791,15958,833,15958
6004,1894,1212,1457,-245,1212,1212,1213,1272,-59,1272
6005,50753,52061,50691,1370,50691,50691,52060,50462,1598,50462
6006,5182,4666,4779,-113,4666,4666,4669,4560,109,4560
6007,1119135,1044654,1015098,29556,1015098,1015098,1044590,1006825,37765,1006825
6008,4447,3910,3908,2,3908,3908,3913,3711,202,3711
6009,41859,38505,37674,831,37674,37674,38501,37382,1119,37382
6010,6892,6511,6599,-88,6511,6511,6511,6463,48,6463
6011,10422,10858,10417,441,10417,10417,10861,10172,689,10172
6012,14669,14059,14146,-87,14059,14059,14055,13848,207,13848
6013,77783,78424,78862,-438,78424,77783,78420,77783,637,77783
6014,6636,6656,7009,-353,6656,6636,6665,6636,29,6636
6015,31494,23289,23792,-503,23289,23289,23294,23328,-34,23328
6016,1807,835,1085,-250,835,835,835,884,-49,884
6017,388279,356744,351684,5060,351684,351684,356716,345907,10809,345907
6018,1081726,911653,890190,21463,890190,890190,911733,876979,34754,876979
6019,357101,368372,382768,-14396,368372,357101,368473,357101,11372,357101
6020,69721,68545,65642,2903,65642,65642,68544,65529,3015,65529
6021,4650,4162,4260,-98,4162,4162,4162,4073,89,4073
6022,26885,26799,26542,257,26542,26542,26823,26248,575,26248
6023,5940,6060,6090,-30,6060,5940,6059,5940,119,5940
6024,122864,126959,123644,3315,123644,122864,126996,123246,3750,122864
6025,72052,60116,60555,-439,60116,60116,60117,59582,535,59582
6026,169634,170966,169569,1397,169569,169569,171097,167932,3165,167932
6027,1677,1637,1828,-191,1637,1637,1638,1701,-63,1677
6028,3287,3267,3468,-201,3267,3267,3266,3278,-12,3278
6029,31724,30495,28309,2186,28309,28309,30479,27303,3176,27303
6030,65761,43325,41633,1692,41633,41633,43329,41211,2118,41211
6031,38612,37752,38659,-907,37752,37752,37773,37689,84,37689
6032,76095,82587,75899,6688,75899,75899,82568,71269,11299,71269
6033,563721,599939,563594,36345,563594,563594,599973,558377,41596,558377
6034,168810,165752,160187,5565,160187,160187,165853,159596,6257,159596
6035,7471,7464,7902,-438,7464,7464,7471,7517,-46,7471
6036,54325,55393,54254,1139,54254,54254,55399,53931,1468,53931
6037,15035,15167,15031,136,15031,15031,15170,14728,442,14728
6038,104200,65271,64596,675,64596,64596,65263,63904,1359,63904
6039,11798,11802,11647,155,11647,11647,11798,11646,152,11646
6040,17807,17806,17151,655,17151,17151,17807,16959,848,16959
6041,3138,2426,2645,-219,2426,2426,2427,2452,-25,2452
6042,36547,35908,34719,1189,34719,34719,35929,34573,1356,34573
6043,38786,38249,37399,850,37399,37399,38265,37215,1050,37215
6044,4317,4214,4318,-104,4214,4214,4219,4057,162,4057
6045,235247,213282,210938,2344,210938,210938,213366,208563,4803,208563
6046,31722,29321,28173,1148,28173,28173,29309,26955,2354,26955
6047,107835,108082,107835,247,107835,107835,108077,105844,2233,105844
6048,12936,13139,12933,206,12933,12933,13141,12781,360,12781
6049,4720,4590,4675,-85,4590,4590,4591,4563,28,4563
6050,1508,409,641,-232,409,409,409,454,-45,454
6051,819,418,651,-233,418,418,418,460,-42,460
6052,27825,27825,27826,-1,27825,27825,27825,27489,336,27489
6053,202078,202025,189284,12741,189284,189284,202078,188486,13592,188486
6054,1528,1440,1711,-271,1440,1440,1440,1488,-48,1488
6055,15777,15770,15468,302,15468,15468,15777,15281,496,15281
6056,7926,7924,7927,-3,7924,7924,7926,7786,140,7786
6057,1851,1853,2106,-253,1853,1851,1851,1893,-42,1851
6058,181851,186608,185567,1041,185567,181851,186668,181851,4817,181851
6059,3306,2899,3048,-149,2899,2899,2901,2908,-7,2908
6060,10779,10744,10819,-75,10744,10744,10750,10550,200,10550
6061,421,421,663,-242,421,421,421,467,-46,421
6062,15294,14606,14003,603,14003,14003,14613,13550,1063,13550
6063,20351,19161,18616,545,18616,18616,19164,18407,757,18407
6064,13526,12331,12005,326,12005,12005,12333,11907,426,11907
6065,854259,344872,339242,5630,339242,339242,344850,335837,9013,335837
6066,13138,13488,13134,354,13134,13134,13482,13084,398,13084
6067,9452,9066,9044,22,9044,9044,9065,8875,190,8875
6068,5822,5381,5377,4,5377,5377,5380,5265,115,5265
6069,284834,274718,275137,-419,274718,274718,274805,269790,5015,269790
6070,445675,432045,410471,21574,410471,410471,431948,406282,25666,406282
6071,232833,240862,232792,8070,232792,232792,240860,230533,10327,230533
6072,7589,7403,7530,-127,7403,7403,7397,7348,49,7348
6073,46583,50680,46562,4118,46562,46562,50676,45140,5536,45140
6074,26029,26015,25607,408,25607,25607,26029,25115,914,25115
6075,98662,72685,69891,2794,69891,69891,72698,69182,3516,69182
6076,8544,8543,8662,-119,8543,8543,8544,8219,325,8219
6077,53620,52277,49949,2328,49949,49949,52280,49708,2572,49708
6078,3851,3430,3521,-91,3430,3430,3430,3409,21,3409
6079,125196,123176,119115,4061,119115,119115,123175,118635,4540,118635
6080,90362,90313,85854,4459,85854,85854,90301,85221,5080,85221
6081,39381,39381,38067,1314,38067,38067,39381,37564,1817,37564
6082,5998,6012,6221,-209,6012,5998,6014,6007,7,5998
6083,44661,43654,42202,1452,42202,42202,43642,42093,1549,42093
6084,21975,21940,22134,-194,21940,21940,21956,21983,-27,21975
6085,38827,35265,34345,920,34345,34345,35294,34229,1065,34229
6086,39194,35698,35059,639,35059,35059,35727,34778,949,34778
6087,3719,2811,3102,-291,2811,2811,2812,2870,-58,2870
6088,32305,30788,29514,1274,29514,29514,30802,29167,1635,29167
6089,26063,27793,26051,1742,26051,26051,27787,25697,2090,25697
6090,24476,24468,24215,253,24215,24215,24476,23959,517,23959
6091,30656,28709,26715,1994,26715,26715,28712,26641,2071,26641
6092,43804,42363,41230,1133,41230,41230,42357,40995,1362,40995
6093,22772,21964,21698,266,21698,21698,21967,21455,512,21455
6094,16932,15693,15197,496,15197,15197,15690,14640,1050,14640
6095,18329,17733,17574,159,17574,17574,17734,17443,291,17443
6096,5644,5643,5716,-73,5643,5643,5644,5568,76,5568
6097,49277,48705,47552,1153,47552,47552,48710,47258,1452,47258
6098,7640,7119,7111,8,7111,7111,7121,7022,99,7022
6099,5519,4503,4653,-150,4503,4503,4501,4548,-47,4548
6100,8197,7705,7531,174,7531,7531,7702,7412,290,7412
6101,45719,45699,43961,1738,43961,43961,45719,43753,1966,43753
6102,17550,16743,16298,445,16298,16298,16751,16141,610,16141
6103,11859,11853,11859,-6,11853,11853,11862,11570,292,11570
6104,14639,12927,12678,249,12678,12678,12924,12517,407,12517
6105,122604,103876,100335,3541,100335,100335,103843,99973,3870,99973
6106,71976,74141,71500,2641,71500,71500,74188,71354,2834,71354
6107,1302,1302,1519,-217,1302,1302,1302,1353,-51,1302
6108,3559,3231,3467,-236,3231,3231,3231,3303,-72,3303
6109,11322,11338,11298,40,11298,11298,11340,11159,181,11159
6110,1484,551,799,-248,551,551,551,531,20,531
6111,3235,3064,3235,-171,3064,3064,3064,3074,-10,3074
6112,2582,2212,2429,-217,2212,2212,2211,2254,-43,2254
6113,8247,7658,7546,112,7546,7546,7654,7325,329,7325
6114,31195,29786,28155,1631,28155,28155,29797,28127,1670,28127
6115,255150,269612,255044,14568,255044,255044,269672,254715,14957,254715
6116,8373,8364,8472,-108,8364,8364,8373,8303,70,8303
6117,67824,66534,67331,-797,66534,66534,66555,66384,171,66384
6118,86068,85351,82821,2530,82821,82821,85366,82656,2710,82656
6119,20054,20052,20262,-210,20052,20052,20054,19905,149,19905
6120,21274,22247,21266,981,21266,21266,22248,21152,1096,21152
6121,22872,22282,21979,303,21979,21979,22272,21817,455,21817
6122,34760,30748,31022,-274,30748,30748,30756,30352,404,30352
6123,48471,47365,46508,857,46508,46508,47369,45855,1514,45855
6124,48916,48912,47249,1663,47249,47249,48916,47147,1769,47147
6125,9591,9588,9701,-113,9588,9588,9591,9370,221,9370
6126,12141,12125,12140,-15,12125,12125,12123,12027,96,12027
6127,1418,1417,1665,-248,1417,1417,1418,1478,-60,1418
6128,242961,237302,222952,14350,222952,222952,237278,222765,14513,222765
6129,17665,16947,16829,118,16829,16829,16943,16634,309,16634
6130,6593,5658,5951,-293,5658,5658,5660,5513,147,5513
6131,49383,48161,46570,1591,46570,46570,48161,45795,2366,45795
6132,19177,18595,17749,846,17749,17749,18595,17707,888,17707
6133,16994,15485,14526,959,14526,14526,15494,14242,1252,14242
6134,5569,5568,5577,-9,5568,5568,5569,5331,238,5331
6135,1992,1992,2168,-176,1992,1992,1992,2029,-37,1992
6136,3950,3574,3820,-246,3574,3574,3573,3606,-33,3606
6137,4622,4315,4339,-24,4315,4315,4319,4000,319,4000
6138,4106,4104,4142,-38,4104,4104,4106,4012,94,4012
6139,38781,35372,34367,1005,34367,34367,35388,34336,1052,34336
6140,3201,3026,3201,-175,3026,3026,3030,3054,-24,3054
6141,3879,3942,3879,63,3879,3879,3944,3840,104,3840
6142,10407,10811,10406,405,10406,10406,10817,10206,611,10206
6143,117546,113170,105850,7320,105850,105850,113158,105410,7748,105410
6144,5068,5067,5064,3,5064,5064,5068,4925,143,4925
6145,8021,8024,8221,-197,8024,8021,8027,8031,-4,8021
6146,7326,7327,7289,38,7289,7289,7326,7134,192,7134
6147,30663,27962,27296,666,27296,27296,27965,27107,858,27107
6148,89290,86164,84581,1583,84581,84581,86200,84067,2133,84067
6149,3459,3456,3541,-85,3456,3456,3459,3420,39,3420
6150,77599,77590,75072,2518,75072,75072,77599,74691,2908,74691
6151,11193,10714,10794,-80,10714,10714,10718,10593,125,10593
6152,8589,8663,8585,78,8585,8585,8661,8481,180,8481
6153,370981,383274,372603,10671,372603,370981,383291,370922,12369,370922
6154,26316,26210,26311,-101,26210,26210,26204,26013,191,26013
6155,25881,25193,24833,360,24833,24833,25181,24500,681,24500
6156,46752,44460,44165,295,44165,44165,44481,43613,868,43613
6157,64155,64061,62551,1510,62551,62551,64045,62068,1977,62068
6158,9207,8493,8364,129,8364,8364,8495,8235,260,8235
6159,393,393,641,-248,393,393,393,440,-47,393
6160,11020,11010,10620,390,10620,10620,11020,10551,469,10551
6161,19260,18442,18770,-328,18442,18442,18433,18243,190,18243
6162,72623,69295,66487,2808,66487,66487,69285,66360,2925,66360
6163,5508,5093,5157,-64,5093,5093,5096,5030,66,5030
6164,16149,16148,15846,302,15846,15846,16149,15665,484,15665
6165,291587,290905,273219,17686,273219,273219,291033,272786,18247,272786
6166,82578,84197,80946,3251,80946,80946,84218,80469,3749,80469
6167,1277,960,1196,-236,960,960,960,1012,-52,1012
6168,5280,5165,5185,-20,5165,5165,5164,5035,129,5035
6169,108726,111505,108722,2783,108722,108722,111449,108213,3236,108213
6170,165223,179618,172386,7232,172386,165223,179709,164601,15108,164601
6171,18673,18038,17377,661,17377,17377,18045,17184,861,17184
6172,32364,31753,31159,594,31159,31159,31751,30960,791,30960
6173,137257,130109,123183,6926,123183,123183,130071,122810,7261,122810
6174,23114,23129,23064,65,23064,23064,23114,22615,499,22615
6175,60494,59563,57695,1868,57695,57695,59542,57528,2014,57528
6176,88136,84242,81225,3017,81225,81225,84244,80614,3630,80614
6177,64784,64806,61786,3020,61786,61786,64802,60977,3825,60977
6178,4797,4315,4356,-41,4315,4315,4311,4243,68,4243
6179,172151,172136,163881,8255,163881,163881,172151,161742,10409,161742
6180,8588,8590,8670,-80,8590,8588,8588,8396,192,8396
6181,2868,2682,2867,-185,2682,2682,2685,2714,-29,2714
6182,40305,40234,39365,869,39365,39365,40244,39088,1156,39088
6183,22493,21679,21130,549,21130,21130,21681,21079,602,21079
6184,18729,17810,17180,630,17180,17180,17810,17095,715,17095
6185,31821,31727,31819,-92,31727,31727,31755,31284,471,31284
6186,9402,8951,8780,171,8780,8780,8952,8679,273,8679
6187,217168,225149,217055,8094,217055,217055,225194,216599,8595,216599
6188,45030,33069,31810,1259,31810,31810,33059,31785,1274,31785
6189,5704,5703,5809,-106,5703,5703,5704,5576,128,5576
6190,10559,10132,10152,-20,10132,10132,10131,9994,137,9994
6191,18951,19309,18888,421,18888,18888,19316,18506,810,18506
6192,28238,28793,28247,546,28247,28238,28801,27705,1096,27705
6193,40859,40852,40136,716,40136,40136,40859,39749,1110,39749
6194,9354,3714,3774,-60,3714,3714,3715,3670,45,3670
6195,7133,6710,6790,-80,6710,6710,6707,6602,105,6602
6196,32180,32185,31901,284,31901,31901,32180,31517,663,31517
6197,3712,3302,3477,-175,3302,3302,3300,3329,-29,3329
6198,83743,80323,79498,825,79498,79498,80367,78284,2083,78284
6199,34199,33426,32156,1270,32156,32156,33429,32031,1398,32031
6200,28055,27319,26879,440,26879,26879,27320,26624,696,26624
6201,68221,67527,64600,2927,64600,64600,67565,64420,3145,64420
6202,4368,4368,4458,-90,4368,4368,4368,4319,49,4319
6203,697265,679084,641800,37284,641800,641800,679195,637398,41797,637398
6204,1561,1561,1797,-236,1561,1561,1561,1608,-47,1561
6205,268697,256435,242574,13861,242574,242574,256490,241018,15472,241018
6206,27653,16323,16235,88,16235,16235,16326,16008,318,16008
6207,63833,67255,63814,3441,63814,63814,67297,63731,3566,63731
6208,7217,7214,7158,56,7158,7158,7217,6983,234,6983
6209,32142,32099,31995,104,31995,31995,32120,31300,820,31300
6210,187508,181953,170847,11106,170847,170847,181957,169341,12616,169341
6211,3431,3025,3189,-164,3025,3025,3025,3039,-14,3039
6212,25839,26384,25839,545,25839,25839,26384,25719,665,25719
6213,40898,11483,11094,389,11094,11094,11487,11089,398,11089
6214,10143,10137,10278,-141,10137,10137,10143,9818,325,9818
6215,22024,21328,21061,267,21061,21061,21342,20713,629,20713
6216,372701,372527,357767,14760,357767,357767,372643,356075,16568,356075
6217,30746,30077,29129,948,29129,29129,30098,28981,1117,28981
6218,23194,22404,21661,743,21661,21661,22407,21557,850,21557
6219,127461,109834,105906,3928,105906,105906,109833,104811,5022,104811
6220,32423,33186,32423,763,32423,32423,33180,31992,1188,31992
6221,71600,71600,70515,1085,70515,70515,71600,70066,1534,70066
6222,10267,10264,10526,-262,10264,10264,10267,10239,28,10239
6223,36828,36760,36245,515,36245,36245,36787,35635,1152,35635
6224,46851,46093,44746,1347,44746,44746,46099,44647,1452,44647
6225,25578,23511,23523,-12,23511,23511,23503,23337,166,23337
6226,28934,28938,28311,627,28311,28311,28934,28080,854,28080
6227,4846,4443,4626,-183,4443,4443,4442,4459,-17,4459
6228,6662,6664,6669,-5,6664,6662,6662,6512,150,6512
6229,18724,18744,18813,-69,18744,18724,18742,17945,797,17945
6230,374311,364202,363224,978,363224,363224,364261,358388,5873,358388
6231,231447,223756,209433,14323,209433,209433,223769,207750,16019,207750
6232,8490,8486,9011,-525,8486,8486,8490,8553,-63,8490
6233,25468,24657,23882,775,23882,23882,24660,23745,915,23745
6234,23599,25070,23941,1129,23941,23599,25066,23235,1831,23235
6235,30325,30322,29631,691,29631,29631,30325,29498,827,29498
6236,140860,138011,134340,3671,134340,134340,138013,134019,3994,134019
6237,2482,2483,2647,-164,2483,2482,2482,2524,-42,2482
6238,9957,9951,10178,-227,9951,9951,9957,9814,143,9814
6239,305728,302576,292540,10036,292540,292540,302613,290934,11679,290934
6240,34539,33249,31744,1505,31744,31744,33246,31636,1610,31636
6241,1510,1508,1610,-102,1508,1508,1510,1521,-11,1510
6242,44970,44081,42803,1278,42803,42803,44103,42565,1538,42565
6243,3015,2637,2856,-219,2637,2637,2637,2697,-60,2697
6244,77929,76550,74606,1944,74606,74606,76592,73781,2811,73781
6245,17738,17754,16884,870,16884,16884,17756,16575,1181,16575
6246,41010,41011,39967,1044,39967,39967,41028,39196,1832,39196
6247,24878,23957,24337,-380,23957,23957,23977,23638,339,23638
6248,19610,19616,18930,686,18930,18930,19610,18815,795,18815
6249,311093,315851,310445,5406,310445,310445,315913,308508,7405,308508
6250,23632,22979,22268,711,22268,22268,22975,22104,871,22104
6251,76074,79800,75999,3801,75999,75999,79856,73571,6285,73571
6252,48442,48407,46926,1481,46926,46926,48442,46430,2012,46430
6253,21603,6400,6488,-88,6400,6400,6397,6314,83,6314
6254,7262,7381,7397,-16,7381,7262,7379,7272,107,7262
6255,12166,12549,12167,382,12167,12166,12541,11966,575,11966
6256,12273,12220,12116,104,12116,12116,12226,11908,318,11908
6257,60831,60063,56618,3445,56618,56618,60028,56469,3559,56469
6258,67160,67143,63944,3199,63944,63944,67160,63837,3323,63837
6259,48564,50002,48490,1512,48490,48490,50005,48245,1760,48245
6260,4711,4329,4607,-278,4329,4329,4328,4382,-54,4382
6261,9883,8855,9317,-462,8855,8855,8852,8881,-29,8881
6262,99190,98363,93941,4422,93941,93941,98363,93520,4843,93520
6263,100533,104913,100533,4380,100533,100533,104906,100114,4792,100114
6264,98788,106287,98714,7573,98714,98714,106256,98303,7953,98303
6265,2730,2731,3001,-270,2731,2730,2730,2786,-56,2730
6266,22901,22134,20913,1221,20913,20913,22119,20816,1303,20816
6267,142550,136931,128692,8239,128692,128692,136937,126687,10250,126687
6268,55228,55052,54681,371,54681,54681,55066,54123,943,54123
6269,9034,8605,8584,21,8584,8584,8603,8413,190,8413
6270,10627,11382,11173,209,11173,10627,11383,10627,756,10627
6271,37146,37132,35241,1891,35241,35241,37146,34953,2193,34953
6272,3075,2738,2804,-66,2738,2738,2738,2684,54,2684
6273,40245,34039,33747,292,33747,33747,34082,33294,788,33294
6274,176319,175963,167850,8113,167850,167850,175845,167764,8081,167764
6275,2389,2327,2527,-200,2327,2327,2328,2343,-15,2343
6276,5975,5582,5678,-96,5582,5582,5578,5500,78,5500
6277,12718,12623,12721,-98,12623,12623,12621,12445,176,12445
6278,2841,2689,2838,-149,2689,2689,2688,2711,-23,2711
6279,29752,28931,27505,1426,27505,27505,28913,27145,1768,27145
6280,134950,131799,129942,1857,129942,129942,131788,129376,2412,129376
6281,4102,4085,4388,-303,4085,4085,4085,4156,-71,4102
6282,46020,50952,47814,3138,47814,46020,50959,45398,5561,45398
6283,50591,52434,50498,1936,50498,50498,52486,50102,2384,50102
6284,5974,5974,6029,-55,5974,5974,5974,5846,128,5846
6285,1358371,1026615,1005769,20846,1005769,1005769,1026524,994334,32190,994334
6286,11357,10846,10566,280,10566,10566,10851,10445,406,10445
6287,6648,6293,6395,-102,6293,6293,6292,6236,56,6236
6288,81217,64708,64716,-8,64708,64708,64737,63876,861,63876
6289,3156,2872,3095,-223,2872,2872,2872,2814,58,2814
6290,17879,17055,16173,882,16173,16173,17063,16048,1015,16048
6291,39347,39339,38021,1318,38021,38021,39341,37666,1675,37666
6292,19489,12390,12463,-73,12390,12390,12392,12218,174,12218
6293,19790,16793,17220,-427,16793,16793,16795,16341,454,16341
6294,5252,5256,5290,-34,5256,5252,5252,5107,145,5107
6295,19012,18104,17492,612,17492,17492,18113,17464,649,17464
6296,3375,3378,3538,-160,3378,3375,3375,3380,-5,3375
6297,157241,157172,150418,6754,150418,150418,157207,149597,7610,149597
6298,13974,16075,15930,145,15930,13974,16083,13448,2635,13448
6299,21048,21319,21623,-304,21319,21048,21330,20426,904,20426
6300,243486,221864,210646,11218,210646,210646,221719,208321,13398,208321
6301,4827,4813,4933,-120,4813,4813,4813,4778,35,4778
6302,14173,13470,13086,384,13086,13086,13477,12959,518,12959
6303,27608,26420,25075,1345,25075,25075,26433,24426,2007,24426
6304,193698,186987,174212,12775,174212,174212,186905,173934,12971,173934
6305,49672,49649,48892,757,48892,48892,49672,48506,1166,48506
6306,14277,7420,7270,150,7270,7270,7415,7145,270,7145
6307,73682,69395,67557,1838,67557,67557,69416,67437,1979,67437
6308,3821,3376,3601,-225,3376,3376,3376,3410,-34,3410
6309,21680,22759,21674,1085,21674,21674,22759,21632,1127,21632
6310,211572,216064,215845,219,215845,211572,216130,210950,5180,210950
6311,266996,240303,223251,17052,223251,223251,240309,219019,21290,219019
6312,37703,37647,37140,507,37140,37140,37648,36770,878,36770
6313,105754,105727,100763,4964,100763,100763,105754,100533,5221,100533
6314,67084,49096,47019,2077,47019,47019,49118,46487,2631,46487
6315,154920,155248,148133,7115,148133,148133,155220,147090,8130,147090
6316,3985,3441,3659,-218,3441,3441,3441,3333,108,3333
6317,132976,129737,128919,818,128919,128919,129783,121856,7927,121856
6318,102656,105657,100558,5099,100558,100558,105638,99644,5994,99644
6319,96694,95771,92745,3026,92745,92745,95778,91446,4332,91446
6320,8140,7464,7455,9,7455,7455,7467,7190,277,7190
6321,13058,13666,13210,456,13210,13058,13675,13025,650,13025
6322,62232,47573,46335,1238,46335,46335,47584,45209,2375,45209
6323,52275,49825,50371,-546,49825,49825,49835,49251,584,49251
6324,87110,87099,84905,2194,84905,84905,87110,84566,2544,84566
6325,4939,4468,4593,-125,4468,4468,4467,4335,132,4335
6326,30276,16352,16239,113,16239,16239,16351,15951,400,15951
6327,366357,358794,341583,17211,341583,341583,358961,334712,24249,334712
6328,53814,51622,49618,2004,49618,49618,51632,44970,6662,44970
6329,2713,2347,2534,-187,2347,2347,2346,2381,-35,2381
6330,63276,57699,53545,4154,53545,53545,57702,52994,4708,52994
6331,9642,9635,9588,47,9588,9588,9642,9430,212,9430
6332,13840,10670,10448,222,10448,10448,10678,10381,297,10381
6333,160064,157526,152133,5393,152133,152133,157544,150376,7168,150376
6334,5964,5652,5711,-59,5652,5652,5649,5579,70,5579
6335,64189,61991,60764,1227,60764,60764,62050,60776,1274,60776
6336,23301,24160,23244,916,23244,23244,24164,22732,1432,22732
6337,32857,33754,32793,961,32793,32793,33759,32698,1061,32698
6338,14175,13677,13258,419,13258,13258,13677,13142,535,13142
6339,42178,41614,39536,2078,39536,39536,41632,39423,2209,39423
6340,203416,198942,192033,6909,192033,192033,199014,191377,7637,191377
6341,76402,76382,74572,1810,74572,74572,76402,74300,2102,74300
6342,10764,10351,10323,28,10323,10323,10354,10041,313,10041
6343,3523,3519,3668,-149,3519,3519,3520,3536,-16,3523
6344,9396,8891,8755,136,8755,8755,8887,8573,314,8573
6345,4632,4263,4388,-125,4263,4263,4263,4240,23,4240
6346,66132,65177,63872,1305,63872,63872,65179,63467,1712,63467
6347,38431,32877,32651,226,32651,32651,32894,32424,470,32424
6348,38060,37109,35754,1355,35754,35754,37092,35676,1416,35676
6349,40909,42155,40909,1246,40909,40909,42175,40565,1610,40565
6350,17605,16724,16213,511,16213,16213,16726,15993,733,15993
6351,93263,72809,71454,1355,71454,71454,72821,70401,2420,70401
6352,425122,398774,377896,20878,377896,377896,398891,374173,24718,374173
6353,29596,27258,27206,52,27206,27206,27273,26408,865,26408
6354,55264,57592,60198,-2606,57592,55264,57574,55231,2343,55231
6355,240079,174101,168433,5668,168433,168433,174108,167870,6238,167870
6356,17130,17736,17063,673,17063,17063,17746,16987,759,16987
6357,2766,2675,2832,-157,2675,2675,2676,2686,-10,2686
6358,116247,116279,110695,5584,110695,110695,116247,110349,5898,110349
6359,16348,16377,15663,714,15663,15663,16366,15655,711,15655
6360,69268,36187,35994,193,35994,35994,36188,35575,613,35575
6361,477542,444067,427596,16471,427596,427596,444142,423742,20400,423742
6362,44370,43804,42451,1353,42451,42451,43812,42344,1468,42344
6363,4565,3781,3898,-117,3781,3781,3782,3747,35,3747
6364,19074,18143,17922,221,17922,17922,18134,17695,439,17695
6365,5328,5328,5366,-38,5328,5328,5328,5206,122,5206
6366,228422,209009,205605,3404,205605,205605,209049,202956,6093,202956
6367,7870,7745,7809,-64,7745,7745,7751,7598,153,7598
6368,103089,100605,95639,4966,95639,95639,100602,95003,5599,95003
6369,13613,12970,12635,335,12635,12635,12973,12603,370,12603
6370,526138,554031,525423,28608,525423,525423,554015,519742,34273,519742
6371,35907,35907,35489,418,35489,35489,35915,34800,1115,34800
6372,13410,14031,13487,544,13487,13410,14040,12788,1252,12788
6373,1785608,1769867,1703162,66705,1703162,1703162,1770227,1689913,80314,1689913
6374,4985,4631,4733,-102,4631,4631,4631,4578,53,4578
6375,103241,102675,97011,5664,97011,97011,102687,96517,6170,96517
6376,63356,62572,61083,1489,61083,61083,62555,60537,2018,60537
6377,56351,60440,58583,1857,58583,56351,60456,56573,3883,56351
6378,9828,10053,9767,286,9767,9767,10054,9402,652,9402
6379,109964,91374,88572,2802,88572,88572,91349,87498,3851,87498
6380,139579,114114,110731,3383,110731,110731,114082,110090,3992,110090
6381,32139,31586,30188,1398,30188,30188,31585,30146,1439,30146
6382,40006,44137,43092,1045,43092,40006,44138,39384,4754,39384
6383,256649,237300,227441,9859,227441,227441,237333,225249,12084,225249
6384,29066,29069,28078,991,28078,28078,29066,27889,1177,27889
6385,24969,22862,22984,-122,22862,22862,22864,22390,474,22390
6386,53759,50736,48498,2238,48498,48498,50722,48297,2425,48297
6387,26871,26330,25783,547,25783,25783,26322,25584,738,25584
6388,116086,119867,116030,3837,116030,116030,119840,115419,4421,115419
6389,55107,53882,51643,2239,51643,51643,53875,51554,2321,51554
6390,52324,51142,50066,1076,50066,50066,51163,48828,2335,48828
6391,227778,199621,196242,3379,196242,196242,199598,192611,6987,192611
6392,5647,10863,11105,-242,10863,5647,10863,5625,5238,5625
6393,12610,12591,12569,22,12569,12569,12592,12353,239,12353
6394,20278,18969,19155,-186,18969,18969,18975,18495,480,18495
6395,11909,11770,12568,-798,11770,11770,11777,11891,-114,11891
6396,76444,75278,74323,955,74323,74323,75290,73255,2035,73255
6397,71917,69511,66508,3003,66508,66508,69507,66465,3042,66465
6398,6826,6329,6276,53,6276,6276,6333,6228,105,6228
6399,683,701,936,-235,701,683,701,740,-39,683
6400,370535,352809,332708,20101,332708,332708,352714,330437,22277,330437
6401,13188,12889,13172,-283,12889,12889,12893,12566,327,12566
6402,180245,147161,135412,11749,135412,135412,147101,134907,12194,134907
6403,3975,3983,4118,-135,3983,3975,3985,3975,10,3975
6404,102759,102721,96711,6010,96711,96711,102759,96195,6564,96195
6405,30184,31144,30100,1044,30100,30100,31156,29806,1350,29806
6406,15985,16576,16000,576,16000,15985,16572,15970,602,15970
6407,25209,24545,23758,787,23758,23758,24530,23406,1124,23406
6408,32962,32371,31771,600,31771,31771,32369,31531,838,31531
6409,225687,196169,186009,10160,186009,186009,196223,184179,12044,184179
6410,16870,14904,14937,-33,14904,14904,14911,14707,204,14707
6411,37362,36520,35123,1397,35123,35123,36522,34952,1570,34952
6412,19693,19689,19107,582,19107,19107,19693,18995,698,18995
6413,25283,24357,24016,341,24016,24016,24357,23654,703,23654
6414,89974,89422,88380,1042,88380,88380,89432,87611,1821,87611
6415,126016,119935,115273,4662,115273,115273,119859,114850,5009,114850
6416,9071,9062,8917,145,8917,8917,9071,8819,252,8819
6417,67480,58778,56687,2091,56687,56687,58754,56615,2139,56615
6418,5038,3944,4210,-266,3944,3944,3947,4014,-67,4014
6419,174133,175603,177724,-2121,175603,174133,175655,174125,1530,174125
6420,81050,68999,66191,2808,66191,66191,69018,65185,3833,65185
6421,117733,91768,91426,342,91426,91426,91775,89754,2021,89754
6422,4182,4203,4231,-28,4203,4182,4200,3600,600,3600
6423,67287,70599,67092,3507,67092,67092,70588,66665,3923,66665
6424,56609,55861,55257,604,55257,55257,55861,53014,2847,53014
6425,93408,93297,91589,1708,91589,91589,93321,90896,2425,90896
6426,108340,108407,104137,4270,104137,104137,108340,103514,4826,103514
6427,14002,7498,7366,132,7366,7366,7500,7005,495,7005
6428,185528,177900,166204,11696,166204,166204,177857,165365,12492,165365
6429,10099,9469,9376,93,9376,9376,9470,9259,211,9259
6430,32876,31425,30246,1179,30246,30246,31433,30160,1273,30160
6431,14418,13504,13295,209,13295,13295,13497,13165,332,13165
6432,75774,74833,72244,2589,72244,72244,74831,70512,4319,70512
6433,55904,55895,52158,3737,52158,52158,55904,51666,4238,51666
6434,30571,30521,29990,531,29990,29990,30542,29723,819,29723
6435,11041,10783,10677,106,10677,10677,10781,10419,362,10419
6436,66886,62467,59902,2565,59902,59902,62444,57747,4697,57747
6437,26610,27252,27922,-670,27252,26610,27262,26577,685,26577
6438,8835,8467,8570,-103,8467,8467,8470,8399,71,8399
6439,12129,12133,12117,16,12117,12117,12129,11934,195,11934
6440,17513,16963,16560,403,16560,16560,16960,16306,654,16306
6441,5325,1637,1823,-186,1637,1637,1636,1660,-24,1660
6442,139695,147289,139610,7679,139610,139610,147369,136900,10469,136900
6443,98190,94514,94548,-34,94514,94514,94522,93082,1440,93082
6444,56473,54724,52935,1789,52935,52935,54723,52730,1993,52730
6445,4978,4484,4586,-102,4484,4484,4483,4356,127,4356
6446,40246,35758,34239,1519,34239,34239,35768,33259,2509,33259
6447,8799,8798,9031,-233,8798,8798,8805,8399,406,8399
6448,75730,79667,75733,3934,75733,75730,79704,75030,4674,75030
6449,15571,15562,15224,338,15224,15224,15566,15077,489,15077
6450,5836,5806,5914,-108,5806,5806,5806,5748,58,5748
6451,19585,19162,18960,202,18960,18960,19157,18753,404,18753
6452,74117,73182,69375,3807,69375,69375,73222,69151,4071,69151
6453,178966,166474,161349,5125,161349,161349,166450,157419,9031,157419
6454,31759,12738,12752,-14,12738,12738,12738,12228,510,12228
6455,490817,492458,468444,24014,468444,468444,492425,463406,29019,463406
6456,22591,18946,19064,-118,18946,18946,18943,18659,284,18659
6457,83898,83025,81455,1570,81455,81455,83001,80715,2286,80715
6458,707,707,940,-233,707,707,707,750,-43,707
6459,5690,5310,5210,100,5210,5210,5314,5056,258,5056
6460,707,707,940,-233,707,707,707,750,-43,707
6461,221627,221478,211119,10359,211119,211119,221627,210781,10846,210781
6462,38303,38293,36676,1617,36676,36676,38303,36393,1910,36393
6463,26940,11992,11893,99,11893,11893,11992,11502,490,11502
6464,19259,6035,6258,-223,6035,6035,6032,5768,264,5768
6465,34636,34458,34943,-485,34458,34458,34462,34014,448,34014
6466,8782,7849,8050,-201,7849,7849,7854,7836,18,7836
6467,5593,5273,5380,-107,5273,5273,5274,5204,70,5204
6468,267818,280114,267818,12296,267818,267818,280187,263613,16574,263613
6469,152818,160888,152802,8086,152802,152802,160837,152338,8499,152338
6470,49041,50647,49110,1537,49110,49041,50674,48213,2461,48213
6471,142035,140617,133057,7560,133057,133057,140584,132042,8542,132042
6472,8818,8246,8049,197,8049,8049,8242,7995,247,7995
6473,40203,42937,41804,1133,41804,40203,42934,40195,2739,40195
6474,13678,13231,12878,353,12878,12878,13228,12778,450,12778
6475,7230,6522,6853,-331,6522,6522,6528,6525,3,6525
6476,19508,19386,19494,-108,19386,19386,19391,19117,274,19117
6477,7372,6819,6938,-119,6819,6819,6818,6692,126,6692
6478,42680,42113,40148,1965,40148,40148,42101,40044,2057,40044
6479,31234,30616,29796,820,29796,29796,30613,25361,5252,25361
6480,23642,22629,22861,-232,22629,22629,22624,22496,128,22496
6481,11536,11139,10833,306,10833,10833,11129,10720,409,10720
6482,19181,19185,18748,437,18748,18748,19181,18607,574,18607
6483,6977,6977,6975,2,6975,6975,6982,6840,142,6840
6484,873345,814984,770738,44246,770738,770738,814726,764376,50350,764376
6485,21860,21069,19783,1286,19783,19783,21074,19437,1637,19437
6486,15907,15919,15487,432,15487,15487,15907,15315,592,15315
6487,2169,2168,2413,-245,2168,2168,2169,2175,-6,2169
6488,41709,36319,35088,1231,35088,35088,36317,34602,1715,34602
6489,130376,120679,116287,4392,116287,116287,120690,114836,5854,114836
6490,99985,99442,93283,6159,93283,93283,99431,92027,7404,92027
6491,103939,103418,99708,3710,99708,99708,103385,98534,4851,98534
6492,254542,223865,210060,13805,210060,210060,223832,208851,14981,208851
6493,354729,348058,327481,20577,327481,327481,347983,326617,21366,326617
6494,602,452,579,-127,452,452,453,464,-11,464
6495,37478,37492,36017,1475,36017,36017,37507,35533,1974,35533
6496,120068,118614,114674,3940,114674,114674,118694,114403,4291,114403
6497,3259,2771,2898,-127,2771,2771,2771,2777,-6,2777
6498,13160,12614,12495,119,12495,12495,12612,12440,172,12440
6499,42752,42420,40885,1535,40885,40885,42431,40336,2095,40336
6500,78748,83476,80166,3310,80166,78748,83514,78666,4848,78666
6501,23806,22354,21015,1339,21015,21015,22376,20107,2269,20107
6502,6165,6167,6255,-88,6167,6165,6165,6098,67,6098
6503,2873793,2823800,2748889,74911,2748889,2748889,2825690,2698265,127425,2698265
6504,15930,15396,14894,502,14894,14894,15397,14727,670,14727
6505,52517,46047,44833,1214,44833,44833,46050,44377,1673,44377
6506,145156,113092,108655,4437,108655,108655,113084,106127,6957,106127
6507,92924,88338,84012,4326,84012,84012,88322,83780,4542,83780
6508,9101,9097,9481,-384,9097,9097,9101,9149,-48,9101
6509,115842,119143,114882,4261,114882,114882,119144,113109,6035,113109
6510,169455,175632,168834,6798,168834,168834,175706,166223,9483,166223
6511,33321,29253,28677,576,28677,28677,29242,27830,1412,27830
6512,101812,99670,96193,3477,96193,96193,99629,96129,3500,96129
6513,122243,100898,101673,-775,100898,100898,100941,99104,1837,99104
6514,435043,458584,442400,16184,442400,435043,458629,434971,23658,434971
6515,54649,53573,50599,2974,50599,50599,53575,50309,3266,50309
6516,139561,144158,139544,4614,139544,139544,144152,138962,5190,138962
6517,8190,8196,8138,58,8138,8138,8190,8009,181,8009
6518,3915,3913,3969,-56,3913,3913,3915,3824,91,3824
6519,45308,15591,15231,360,15231,15231,15593,15089,504,15089
6520,85277,82126,77090,5036,77090,77090,82115,75980,6135,75980
6521,112148,116377,114307,2070,114307,112148,116422,112148,4274,112148
6522,15316,14863,14459,404,14459,14459,14870,14283,587,14283
6523,9305,9225,9307,-82,9225,9225,9225,9045,180,9045
6524,32959,32361,31577,784,31577,31577,32373,31163,1210,31163
6525,169392,174832,168523,6309,168523,168523,174795,167672,7123,167672
6526,18524,16994,16131,863,16131,16131,17002,16049,953,16049
6527,7837,7297,7026,271,7026,7026,7295,6375,920,6375
6528,17853,18383,17794,589,17794,17794,18391,17702,689,17702
6529,8323,7818,7962,-144,7818,7818,7821,7782,39,7782
6530,11041,10620,10610,10,10610,10610,10624,10383,241,10383
6531,45361,44768,43847,921,43847,43847,44783,42726,2057,42726
6532,44177,40784,40976,-192,40784,40784,40795,40556,239,40556
6533,63594,18552,17765,787,17765,17765,18560,17672,888,17672
6534,197241,197266,191609,5657,191609,191609,197249,189765,7484,189765
6535,37073,38504,37080,1424,37080,37073,38512,36443,2069,36443
6536,22405,23453,23068,385,23068,22405,23456,22513,943,22405
6537,45005,45003,44156,847,44156,44156,45005,43859,1146,43859
6538,9210,9216,9086,130,9086,9086,9210,8967,243,8967
6539,20270,19719,19532,187,19532,19532,19716,18868,848,18868
6540,159302,167881,161932,5949,161932,159302,167925,159294,8631,159294
6541,18802,18458,18327,131,18327,18327,18459,18260,199,18260
6542,118959,114517,112402,2115,112402,112402,114491,111440,3051,111440
6543,16604,17071,16605,466,16605,16604,17070,16438,632,16438
6544,20514,20456,20866,-410,20456,20456,20464,19722,742,19722
6545,26208,26754,26203,551,26203,26203,26749,26057,692,26057
6546,50118,25959,25796,163,25796,25796,25968,25125,843,25125
6547,21531,22624,21532,1092,21532,21531,22614,21424,1190,21424
6548,6542,6565,6548,17,6548,6542,6569,6313,256,6313
6549,20011,19153,18888,265,18888,18888,19150,18692,458,18692
6550,106621,106687,104171,2516,104171,104171,106621,103627,2994,103627
6551,120420,119656,120420,-764,119656,119656,119710,117480,2230,117480
6552,64063,63990,62223,1767,62223,62223,64002,61803,2199,61803
6553,175891,158085,147812,10273,147812,147812,158160,147098,11062,147098
6554,111471,111468,106167,5301,106167,106167,111421,105709,5712,105709
6555,203663,208701,203558,5143,203558,203558,208665,203123,5542,203123
6556,81632,81089,78539,2550,78539,78539,81090,74674,6416,74674
6557,12862,13090,12859,231,12859,12859,13090,12633,457,12633
6558,87164,89129,87118,2011,87118,87118,89158,86912,2246,86912
6559,19984,19367,18797,570,18797,18797,19363,18688,675,18688
6560,67470,66428,64308,2120,64308,64308,66452,63859,2593,63859
6561,7386,5941,5809,132,5809,5809,5932,5700,232,5700
6562,39701,38981,37786,1195,37786,37786,38983,37663,1320,37663
6563,92063,94327,98065,-3738,94327,92063,94332,92055,2277,92055
6564,73855,3926,4229,-303,3926,3926,3925,3983,-58,3983
6565,65225,65213,63378,1835,63378,63378,65225,62753,2472,62753
6566,2787,2393,2574,-181,2393,2393,2392,2415,-23,2415
6567,1764,1769,2025,-256,1769,1764,1769,1790,-21,1764
6568,368595,392067,368038,24029,368038,368038,392166,366602,25564,366602
6569,50345,50333,49972,361,49972,49972,50345,49307,1038,49307
6570,4899,4511,4479,32,4479,4479,4511,4360,151,4360
6571,19657,19649,19812,-163,19649,19649,19657,19344,313,19344
6572,476949,505827,476949,28878,476949,476949,505860,472998,32862,472998
6573,9725,9710,9666,44,9666,9666,9714,9321,393,9321
6574,32502,32508,32017,491,32017,32017,32502,31776,726,31776
6575,30218,31518,30211,1307,30211,30211,31529,29961,1568,29961
6576,72219,70876,69187,1689,69187,69187,70910,68411,2499,68411
6577,58136,55962,52502,3460,52502,52502,55948,52244,3704,52244
6578,67429,67394,66065,1329,66065,66065,67406,64699,2707,64699
6579,110633,71498,67060,4438,67060,67060,71551,66911,4640,66911
6580,12730,12746,12514,232,12514,12514,12748,12375,373,12375
6581,59440,41178,40228,950,40228,40228,41175,34460,6715,34460
6582,60282,57106,55681,1425,55681,55681,57120,55572,1548,55572
6583,18063,17604,17394,210,17394,17394,17600,17183,417,17183
6584,43325,43327,41775,1552,41775,41775,43325,41622,1703,41622
6585,23402,24308,23335,973,23335,23335,24319,23056,1263,23056
6586,49235,48048,46694,1354,46694,46694,48034,46541,1493,46541
6587,347501,339079,319551,19528,319551,319551,339098,319012,20086,319012
6588,84957,87854,84413,3441,84413,84413,87880,81570,6310,81570
6589,15512,15499,15210,289,15210,15210,15512,14574,938,14574
6590,214677,207535,197751,9784,197751,197751,207469,196015,11454,196015
6591,24284,25296,24216,1080,24216,24216,25297,23974,1323,23974
6592,132509,131591,124922,6669,124922,124922,131672,122421,9251,122421
6593,3216,2810,2931,-121,2810,2810,2810,2787,23,2787
6594,17179,17178,16690,488,16690,16690,17179,16581,598,16581
6595,152449,149352,141394,7958,141394,141394,149287,139318,9969,139318
6596,5846,5466,5460,6,5460,5460,5470,5329,141,5329
6597,7599,7072,6969,103,6969,6969,7077,6878,199,6878
6598,30978,32503,31140,1363,31140,30978,32504,30978,1526,30978
6599,9733,9736,9723,13,9723,9723,9733,9544,189,9544
6600,57469,59919,57452,2467,57452,57452,59924,56881,3043,56881
6601,2473960,2472811,2425190,47621,2425190,2425190,2473638,2391020,82618,2391020
6602,178139,172345,160750,11595,160750,160750,172292,160065,12227,160065
6603,73758,54994,51005,3989,51005,51005,54987,49408,5579,49408
6604,33654,29819,28823,996,28823,28823,29817,28637,1180,28637
6605,27540,26587,25616,971,25616,25616,26577,24965,1612,24965
6606,559,559,812,-253,559,559,559,602,-43,559
6607,240515,233040,223855,9185,223855,223855,232958,220233,12725,220233
6608,167671,105351,102253,3098,102253,102253,105326,101503,3823,101503
6609,80852,63779,61642,2137,61642,61642,63763,61487,2276,61487
6610,13355,13545,13521,24,13521,13355,13542,13355,187,13355
6611,11030,10620,10602,18,10602,10602,10616,10383,233,10383
6612,91445,91399,93988,-2589,91399,91399,91413,90858,555,90858
6613,4925,1428,1653,-225,1428,1428,1428,1481,-53,1481
6614,340,321,562,-241,321,321,321,368,-47,340
6615,10663,10662,10551,111,10551,10551,10663,10336,327,10336
6616,8380583,8462372,8357178,105194,8357178,8357178,8467319,8239336,227983,8239336
6617,77748,77746,76367,1379,76367,76367,77748,75848,1900,75848
6618,93118,91530,87638,3892,87638,87638,91542,87312,4230,87312
6619,324548,304899,285658,19241,285658,285658,304966,282474,22492,282474
6620,2121,2615,2857,-242,2615,2121,2615,1499,1116,1499
6621,6157,5313,5389,-76,5313,5313,5312,5063,249,5063
6622,31278,30161,30529,-368,30161,30161,30173,29700,473,29700
6623,197377,185144,173922,11222,173922,173922,185185,172198,12987,172198
6624,125386,125256,118562,6694,118562,118562,125192,118249,6943,118249
6625,9494,8668,8073,595,8073,8073,8670,7671,999,7671
6626,643890,637998,626835,11163,626835,626835,638286,624621,13665,624621
6627,146402,146449,138107,8342,138107,138107,146402,137883,8519,137883
6628,75041,48010,47400,610,47400,47400,48019,47227,792,47227
6629,2478,2479,2736,-257,2479,2478,2478,2540,-62,2478
6630,55240,56750,55245,1505,55245,55240,56760,54227,2533,54227
6631,4605,4439,4545,-106,4439,4439,4441,4331,110,4331
6632,22463,22456,21722,734,21722,21722,22463,21556,907,21556
6633,13241,12272,12117,155,12117,12117,12276,11968,308,11968
6634,19548,19540,19334,206,19334,19334,19548,19027,521,19027
6635,47837,47828,46758,1070,46758,46758,47837,46404,1433,46404
6636,120862,120826,120611,215,120611,120611,120862,117322,3540,117322
6637,5503,5405,5503,-98,5405,5405,5406,5160,246,5160
6638,11524,505,757,-252,505,505,505,552,-47,552
6639,100387,87957,86181,1776,86181,86181,87966,85584,2382,85584
6640,14784,14921,14720,201,14720,14720,14931,14567,364,14567
6641,8766,8805,8768,37,8768,8766,8806,8656,150,8656
6642,10904,10902,10752,150,10752,10752,10904,10594,310,10594
6643,12300,11456,11511,-55,11456,11456,11460,11229,231,11229
6644,9587,9675,9522,153,9522,9522,9680,9133,547,9133
6645,20691,21336,20693,643,20693,20691,21332,20654,678,20654
6646,86748,88364,87380,984,87380,86748,88356,86740,1616,86740
6647,27753,27244,26256,988,26256,26256,27251,26027,1224,26027
6648,10967,10960,11067,-107,10960,10960,10967,10877,90,10877
6649,1632,1417,1632,-215,1417,1417,1417,1368,49,1368
6650,93136,95605,93571,2034,93571,93136,95633,93128,2505,93128
6651,22567,22565,21447,1118,21447,21447,22567,20382,2185,20382
6652,649431,638699,631132,7567,631132,631132,638581,617151,21430,617151
6653,119976,119925,116892,3033,116892,116892,119915,116055,3860,116055
6654,206709,187690,178558,9132,178558,178558,187715,177112,10603,177112
6655,39306,41346,39295,2051,39295,39295,41310,39238,2072,39238
6656,420755,419927,422259,-2332,419927,419927,420201,412182,8019,412182
6657,5160,4798,4884,-86,4798,4798,4802,4757,45,4757
6658,482036,468536,443679,24857,443679,443679,468507,440765,27742,440765
6659,12774,12166,11951,215,11951,11951,12167,11592,575,11592
6660,60465,59643,58172,1471,58172,58172,59652,57880,1772,57880
6661,19586,19592,19063,529,19063,19063,19586,18932,654,18932
6662,31114,31093,30048,1045,30048,30048,31114,29990,1124,29990
6663,1422,997,1214,-217,997,997,997,1004,-7,1004
6664,8720,8719,8566,153,8566,8566,8720,8197,523,8197
6665,36636,37255,36626,629,36626,36626,37299,36249,1050,36249
6666,213372,195753,188351,7402,188351,188351,195873,187500,8373,187500
6667,204460,197083,196721,362,196721,196721,197096,194423,2673,194423
6668,402162,413321,401700,11621,401700,401700,413273,397150,16123,397150
6669,557876,557643,551089,6554,551089,551089,557876,542444,15432,542444
6670,54280,26272,25182,1090,25182,25182,26277,25107,1170,25107
6671,61782,64163,61768,2395,61768,61768,64140,61640,2500,61640
6672,13085,13438,13087,351,13087,13085,13446,12978,468,12978
6673,46734,22483,22345,138,22345,22345,22490,22233,257,22233
6674,103839,83423,81956,1467,81956,81956,83445,81661,1784,81661
6675,25273,25763,25421,342,25421,25273,25766,25229,537,25229
6676,17360,16789,16232,557,16232,16232,16806,15923,883,15923
6677,131182,94614,93501,1113,93501,93501,94672,91526,3146,91526
6678,26495,22779,22545,234,22545,22545,22787,22188,599,22188
6679,7114,7173,7046,127,7046,7046,7168,6704,464,6704
6680,2195,1343,1591,-248,1343,1343,1342,1408,-66,1408
6681,5794803,5054612,4974771,79841,4974771,4974771,5055085,4882297,172788,4882297
6682,178204,175045,173637,1408,173637,173637,175069,171491,3578,171491
6683,42875,41957,40460,1497,40460,40460,41961,40248,1713,40248
6684,71884,71896,69654,2242,69654,69654,71884,69443,2441,69443
6685,11511,8343,8285,58,8285,8285,8349,8147,202,8147
6686,1275,900,1128,-228,900,900,900,953,-53,953
6687,51366,52748,51357,1391,51357,51357,52750,51034,1716,51034
6688,1265,915,1152,-237,915,915,914,978,-64,978
6689,9768,8926,9093,-167,8926,8926,8923,8887,36,8887
6690,5538,5541,5666,-125,5541,5538,5538,5510,28,5510
6691,258297,255853,238173,17680,238173,238173,255994,237732,18262,237732
6692,23880,7949,7955,-6,7949,7949,7948,7815,133,7815
6693,28337,29371,28337,1034,28337,28337,29376,28029,1347,28029
6694,34137,33110,31976,1134,31976,31976,33117,31109,2008,31109
6695,68496,64605,62991,1614,62991,62991,64596,61898,2698,61898
6696,13630,13624,13603,21,13603,13603,13635,13086,549,13086
6697,3406,3213,3345,-132,3213,3213,3212,3203,9,3203
6698,1618,1619,1844,-225,1619,1618,1618,1674,-56,1618
6699,132589,129811,121394,8417,121394,121394,129756,120909,8847,120909
6700,109673,82712,79703,3009,79703,79703,82729,79481,3248,79481
6701,3107,3105,3251,-146,3105,3105,3107,2531,576,2531
6702,15977,15978,15728,250,15728,15728,15977,15607,370,15607
6703,13979,14256,13973,283,13973,13973,14262,13767,495,13767
6704,12253,12219,12254,-35,12219,12219,12224,12056,168,12056
6705,104666,104598,104008,590,104008,104008,104597,102467,2130,102467
6706,20019,20023,19905,118,19905,19905,20019,19635,384,19635
6707,172949,207076,198841,8235,198841,172949,207090,170469,36621,170469
6708,99541,95805,91902,3903,91902,91902,95790,90547,5243,90547
6709,15180,15173,15065,108,15065,15065,15180,14831,349,14831
6710,5672,5670,5589,81,5589,5589,5672,5421,251,5421
6711,70262,65208,62688,2520,62688,62688,65239,61679,3560,61679
6712,31727,30821,30862,-41,30821,30821,30840,30441,399,30441
6713,89459,81508,79733,1775,79733,79733,81478,79301,2177,79301
6714,131220,135955,131586,4369,131586,131220,135965,131147,4818,131147
6715,19915,20169,19418,751,19418,19418,20158,19293,865,19293
6716,6099,5739,5884,-145,5739,5739,5736,5715,21,5715
6717,6739,6276,6300,-24,6276,6276,6278,6181,97,6181
6718,739821,726468,730563,-4095,726468,726468,726818,687765,39053,687765
6719,44387,42150,40634,1516,40634,40634,42152,40328,1824,40328
6720,24757,23480,24754,-1274,23480,23480,23488,23532,-44,23532
6721,97136,91687,85068,6619,85068,85068,91632,84372,7260,84372
6722,47281,46571,46467,104,46467,46467,46589,45978,611,45978
6723,15085,15083,14828,255,14828,14828,15085,14612,473,14612
6724,18769,18204,17969,235,17969,17969,18203,17751,452,17751
6725,13334,13504,13267,237,13267,13267,13506,13002,504,13002
6726,42979,28730,27893,837,27893,27893,28718,27520,1198,27520
6727,23861,23162,22143,1019,22143,22143,23157,21902,1255,21902
6728,17217,17219,16830,389,16830,16830,17217,16698,519,16698
6729,27766,26920,26458,462,26458,26458,26930,26326,604,26326
6730,8636,8741,8633,108,8633,8633,8746,8464,282,8464
6731,108043,114544,108023,6521,108023,108023,114486,107616,6870,107616
6732,77101,78172,77200,972,77200,77101,78189,76607,1582,76607
6733,44051,44022,43600,422,43600,43600,44051,43489,562,43489
6734,20345,19981,20207,-226,19981,19981,19988,19723,265,19723
6735,122715,125987,125347,640,125347,122715,126042,123555,2487,122715
6736,7628,7441,7624,-183,7441,7441,7443,7346,97,7346
6737,363187,353398,330255,23143,330255,330255,353561,329402,24159,329402
6738,30525,29580,28648,932,28648,28648,29606,26849,2757,26849
6739,98229,93194,89413,3781,89413,89413,93235,88112,5123,88112
6740,691745,609455,569021,40434,569021,569021,609162,548787,60375,548787
6741,1686,971,1211,-240,971,971,969,1019,-50,1019
6742,54299,53205,50517,2688,50517,50517,53215,50393,2822,50393
6743,110035,122296,115327,6969,115327,110035,122284,109493,12791,109493
6744,7521,7384,7406,-22,7384,7384,7385,7194,191,7194
6745,112550,110642,104793,5849,104793,104793,110626,104724,5902,104724
6746,28491,28470,27813,657,27813,27813,28462,21779,6683,21779
6747,37534,32335,31631,704,31631,31631,32352,31269,1083,31269
6748,7984,7985,7971,14,7971,7971,7984,7879,105,7879
6749,95286,93792,89306,4486,89306,89306,93797,89190,4607,89190
6750,23629,23758,23625,133,23625,23625,23767,23291,476,23291
6751,12801,12267,12449,-182,12267,12267,12268,12142,126,12142
6752,19395,18113,17536,577,17536,17536,18109,17445,664,17445
6753,3334,2760,2895,-135,2760,2760,2763,2677,86,2677
6754,18164,17328,16044,1284,16044,16044,17331,15759,1572,15759
6755,42289,41521,40629,892,40629,40629,41530,40235,1295,40235
6756,33306,32686,31543,1143,31543,31543,32694,31440,1254,31440
6757,103328,107588,103200,4388,103200,103200,107588,98444,9144,98444
6758,11102,11042,11038,4,11038,11038,11042,10848,194,10848
6759,8794,8732,8784,-52,8732,8732,8738,8172,566,8172
6760,4942,4943,4914,29,4914,4914,4942,4838,104,4838
6761,20155,19411,18810,601,18810,18810,19414,18618,796,18618
6762,11298,10782,10619,163,10619,10619,10780,10520,260,10520
6763,71279,71291,69492,1799,69492,69492,71297,68931,2366,68931
6764,35728,35100,33768,1332,33768,33768,35125,33641,1484,33641
6765,9084,9267,9085,182,9085,9084,9270,8990,280,8990
6766,27382,26272,25862,410,25862,25862,26283,25057,1226,25057
6767,5778,5157,5478,-321,5157,5157,5158,5198,-40,5198
6768,106035,89524,85658,3866,85658,85658,89548,85499,4049,85499
6769,42392,34817,35157,-340,34817,34817,34792,34199,593,34199
6770,62259,62497,60399,2098,60399,60399,62509,60243,2266,60243
6771,13820,13233,13047,186,13047,13047,13236,12845,391,12845
6772,15138,15255,15136,119,15136,15136,15265,14883,382,14883
6773,59824,59795,60004,-209,59795,59795,59824,59128,696,59128
6774,91457,86515,84267,2248,84267,84267,86477,83566,2911,83566
6775,183384,176841,172419,4422,172419,172419,176804,169502,7302,169502
6776,411552,377307,370673,6634,370673,370673,377504,366926,10578,366926
6777,111522,111436,113676,-2240,111436,111436,111479,111514,-35,111514
6778,66334,70933,67258,3675,67258,66334,70976,66900,4076,66334
6779,107813,94562,91398,3164,91398,91398,94566,90193,4373,90193
6780,4193,4104,4191,-87,4104,4104,4104,4053,51,4053
6781,19008,18393,18107,286,18107,18107,18389,17949,440,17949
6782,13900,13328,13014,314,13014,13014,13323,12923,400,12923
6783,296107,298279,284788,13491,284788,284788,298387,279463,18924,279463
6784,98477,98420,92181,6239,92181,92181,98467,91972,6495,91972
6785,36579,32958,31054,1904,31054,31054,32952,30622,2330,30622
6786,241312,235113,219860,15253,219860,219860,235213,219517,15696,219517
6787,8618,8212,8052,160,8052,8052,8204,7937,267,7937
6788,223378,234265,222361,11904,222361,222361,234247,219594,14653,219594
6789,1315450,1298742,1234768,63974,1234768,1234768,1299090,1228369,70721,1228369
6790,32365,32708,33179,-471,32708,32365,32724,32475,249,32365
6791,5401,4261,4425,-164,4261,4261,4267,4141,126,4141
6792,66049,33589,32636,953,32636,32636,33593,32217,1376,32217
6793,228554,239804,227944,11860,227944,227944,239864,227876,11988,227876
6794,11703,11150,11153,-3,11150,11150,11149,10837,312,10837
6795,46522,46536,44754,1782,44754,44754,46522,44469,2053,44469
6796,270415,270016,254568,15448,254568,254568,269861,253737,16124,253737
6797,200730,188261,180156,8105,180156,180156,188276,179037,9239,179037
6798,227356,223955,215464,8491,215464,215464,224036,214154,9882,214154
6799,29173,28570,27869,701,27869,27869,28566,27669,897,27669
6800,95655,100541,95589,4952,95589,95589,100603,95346,5257,95346
6801,290745,276075,253962,22113,253962,253962,276105,253610,22495,253610
6802,42036,41979,40660,1319,40660,40660,41989,40056,1933,40056
6803,16131,16120,15905,215,15905,15905,16131,15739,392,15739
6804,80232,77935,75638,2297,75638,75638,77937,75131,2806,75131
6805,1959,1960,2174,-214,1960,1959,1959,1990,-31,1959
6806,11461,11064,10811,253,10811,10811,11064,10693,371,10693
6807,80889,80883,75674,5209,75674,75674,80889,75044,5845,75044
6808,1226,809,1013,-204,809,809,809,829,-20,829
6809,23223,21079,20542,537,20542,20542,21075,20481,594,20481
6810,262507,272247,265377,6870,265377,262507,272383,262499,9884,262499
6811,111801,110903,107497,3406,107497,107497,110856,107013,3843,107013
6812,3900,3729,3899,-170,3729,3729,3729,3713,16,3713
6813,7674,7864,7671,193,7671,7671,7868,7325,543,7325
6814,164420,172302,165332,6970,165332,164420,172365,164316,8049,164316
6815,293790,293611,287590,6021,287590,287590,293808,285192,8616,285192
6816,12383,12765,12431,334,12431,12383,12762,12383,379,12383
6817,3733,3731,3976,-245,3731,3731,3733,3782,-49,3733
6818,93618,64673,64180,493,64180,64180,64688,63382,1306,63382
6819,17346,17350,16970,380,16970,16970,17346,16768,578,16768
6820,6385,6364,6343,21,6343,6343,6365,6270,95,6270
6821,44720,45616,44647,969,44647,44647,45592,44137,1455,44137
6822,240447,240389,234223,6166,234223,234223,240447,231085,9362,231085
6823,180741,159937,155392,4545,155392,155392,159969,153289,6680,153289
6824,12709,12830,12648,182,12648,12648,12823,12469,354,12469
6825,7326,7324,7073,251,7073,7073,7326,6783,543,6783
6826,33628,33997,33622,375,33622,33622,33994,33397,597,33397
6827,339,339,570,-231,339,339,339,385,-46,339
6828,5057,4529,4665,-136,4529,4529,4529,4464,65,4464
6829,23769,22564,21604,960,21604,21604,22580,21026,1554,21026
6830,15759,15747,15320,427,15320,15320,15759,15241,518,15241
6831,22397,22398,21401,997,21401,21401,22397,20161,2236,20161
6832,7417,6131,6155,-24,6131,6131,6133,5929,204,5929
6833,33320,32797,31331,1466,31331,31331,32811,31219,1592,31219
6834,19720,19178,18724,454,18724,18724,19180,18573,607,18573
6835,251374,259500,252249,7251,252249,251374,259491,250752,8739,250752
6836,39693,37927,35212,2715,35212,35212,37909,34866,3043,34866
6837,35736,35756,34420,1336,34420,34420,35754,34197,1557,34197
6838,77878,81179,78321,2858,78321,77878,81175,77878,3297,77878
6839,62851,61757,59939,1818,59939,59939,61723,59407,2316,59407
6840,102932,94693,90705,3988,90705,90705,94732,89419,5313,89419
6841,213771,213627,202420,11207,202420,202420,213710,199980,13730,199980
6842,16245,12239,12210,29,12210,12210,12252,12009,243,12009
6843,18419,18419,18163,256,18163,18163,18419,17850,569,17850
6844,4156,4156,4422,-266,4156,4156,4161,4209,-48,4156
6845,73953,73952,69340,4612,69340,69340,73953,68958,4995,68958
6846,43462,43415,42569,846,42569,42569,43411,42176,1235,42176
6847,98743,103271,98655,4616,98655,98655,103295,97293,6002,97293
6848,13607,12721,12364,357,12364,12364,12720,12360,360,12360
6849,20191,17189,17232,-43,17189,17189,17199,17029,170,17029
6850,146530,149207,146477,2730,146477,146477,149285,145491,3794,145491
6851,71800,63012,59352,3660,59352,59352,63004,57161,5843,57161
6852,6504,6062,6040,22,6040,6040,6065,5928,137,5928
6853,2034,1654,1879,-225,1654,1654,1654,1711,-57,1711
6854,17015,17514,17235,279,17235,17015,17531,17015,516,17015
6855,16265,16253,15739,514,15739,15739,16265,15643,622,15643
6856,64697,40486,40060,426,40060,40060,40482,39357,1125,39357
6857,10324,9414,9281,133,9281,9281,9417,9113,304,9113
6858,20504,20508,19960,548,19960,19960,20504,19920,584,19920
6859,15010,14188,14393,-205,14188,14188,14195,14071,124,14071
6860,62179,60641,59305,1336,59305,59305,60646,58850,1796,58850
6861,65009,65019,64119,900,64119,64119,64979,63556,1423,63556
6862,13157,12542,12239,303,12239,12239,12543,11977,566,11977
6863,4052,3643,3803,-160,3643,3643,3643,3656,-13,3656
6864,34848,34825,34824,1,34824,34824,34848,34049,799,34049
6865,21583,19282,18811,471,18811,18811,19289,17790,1499,17790
6866,136068,134164,128060,6104,128060,128060,134205,126598,7607,126598
6867,18445,17943,17653,290,17653,17653,17946,17482,464,17482
6868,15664,15833,15556,277,15556,15556,15832,15042,790,15042
6869,6883,6904,6966,-62,6904,6883,6901,6761,140,6761
6870,3155,2340,2504,-164,2340,2340,2341,2363,-22,2363
6871,238291,203491,190042,13449,190042,190042,203677,188649,15028,188649
6872,28676,30125,28719,1406,28719,28676,30135,28654,1481,28654
6873,85923,84162,80651,3511,80651,80651,84176,80383,3793,80383
6874,3741,3177,3285,-108,3177,3177,3175,3132,43,3132
6875,5507,5505,5555,-50,5505,5505,5507,5414,93,5414
6876,526636,523192,513068,10124,513068,513068,523339,509676,13663,509676
6877,23081,22440,21854,586,21854,21854,22458,21721,737,21721
6878,42876,43240,41243,1997,41243,41243,43253,40655,2598,40655
6879,14657,14657,14414,243,14414,14414,14657,14078,579,14078
6880,4459,3889,4002,-113,3889,3889,3883,3798,85,3798
6881,53235,53207,50511,2696,50511,50511,53235,49864,3371,49864
6882,5538,5087,5107,-20,5087,5087,5091,4884,207,4884
6883,32293,31563,31020,543,31020,31020,31555,30736,819,30736
6884,29805,11632,11687,-55,11632,11632,11643,11420,223,11420
6885,19460,18736,18542,194,18542,18542,18749,18172,577,18172
6886,10535,9747,9357,390,9357,9357,9752,9269,483,9269
6887,12954,12260,12148,112,12148,12148,12256,11823,433,11823
6888,31531,35590,35209,381,35209,31531,35586,31531,4055,31531
6889,1120624,932077,886241,45836,886241,886241,932087,877144,54943,877144
6890,35451,22731,22785,-54,22731,22731,22740,22154,586,22154
6891,15483,13168,12877,291,12877,12877,13169,12739,430,12739
6892,110791,108856,105909,2947,105909,105909,108828,105577,3251,105577
6893,83227,80436,79425,1011,79425,79425,80484,78715,1769,78715
6894,38017,23261,23598,-337,23261,23261,23268,22433,835,22433
6895,557856,557931,534930,23001,534930,534930,557738,530363,27375,530363
6896,141924,140636,134090,6546,134090,134090,140681,131872,8809,131872
6897,83685,85936,83654,2282,83654,83654,85914,83685,2229,83685
6898,67154,71485,67079,4406,67079,67079,71536,66864,4672,66864
6899,13684,13300,13094,206,13094,13094,13296,13062,234,13062
6900,21226,21234,20015,1219,20015,20015,21226,19567,1659,19567
6901,253580,253517,246409,7108,246409,246409,253580,243293,10287,243293
6902,6229,5800,5913,-113,5800,5800,5801,5793,8,5793
6903,54498,52486,52768,-282,52486,52486,52504,51621,883,51621
6904,2066,1487,1737,-250,1487,1487,1486,1541,-55,1541
6905,123921,122577,116620,5957,116620,116620,122558,116084,6474,116084
6906,40518,42158,40499,1659,40499,40499,42156,40340,1816,40340
6907,18508,17969,17687,282,17687,17687,17962,17542,420,17542
6908,131369,129799,126365,3434,126365,126365,129770,125757,4013,125757
6909,180247,184634,178600,6034,178600,178600,184674,175566,9108,175566
6910,2964,2294,2481,-187,2294,2294,2297,2342,-45,2342
6911,8275,7596,7547,49,7547,7547,7598,7367,231,7367
6912,76142,79525,76196,3329,76196,76142,79506,76142,3364,76142
6913,22866,20967,19555,1412,19555,19555,20952,19474,1478,19474
6914,10660,7500,7582,-82,7500,7500,7498,7444,54,7444
6915,49701,48005,45495,2510,45495,45495,47999,45394,2605,45394
6916,41111,45190,42167,3023,42167,41111,45193,41111,4082,41111
6917,12713,12646,12710,-64,12646,12646,12651,12507,144,12507
6918,903,903,1195,-292,903,903,903,873,30,873
6919,10169,9258,9234,24,9234,9234,9257,9094,163,9094
6920,12644,12638,12852,-214,12638,12638,12644,12506,138,12506
6921,15321,15354,15408,-54,15354,15321,15371,14699,672,14699
6922,80725,83937,81573,2364,81573,80725,83914,81149,2765,80725
6923,18794,18007,17707,300,17707,17707,18017,17600,417,17600
6924,244846,263949,258069,5880,258069,244846,263970,244838,19132,244838
6925,117798,116503,116374,129,116374,116374,116541,113817,2724,113817
6926,94065,92090,87472,4618,87472,87472,92109,87196,4913,87196
6927,44681,44081,43604,477,43604,43604,44077,43274,803,43274
6928,2643,2621,2754,-133,2621,2621,2619,2492,127,2492
6929,172673,177081,172673,4408,172673,172673,177005,171388,5617,171388
6930,12742,12734,12541,193,12541,12541,12742,12327,415,12327
6931,40931,39992,39075,917,39075,39075,40002,38686,1316,38686
6932,12027,11161,11047,114,11047,11047,11159,10697,462,10697
6933,35617,36796,35986,810,35986,35617,36826,35609,1217,35609
6934,64664,66205,64641,1564,64641,64641,66225,64367,1858,64367
6935,23221,23153,22956,197,22956,22956,23160,22798,362,22798
6936,17405,16673,16102,571,16102,16102,16674,15727,947,15727
6937,146825,145396,139958,5438,139958,139958,145367,139304,6063,139304
6938,38207,37264,36870,394,36870,36870,37283,36297,986,36297
6939,32833,32225,31414,811,31414,31414,32219,31148,1071,31148
6940,27704,26315,24652,1663,24652,24652,26317,24487,1830,24487
6941,11552,11147,11078,69,11078,11078,11143,10928,215,10928
6942,117293,117140,109628,7512,109628,109628,117103,107546,9557,107546
6943,208456,210718,212304,-1586,210718,208456,210696,207834,2862,207834
6944,65686,65656,64795,861,64795,64795,65686,64191,1495,64191
6945,45199,44251,42967,1284,42967,42967,44244,42415,1829,42415
6946,35405,34867,34246,621,34246,34246,34851,33930,921,33930
6947,6103,5403,5528,-125,5403,5403,5402,5255,147,5255
6948,476943,460994,439655,21339,439655,439655,460830,437830,23000,437830
6949,254814,249263,244789,4474,244789,244789,249366,242426,6940,242426
6950,21668,20923,19926,997,19926,19926,20927,19885,1042,19885
6951,129775,129709,127456,2253,127456,127456,129775,126407,3368,126407
6952,2106,1729,1921,-192,1729,1729,1729,1763,-34,1763
6953,1522,1130,1360,-230,1130,1130,1130,1183,-53,1183
6954,7815,7053,6979,74,6979,6979,7048,6838,210,6838
6955,7817,7777,7757,20,7757,7757,7778,7440,338,7440
6956,104520,105958,105461,497,105461,104520,106022,104520,1502,104520
6957,34056,33126,32699,427,32699,32699,33119,32218,901,32218
6958,230575,229615,220180,9435,220180,220180,229725,219235,10490,219235
6959,47305,47290,45858,1432,45858,45858,47305,45507,1798,45507
6960,11107,11101,10920,181,10920,10920,11107,10514,593,10514
6961,5538,5372,5536,-164,5372,5372,5369,5368,1,5368
6962,89236,94114,89216,4898,89216,89216,94048,88688,5360,88688
6963,2111,1224,1421,-197,1224,1224,1222,1265,-43,1265
6964,26910,26897,26119,778,26119,26119,26910,25889,1021,25889
6965,78673,78654,78403,251,78403,78403,78653,77068,1585,77068
6966,39698,39692,38164,1528,38164,38164,39698,38060,1638,38060
6967,336809,340437,342990,-2553,340437,336809,340569,339678,891,336809
6968,4365,4365,4612,-247,4365,4365,4368,4352,16,4352
6969,103739,86297,85624,673,85624,85624,86316,85169,1147,85169
6970,84225,79893,79131,762,79131,79131,79932,77635,2297,77635
6971,20787,19954,20038,-84,19954,19954,19955,19590,365,19590
6972,35143,33421,31829,1592,31829,31829,33430,31590,1840,31590
6973,8313,6890,7001,-111,6890,6890,6898,6927,-29,6927
6974,13921,6984,6879,105,6879,6879,6982,6732,250,6732
6975,45157,45098,44430,668,44430,44430,45096,43866,1230,43866
6976,23117,22518,22433,85,22433,22433,22517,21931,586,21931
6977,211129,205363,203158,2205,203158,203158,205500,198092,7408,198092
6978,6080,5521,5678,-157,5521,5521,5523,5379,144,5379
6979,2294,1929,2146,-217,1929,1929,1929,1974,-45,1974
6980,14006,12558,12299,259,12299,12299,12568,12245,323,12245
6981,46528,48708,46456,2252,46456,46456,48722,46029,2693,46029
6982,14348,14334,14218,116,14218,14218,14339,13726,613,13726
6983,43852,42456,41800,656,41800,41800,42460,41014,1446,41014
6984,18821,18688,18337,351,18337,18337,18687,18205,482,18205
6985,33479,32535,31929,606,31929,31929,32561,31372,1189,31372
6986,18456,17426,17125,301,17125,17125,17429,16892,537,16892
6987,6636,6598,6573,25,6573,6573,6598,6421,177,6421
6988,5475,5477,5560,-83,5477,5475,5475,5408,67,5408
6989,138579,145569,138553,7016,138553,138553,145608,138424,7184,138424
6990,22515,21957,21334,623,21334,21334,21961,21168,793,21168
6991,17118,17720,17054,666,17054,17054,17724,17034,690,17034
6992,280103,267657,259992,7665,259992,259992,267713,259958,7755,259958
6993,20864,20863,21247,-384,20863,20863,20864,20528,336,20528
6994,34832,34848,34288,560,34288,34288,34832,34036,796,34036
6995,79735,71719,70341,1378,70341,70341,71696,69814,1882,69814
6996,55138,53837,52209,1628,52209,52209,53833,51859,1974,51859
6997,93547,90077,84511,5566,84511,84511,90090,84036,6054,84036
6998,60584,46989,44279,2710,44279,44279,47030,44214,2816,44214
6999,117996,114642,111410,3232,111410,111410,114681,111197,3484,111197
7000,8633,8636,8428,208,8428,8428,8633,8273,360,8273
7001,214016,222344,207096,15248,207096,207096,222352,203538,18814,203538
7002,2232,2206,2456,-250,2206,2206,2207,2205,2,2205
7003,28126,1026,1289,-263,1026,1026,1026,813,213,813
7004,22715,22712,22448,264,22448,22448,22715,22153,562,22153
7005,36496,37927,36473,1454,36473,36473,37951,36230,1721,36230
7006,155500,157705,156118,1587,156118,155500,157761,155453,2308,155453
7007,11483,11482,11534,-52,11482,11482,11483,11364,119,11364
7008,190249,164155,156705,7450,156705,156705,164142,154847,9295,154847
7009,15112,14665,14614,51,14614,14614,14671,14490,181,14490
7010,13698,14064,13633,431,13633,13633,14063,13468,595,13468
7011,239378,253015,239311,13704,239311,239311,252940,237041,15899,237041
7012,4998,4854,4998,-144,4854,4854,4855,4829,26,4829
7013,12259,12234,12299,-65,12234,12234,12237,12111,126,12111
7014,17685,18329,17620,709,17620,17620,18331,17496,835,17496
7015,132991,133476,127498,5978,127498,127498,133555,125985,7570,125985
7016,309854,308973,297644,11329,297644,297644,308877,294225,14652,294225
7017,13786,14156,13725,431,13725,13725,14154,13266,888,13266
7018,134906,131567,124360,7207,124360,124360,131699,122955,8744,122955
7019,145096,123967,118799,5168,118799,118799,123977,118779,5198,118779
7020,24400,23548,22951,597,22951,22951,23542,22605,937,22605
7021,141526,141569,134636,6933,134636,134636,141526,133811,7715,133811
7022,4808,4400,4559,-159,4400,4400,4406,4379,27,4379
7023,868048,849165,805952,43213,805952,805952,849552,797923,51629,797923
7024,6500,5953,6128,-175,5953,5953,5961,5873,88,5873
7025,19383,19382,18864,518,18864,18864,19383,18351,1032,18351
7026,8735,8576,8669,-93,8576,8576,8580,8243,337,8243
7027,383423,372790,346172,26618,346172,346172,372750,343728,29022,343728
7028,14048,12337,12272,65,12272,12272,12337,12208,129,12208
7029,38277,37111,36139,972,36139,36139,37120,35740,1380,35740
7030,166074,156859,147803,9056,147803,147803,156839,146842,9997,146842
7031,16532,15990,15691,299,15691,15691,15995,15452,543,15452
7032,4801,4409,4393,16,4393,4393,4412,4255,157,4255
7033,471555,481382,467754,13628,467754,467754,481606,464422,17184,464422
7034,27182,27874,27458,416,27458,27182,27877,27218,659,27182
7035,111106,117089,111092,5997,111092,111092,117094,110974,6120,110974
7036,54709,40812,39685,1127,39685,39685,40809,39423,1386,39423
7037,88537,55239,56300,-1061,55239,55239,55228,54234,994,54234
7038,3063,2739,2974,-235,2739,2739,2737,2782,-45,2782
7039,2111,1187,1411,-224,1187,1187,1187,1245,-58,1245
7040,66330,68679,65420,3259,65420,65420,68693,64735,3958,64735
7041,78581,80699,78899,1800,78899,78581,80689,78726,1963,78581
7042,306060,249381,237986,11395,237986,237986,249383,237463,11920,237463
7043,181743,180903,173110,7793,173110,173110,180936,171063,9873,171063
7044,848,543,777,-234,543,543,543,587,-44,587
7045,1580,912,1197,-285,912,912,912,958,-46,958
7046,56046,17683,16989,694,16989,16989,17682,15542,2140,15542
7047,20501,20507,20129,378,20129,20129,20501,19942,559,19942
7048,71041,71005,69720,1285,69720,69720,71006,69134,1872,69134
7049,13641,12820,12935,-115,12820,12820,12833,12445,388,12445
7050,309292,298365,288741,9624,288741,288741,298404,285588,12816,285588
7051,38814,40103,38803,1300,38803,38803,40129,38578,1551,38578
7052,25557,25532,24802,730,24802,24802,25547,23433,2114,23433
7053,43257,44112,42861,1251,42861,42861,44136,42635,1501,42635
7054,7306,7683,7602,81,7602,7306,7687,7306,381,7306
7055,19842,19194,19366,-172,19194,19194,19193,18994,199,18994
7056,32041,31120,30440,680,30440,30440,31136,30116,1020,30116
7057,134989,138452,136207,2245,136207,134989,138429,135091,3338,134989
7058,87886,87187,82960,4227,82960,82960,87191,82010,5181,82010
7059,4710,4688,4862,-174,4688,4688,4689,4710,-21,4710
7060,28223,28231,27088,1143,27088,27088,28223,26785,1438,26785
7061,29302,28115,27597,518,27597,27597,28122,27256,866,27256
7062,267789,264271,254281,9990,254281,254281,264196,252726,11470,252726
7063,67214,66225,64210,2015,64210,64210,66235,63492,2743,63492
7064,114375,117839,113958,3881,113958,113958,117904,113753,4151,113753
7065,187844,186893,184170,2723,184170,184170,186903,181854,5049,181854
7066,244130,252814,243547,9267,243547,243547,252888,242298,10590,242298
7067,110060,109265,107311,1954,107311,107311,109236,106427,2809,106427
7068,169264,181706,169264,12442,169264,169264,181757,160847,20910,160847
7069,35692,35063,35043,20,35043,35043,35072,34190,882,34190
7070,34191,33384,31427,1957,31427,31427,33381,31346,2035,31346
7071,479446,463229,439721,23508,439721,439721,463342,434938,28404,434938
7072,51518,50769,47656,3113,47656,47656,50815,47555,3260,47555
7073,39931,38409,36540,1869,36540,36540,38412,35709,2703,35709
7074,29687,29691,27815,1876,27815,27815,29687,27738,1949,27738
7075,89354,89226,88362,864,88362,88362,89280,86947,2333,86947
7076,35366,33731,33959,-228,33731,33731,33751,33129,622,33129
7077,19498,19497,18500,997,18500,18500,19498,17906,1592,17906
7078,91619,62755,61374,1381,61374,61374,62799,60874,1925,60874
7079,37102,32752,32054,698,32054,32054,32754,31860,894,31860
7080,14643,13669,13347,322,13347,13347,13664,12880,784,12880
7081,272803,284004,271988,12016,271988,271988,284186,259611,24575,259611
7082,60358,59131,55362,3769,55362,55362,59204,54884,4320,54884
7083,63189,62248,60970,1278,60970,60970,62257,59441,2816,59441
7084,15200,13569,13413,156,13413,13413,13573,13392,181,13392
7085,35279,34778,32938,1840,32938,32938,34795,32700,2095,32700
7086,58858,58816,57808,1008,57808,57808,58804,57421,1383,57421
7087,102062,105162,103736,1426,103736,102062,105177,101054,4123,101054
7088,4687,4083,4024,59,4024,4024,4088,3811,277,3811
7089,88589,88614,83914,4700,83914,83914,88589,83614,4975,83614
7090,12322,11201,11053,148,11053,11053,11201,10655,546,10655
7091,51002,49520,49512,8,49512,49512,49518,48530,988,48530
7092,15829,15447,15104,343,15104,15104,15456,14981,475,14981
7093,10454,8259,8466,-207,8259,8259,8260,7002,1258,7002
7094,31307,27015,26386,629,26386,26386,27026,26216,810,26216
7095,33064,32968,33003,-35,32968,32968,32967,32611,356,32611
7096,4976,4977,5152,-175,4977,4976,4976,4961,15,4961
7097,90133,91438,89473,1965,89473,89473,91420,89580,1840,89580
7098,102382,102895,99887,3008,99887,99887,102928,99220,3708,99220
7099,18802,19058,18809,249,18809,18802,19063,18576,487,18576
7100,251011,250049,243920,6129,243920,243920,250065,242258,7807,242258
7101,221163,220572,209883,10689,209883,209883,220609,207942,12667,207942
7102,6614,5885,5949,-64,5885,5885,5883,5727,156,5727
7103,50018,27521,26047,1474,26047,26047,27528,25341,2187,25341
7104,24526,24388,23863,525,23863,23863,24392,23739,653,23739
7105,2875,2501,2646,-145,2501,2501,2499,2481,18,2481
7106,10980,10323,10456,-133,10323,10323,10329,10199,130,10199
7107,131020,136327,130994,5333,130994,130994,136304,130478,5826,130478
7108,52521,52502,50995,1507,50995,50995,52496,50664,1832,50664
7109,35743,35689,35735,-46,35689,35689,35726,35141,585,35141
7110,6788,6754,6723,31,6723,6723,6754,6618,136,6618
7111,42641,12965,12426,539,12426,12426,12970,11930,1040,11930
7112,75986,75960,73063,2897,73063,73063,75968,72477,3491,72477
7113,12264,12095,12262,-167,12095,12095,12093,11985,108,11985
7114,12101,12246,12040,206,12040,12040,12258,11778,480,11778
7115,161364,151384,142667,8717,142667,142667,151538,141970,9568,141970
7116,8407,8690,8813,-123,8690,8407,8694,8399,295,8399
7117,27194,28586,27189,1397,27189,27189,28575,27021,1554,27021
7118,77899,70113,64916,5197,64916,64916,70110,61622,8488,61622
7119,8309,8478,8242,236,8242,8242,8478,8186,292,8186
7120,17470,17036,16413,623,16413,16413,17039,16311,728,16311
7121,345623,15857,15802,55,15802,15802,15856,14547,1309,14547
7122,67947,67087,65585,1502,65585,65585,67117,65189,1928,65189
7123,4605,4208,4333,-125,4208,4208,4208,4180,28,4180
7124,14819,15717,14756,961,14756,14756,15715,14518,1197,14518
7125,162969,157968,149641,8327,149641,149641,158028,149233,8795,149233
7126,9774,9771,9854,-83,9771,9771,9774,9573,201,9573
7127,36848,36667,34569,2098,34569,34569,36652,34362,2290,34362
7128,95259,91387,86969,4418,86969,86969,91400,86073,5327,86073
7129,28607,27681,27402,279,27402,27402,27690,27167,523,27167
7130,955,285,519,-234,285,285,285,333,-48,333
7131,142911,142023,138913,3110,138913,138913,142055,135564,6491,135564
7132,173076,185139,173043,12096,173043,173043,185169,172733,12436,172733
7133,14009,13083,12832,251,12832,12832,13083,12713,370,12713
7134,64046,59059,56577,2482,56577,56577,59066,56365,2701,56365
7135,11493,11067,10885,182,10885,10885,11065,10683,382,10683
7136,61140,61070,59712,1358,59712,59712,61050,55460,5590,55460
7137,290190,306680,290132,16548,290132,290132,306770,288162,18608,288162
7138,1994,1995,2227,-232,1995,1994,1994,2039,-45,1994
7139,237428,232178,220983,11195,220983,220983,232194,219916,12278,219916
7140,371727,312918,299831,13087,299831,299831,313008,299189,13819,299189
7141,9888,8461,8523,-62,8461,8461,8465,8349,116,8349
7142,4475,4478,4846,-368,4478,4475,4481,4472,9,4472
7143,140010,138542,132165,6377,132165,132165,138573,131969,6604,131969
7144,50900,50049,48199,1850,48199,48199,50040,48026,2014,48026
7145,44809,44762,41899,2863,41899,41899,44777,41344,3433,41344
7146,17205,17215,16868,347,16868,16868,17205,16637,568,16637
7147,34853,10961,10550,411,10550,10550,10963,10253,710,10253
7148,229195,228320,218495,9825,218495,218495,228354,214941,13413,214941
7149,122972,128649,120074,8575,120074,120074,128639,114756,13883,114756
7150,58750,54830,53365,1465,53365,53365,54838,52976,1862,52976
7151,164062,163497,157377,6120,157377,157377,163508,157075,6433,157075
7152,114807,110437,106164,4273,106164,106164,110431,105163,5268,105163
7153,2485,2140,2324,-184,2140,2140,2140,2179,-39,2179
7154,25620,26336,25642,694,25642,25620,26329,25620,709,25620
7155,327518,329709,332998,-3289,329709,327518,329840,327510,2330,327510
7156,233857,220670,207667,13003,207667,207667,220638,206436,14202,206436
7157,1919,1917,2155,-238,1917,1917,1919,1979,-60,1919
7158,10406,10049,10063,-14,10049,10049,10055,9856,199,9856
7159,53653,53709,53651,58,53651,53651,53714,52632,1082,52632
7160,3046,2970,3107,-137,2970,2970,2970,2956,14,2956
7161,181937,178922,171303,7619,171303,171303,178775,170425,8350,170425
7162,50304,39622,40227,-605,39622,39622,39633,39531,102,39531
7163,11437,11034,10760,274,10760,10760,11032,10620,412,10620
7164,16937,16395,16264,131,16264,16264,16395,16133,262,16133
7165,95566,100341,96537,3804,96537,95566,100325,95858,4467,95566
7166,343222,343341,337707,5634,337707,337707,343222,327477,15745,327477
7167,673093,672699,630364,42335,630364,630364,673111,629614,43497,629614
7168,55711,58395,55707,2688,55707,55707,58403,54994,3409,54994
7169,479627,479527,451453,28074,451453,451453,479627,447814,31813,447814
7170,4232,3831,4044,-213,3831,3831,3832,3830,2,3830
7171,6637,6078,6009,69,6009,6009,6083,5634,449,5634
7172,11570,11449,11508,-59,11449,11449,11458,10902,556,10902
7173,47743,48436,48007,429,48007,47743,48418,47726,692,47726
7174,4795,4279,4354,-75,4279,4279,4275,4165,110,4165
7175,3181,3180,3297,-117,3180,3180,3181,2915,266,2915
7176,2521,2365,2522,-157,2365,2365,2362,2381,-19,2381
7177,1672,1282,1461,-179,1282,1282,1282,1327,-45,1327
7178,397894,414708,402462,12246,402462,397894,414696,400802,13894,397894
7179,4555,4143,4222,-79,4143,4143,4145,4077,68,4077
7180,19665,19194,18631,563,18631,18631,19191,18504,687,18504
7181,57123,43435,42209,1226,42209,42209,43427,41703,1724,41703
7182,4434,3790,3873,-83,3790,3790,3789,3698,91,3698
7183,330823,300930,283437,17493,283437,283437,301016,281784,19232,281784
7184,60146,59207,56904,2303,56904,56904,59223,56550,2673,56550
7185,177160,131098,125665,5433,125665,125665,131120,123707,7413,123707
7186,70116,73081,74766,-1685,73081,70116,73057,71948,1109,70116
7187,7181,7184,7199,-15,7184,7181,7181,7056,125,7056
7188,1561,1576,1846,-270,1576,1561,1577,1613,-36,1561
7189,25666,25716,25197,519,25197,25197,25690,25044,646,25044
7190,99005,83103,80061,3042,80061,80061,83132,79263,3869,79263
7191,26680,26529,26954,-425,26529,26529,26547,26058,489,26058
7192,256162,205239,194483,10756,194483,194483,205261,188924,16337,188924
7193,21790,21233,20829,404,20829,20829,21236,20689,547,20689
7194,4209,3886,4145,-259,3886,3886,3891,3940,-49,3940
7195,40105,40087,38758,1329,38758,38758,40070,38267,1803,38267
7196,121614,129191,121539,7652,121539,121539,129259,119749,9510,119749
7197,17360,17927,17329,598,17329,17329,17928,17242,686,17242
7198,23499,24509,23432,1077,23432,23432,24503,22843,1660,22843
7199,21615,20701,20379,322,20379,20379,20705,20221,484,20221
7200,19399,19296,18825,471,18825,18825,19302,18287,1015,18287
7201,15481,15062,14665,397,14665,14665,15070,14556,514,14556
7202,37085,33836,32030,1806,32030,32030,33828,31808,2020,31808
7203,119831,119846,115234,4612,115234,115234,119831,114273,5558,114273
7204,663491,627495,590723,36772,590723,590723,627441,578473,48968,578473
7205,253530,212104,200821,11283,200821,200821,212155,199076,13079,199076
7206,14038,14362,14029,333,14029,14029,14364,13911,453,13911
7207,454289,388891,383561,5330,383561,383561,388877,379335,9542,379335
7208,55892,48184,47126,1058,47126,47126,48182,46745,1437,46745
7209,7203,6730,6708,22,6708,6708,6730,6520,210,6520
7210,125947,125805,121357,4448,121357,121357,125813,120975,4838,120975
7211,104878,104806,100147,4659,100147,100147,104852,99659,5193,99659
7212,22613,11875,12129,-254,11875,11875,11880,10857,1023,10857
7213,255988,255110,240468,14642,240468,240468,255098,236296,18802,236296
7214,62402,37470,36638,832,36638,36638,37486,36296,1190,36296
7215,397531,397475,373484,23991,373484,373484,397531,365362,32169,365362
7216,17197,16390,15844,546,15844,15844,16386,15700,686,15700
7217,19476,19783,19599,184,19599,19476,19799,18854,945,18854
7218,1711148,1646999,1578243,68756,1578243,1578243,1647229,1570780,76449,1570780
7219,75350,73376,70278,3098,70278,70278,73400,69277,4123,69277
7220,308698,308803,296963,11840,296963,296963,308698,296638,12060,296638
7221,195064,190586,178294,12292,178294,178294,190626,177027,13599,177027
7222,10843,10750,10764,-14,10750,10750,10751,10455,296,10455
7223,4880,4516,4882,-366,4516,4516,4519,4422,97,4422
7224,9059,8665,8471,194,8471,8471,8664,8365,299,8365
7225,50557,53695,50489,3206,50489,50489,53731,50287,3444,50287
7226,8646,8404,8137,267,8137,8137,8406,8024,382,8024
7227,16239,13563,13563,0,13563,13563,13564,13456,108,13456
7228,14272,13341,13265,76,13265,13265,13335,13125,210,13125
7229,81763,81704,77115,4589,77115,77115,81726,75469,6257,75469
7230,8590,8132,8056,76,8056,8056,8141,7907,234,7907
7231,40128,40102,38801,1301,38801,38801,40102,38566,1536,38566
7232,116561,121521,116907,4614,116907,116561,121514,115939,5575,115939
7233,17072,17025,16754,271,16754,16754,17025,16132,893,16132
7234,6243,5881,5914,-33,5881,5881,5881,5780,101,5780
7235,784772,784609,739300,45309,739300,739300,784790,728888,55902,728888
7236,23875,24274,23813,461,23813,23813,24284,22880,1404,22880
7237,2082387,1847053,1817838,29215,1817838,1817838,1847683,1768619,79064,1768619
7238,4421,3695,3791,-96,3695,3695,3694,3627,67,3627
7239,79798,77000,75554,1446,75554,75554,77018,75145,1873,75145
7240,405235,280971,266538,14433,266538,266538,281080,266316,14764,266316
7241,20590,20123,19874,249,19874,19874,20123,19655,468,19655
7242,1164655,1161571,1091241,70330,1091241,1091241,1161493,1085656,75837,1085656
7243,214874,222030,214829,7201,214829,214829,222047,211285,10762,211285
7244,27526,27500,26641,859,26641,26641,27493,26542,951,26542
7245,216622,219446,211993,7453,211993,211993,219424,206112,13312,206112
7246,103877,103856,98916,4940,98916,98916,103847,98485,5362,98485
7247,64523,63474,61416,2058,61416,61416,63480,60138,3342,60138
7248,4416,3874,3916,-42,3874,3874,3880,3685,195,3685
7249,7356,6903,6957,-54,6903,6903,6904,6813,91,6813
7250,664424,663202,644901,18301,644901,644901,663270,637465,25805,637465
7251,505954,525148,505758,19390,505758,505758,524917,503087,21830,503087
7252,28339,27509,26466,1043,26466,26466,27503,26284,1219,26284
7253,1281236,1260481,1206930,53551,1206930,1206930,1260556,1187932,72624,1187932
7254,23263,23993,23262,731,23262,23262,23989,23226,763,23226
7255,2280,1856,2032,-176,1856,1856,1856,1844,12,1844
7256,359378,298473,273672,24801,273672,273672,298554,262536,36018,262536
7257,247795,247750,224084,23666,224084,224084,247813,214332,33481,214332
7258,34018,32278,30779,1499,30779,30779,32284,30766,1518,30766
7259,92439,79203,74354,4849,74354,74354,79168,73555,5613,73555
7260,24002,22446,22322,124,22322,22322,22444,21436,1008,21436
7261,25910,24977,24803,174,24803,24803,24977,23977,1000,23977
7262,2339,1419,1625,-206,1419,1419,1419,1479,-60,1479
7263,36929,35870,34152,1718,34152,34152,35852,34050,1802,34050
7264,20633,20425,20306,119,20306,20306,20436,20011,425,20011
7265,140822,145741,138371,7370,138371,138371,145736,137660,8076,137660
7266,2042,2042,2233,-191,2042,2042,2042,2093,-51,2042
7267,356361,362696,356296,6400,356296,356296,362636,354466,8170,354466
7268,16547,16543,16212,331,16212,16212,16547,16016,531,16016
7269,21065,21035,21421,-386,21035,21035,21032,19422,1610,19422
7270,31477,30909,29470,1439,29470,29470,30918,29412,1506,29412
7271,17576,16786,16731,55,16731,16731,16799,16571,228,16571
7272,1544,865,1106,-241,865,865,865,922,-57,922
7273,6974,6940,7159,-219,6940,6940,6938,6927,11,6927
7274,52854,51357,52778,-1421,51357,51357,51380,50278,1102,50278
7275,29037,28596,29037,-441,28596,28596,28620,28386,234,28386
7276,71309,70378,68563,1815,68563,68563,70373,68319,2054,68319
7277,311124,316036,320855,-4819,316036,311124,316135,314594,1541,311124
7278,32068,32273,31995,278,31995,31995,32321,31637,684,31637
7279,57332,57283,55320,1963,55320,55320,57332,54486,2846,54486
7280,2531,2086,2296,-210,2086,2086,2085,2057,28,2057
7281,258024,250746,241543,9203,241543,241543,250658,239810,10848,239810
7282,1731,1626,1855,-229,1626,1626,1626,1684,-58,1684
7283,73347,72423,69992,2431,69992,69992,72449,69441,3008,69441
7284,15795,16203,15790,413,15790,15790,16206,15665,541,15665
7285,6625,6624,6663,-39,6624,6624,6625,6488,137,6488
7286,21706,21068,20263,805,20263,20263,21074,20234,840,20234
7287,56923,34548,34232,316,34232,34232,34568,33761,807,33761
7288,112812,99495,98109,1386,98109,98109,99508,96728,2780,96728
7289,181001,174538,164440,10098,164440,164440,174544,163805,10739,163805
7290,208370,212608,208306,4302,208306,208306,212714,205125,7589,205125
7291,27875,27314,26121,1193,26121,26121,27321,25959,1362,25959
7292,27438,27419,27243,176,27243,27243,27438,26922,516,26922
7293,294890,293893,293937,-44,293893,293893,293946,290226,3720,290226
7294,28801,28700,28408,292,28408,28408,28715,27891,824,27891
7295,48129,48957,49228,-271,48957,48129,49003,48590,413,48129
7296,96150,94549,90960,3589,90960,90960,94567,90762,3805,90762
7297,49167,52015,49091,2924,49091,49091,52010,48822,3188,48822
7298,59124,57588,56993,595,56993,56993,57566,56510,1056,56510
7299,28550,24778,24070,708,24070,24070,24774,23897,877,23897
7300,41752,23344,22767,577,22767,22767,23354,22610,744,22610
7301,198371,197880,191546,6334,191546,191546,197817,189880,7937,189880
7302,83388,83377,81498,1879,81498,81498,83388,80550,2838,80550
7303,22028,19388,18752,636,18752,18752,19382,18601,781,18601
7304,18909,19674,18902,772,18902,18902,19693,18775,918,18775
7305,15047,14401,14152,249,14152,14152,14409,13820,589,13820
7306,119116,99255,93523,5732,93523,93523,99287,93005,6282,93005
7307,1368,1078,1307,-229,1078,1078,1079,1128,-49,1128
7308,73704,72827,69824,3003,69824,69824,72829,69343,3486,69343
7309,25884,26464,25885,579,25885,25884,26467,25553,914,25553
7310,216589,223090,216529,6561,216529,216529,223172,205783,17389,205783
7311,18511,13354,13379,-25,13354,13354,13353,13286,67,13286
7312,94077,77707,76455,1252,76455,76455,77721,76113,1608,76113
7313,3861,3498,3711,-213,3498,3498,3498,3487,11,3487
7314,41665,41674,42740,-1066,41674,41665,41671,41553,118,41553
7315,25881,25877,25417,460,25417,25417,25881,25240,641,25240
7316,758,427,662,-235,427,427,427,478,-51,478
7317,29488,29448,28653,795,28653,28653,29460,28271,1189,28271
7318,3133,2757,2941,-184,2757,2757,2757,2766,-9,2766
7319,3207,3207,3508,-301,3207,3207,3208,2997,211,2997
7320,18458,15632,15376,256,15376,15376,15638,13421,2217,13421
7321,7297,6879,6841,38,6841,6841,6885,6738,147,6738
7322,2073,1701,1909,-208,1701,1701,1698,1747,-49,1747
7323,4050,3725,3858,-133,3725,3725,3725,3723,2,3723
7324,2360,2275,2510,-235,2275,2275,2274,2327,-53,2327
7325,13819,11698,11324,374,11324,11324,11701,10454,1247,10454
7326,33923,34096,33922,174,33922,33922,34115,33558,557,33558
7327,294188,294062,287723,6339,287723,287723,294188,286915,7273,286915
7328,2658,2658,2919,-261,2658,2658,2658,2665,-7,2658
7329,264719,237877,230467,7410,230467,230467,237937,229250,8687,229250
7330,184202,184189,180347,3842,180347,180347,184202,178958,5244,178958
7331,97686,91672,86902,4770,86902,86902,91719,86176,5543,86176
7332,11360,10918,10999,-81,10918,10918,10915,10801,114,10801
7333,124640,121390,113644,7746,113644,113644,121328,113261,8067,113261
7334,21558,5411,5445,-34,5411,5411,5410,5372,38,5372
7335,10107,10105,10719,-614,10105,10105,10107,10228,-121,10107
7336,30291,31943,30804,1139,30804,30291,31942,30291,1651,30291
7337,9104,8560,8283,277,8283,8283,8556,8170,386,8170
7338,80560,85317,80546,4771,80546,80546,85326,80120,5206,80120
7339,60231,60163,58033,2130,58033,58033,60169,57764,2405,57764
7340,70760,66869,68368,-1499,66869,66869,66917,65594,1323,65594
7341,58701,56020,53677,2343,53677,53677,56024,52873,3151,52873
7342,55097,53080,52389,691,52389,52389,53085,50535,2550,50535
7343,1366217,1239772,1164718,75054,1164718,1164718,1239777,1146253,93524,1146253
7344,11846,11286,10800,486,10800,10800,11292,10469,823,10469
7345,438308,397940,380204,17736,380204,380204,397930,377733,20197,377733
7346,79584,76380,75205,1175,75205,75205,76411,68516,7895,68516
7347,6148,5734,5881,-147,5734,5734,5728,5732,-4,5732
7348,22289,21716,21286,430,21286,21286,21720,21100,620,21100
7349,26242,25668,25164,504,25164,25164,25688,24915,773,24915
7350,155916,164185,156761,7424,156761,155916,164234,155912,8322,155912
7351,93896,95763,91182,4581,91182,91182,95737,90755,4982,90755
7352,262079,241501,229707,11794,229707,229707,241576,227175,14401,227175
7353,2842,2510,2710,-200,2510,2510,2505,2489,16,2489
7354,95434,91694,85702,5992,85702,85702,91703,84851,6852,84851
7355,46387,46391,45811,580,45811,45811,46387,45608,779,45608
7356,20893,20979,20509,470,20509,20509,20984,20271,713,20271
7357,273782,273754,264420,9334,264420,264420,273782,261289,12493,261289
7358,31299,31296,32568,-1272,31296,31296,31299,30621,678,30621
7359,9294,9292,9279,13,9279,9279,9288,9115,173,9115
7360,29052,28600,27730,870,27730,27730,28578,27480,1098,27480
7361,13099,12574,12346,228,12346,12346,12580,12251,329,12251
7362,12513,12511,12489,22,12489,12489,12510,12237,273,12237
7363,18072,17563,16572,991,16572,16572,17556,16432,1124,16432
7364,74817,72750,72685,65,72685,72685,72780,71325,1455,71325
7365,89455,95298,90733,4565,90733,89455,95306,89455,5851,89455
7366,258028,264521,257942,6579,257942,257942,264454,254661,9793,254661
7367,15692,14758,14555,203,14555,14555,14765,14351,414,14351
7368,5515,5518,5685,-167,5518,5515,5515,5480,35,5480
7369,100651,100653,95158,5495,95158,95158,100651,93894,6757,93894
7370,25222,25877,25163,714,25163,25163,25883,25098,785,25098
7371,17696,17503,17936,-433,17503,17503,17501,17587,-86,17587
7372,29130,28637,27501,1136,27501,27501,28624,27401,1223,27401
7373,46828,51042,52145,-1103,51042,46828,51045,46828,4217,46828
7374,9322,8699,8449,250,8449,8449,8693,8445,248,8445
7375,9159,9160,9163,-3,9160,9159,9162,8666,496,8666
7376,8754,8091,8301,-210,8091,8091,8092,8054,38,8054
7377,53467,13141,13007,134,13007,13007,13143,12885,258,12885
7378,35468,36307,35402,905,35402,35402,36303,34917,1386,34917
7379,3673,3115,3254,-139,3115,3115,3116,3089,27,3089
7380,290438,290426,275485,14941,275485,275485,290456,273512,16944,273512
7381,321268,315771,305142,10629,305142,305142,315662,303517,12145,303517
7382,26938,26867,27326,-459,26867,26867,26877,26773,104,26773
7383,1794,885,1128,-243,885,885,885,906,-21,906
7384,124387,124386,119219,5167,119219,119219,124387,117713,6674,117713
7385,3684,3680,3841,-161,3680,3680,3684,3477,207,3477
7386,275772,275671,257923,17748,257923,257923,275772,257709,18063,257709
7387,8303,8591,8303,288,8303,8303,8593,8053,540,8053
7388,2815,2902,3052,-150,2902,2815,2903,2791,112,2791
7389,723961,712618,677081,35537,677081,677081,712904,675157,37747,675157
7390,85949,86000,83179,2821,83179,83179,85949,82259,3690,82259
7391,68337,63511,62540,971,62540,62540,63556,61680,1876,61680
7392,1195568,1195135,1138054,57081,1138054,1138054,1195516,1127189,68327,1127189
7393,1721432,1831357,1720880,110477,1720880,1720880,1830806,1718564,112242,1718564
7394,51948,50971,50061,910,50061,50061,50964,49705,1259,49705
7395,11295,12699,12488,211,12488,11295,12697,10673,2024,10673
7396,6282,6277,6206,71,6206,6206,6282,6050,232,6050
7397,101537,96697,94716,1981,94716,94716,96708,93332,3376,93332
7398,15245,15598,15184,414,15184,15184,15596,14787,809,14787
7399,244334,243315,239733,3582,239733,239733,243446,235582,7864,235582
7400,72674,71780,70577,1203,70577,70577,71805,68339,3466,68339
7401,3582,2954,3147,-193,2954,2954,2955,2865,90,2865
7402,17062,19308,17747,1561,17747,17062,19311,17062,2249,17062
7403,12209,12206,11177,1029,11177,11177,12209,10277,1932,10277
7404,45249,43954,43029,925,43029,43029,43963,42732,1231,42732
7405,8896,8971,8897,74,8897,8896,8976,8753,223,8753
7406,41641,41656,40531,1125,40531,40531,41670,39969,1701,39969
7407,79200,79199,75731,3468,75731,75731,79139,75218,3921,75218
7408,32724,28385,27751,634,27751,27751,28384,27251,1133,27251
7409,54652,55420,55189,231,55189,54652,55425,54030,1395,54030
7410,14959,14349,14039,310,14039,14039,14356,13939,417,13939
7411,46836,48343,46836,1507,46836,46836,48350,46345,2005,46345
7412,4976,4596,4698,-102,4596,4596,4595,4528,67,4528
7413,42118,28163,28676,-513,28163,28163,28163,27647,516,27647
7414,5877,4432,4864,-432,4432,4432,4432,4302,130,4302
7415,378046,375118,361584,13534,361584,361584,375185,358116,17069,358116
7416,101064,96691,92230,4461,92230,92230,96704,90361,6343,90361
7417,110229,110201,106872,3329,106872,106872,110229,105855,4374,105855
7418,6968,6861,6970,-109,6861,6861,6860,6802,58,6802
7419,9567,9551,9722,-171,9551,9551,9553,9539,14,9539
7420,26432,26139,26427,-288,26139,26139,26146,25719,427,25719
7421,29096,29547,29336,211,29336,29096,29557,29096,461,29096
7422,41100,36985,36126,859,36126,36126,36991,27285,9706,27285
7423,22041,21492,20991,501,20991,20991,21487,20856,631,20856
7424,26147,26855,26077,778,26077,26077,26857,25861,996,25861
7425,8414,6871,6957,-86,6871,6871,6874,6767,107,6767
7426,233221,228385,233181,-4796,228385,228385,228533,223064,5469,223064
7427,3044,2512,2708,-196,2512,2512,2514,2498,16,2498
7428,17295,17304,17236,68,17236,17236,17295,17125,170,17125
7429,51937,51117,48258,2859,48258,48258,51136,48019,3117,48019
7430,597297,595641,584779,10862,584779,584779,595700,580705,14995,580705
7431,9018,8497,8327,170,8327,8327,8490,8261,229,8261
7432,15556,16230,15553,677,15553,15553,16227,15498,729,15498
7433,58052,57272,54161,3111,54161,54161,57293,54069,3224,54069
7434,2660,2304,2501,-197,2304,2304,2303,2350,-47,2350
7435,10896,10806,10896,-90,10806,10806,10801,10636,165,10636
7436,62502,62490,60260,2230,60260,60260,62502,60088,2414,60088
7437,71928,60951,58794,2157,58794,58794,60980,57035,3945,57035
7438,4176,3842,3957,-115,3842,3842,3844,3814,30,3814
7439,24020,23187,22599,588,22599,22599,23208,22361,847,22361
7440,25676,24364,24515,-151,24364,24364,24358,23574,784,23574
7441,3897,3522,3703,-181,3522,3522,3522,3545,-23,3545
7442,26066,25556,24276,1280,24276,24276,25539,24196,1343,24196
7443,34457,33540,33029,511,33029,33029,33530,23936,9594,23936
7444,89735,84963,78883,6080,78883,78883,84982,76728,8254,76728
7445,2013,1760,1952,-192,1760,1760,1760,1769,-9,1769
7446,67014,66281,65103,1178,65103,65103,66319,63743,2576,63743
7447,8242,7702,7567,135,7567,7567,7700,7497,203,7497
7448,203864,211158,201633,9525,201633,201633,211186,200427,10759,200427
7449,47770,45009,42673,2336,42673,42673,45003,42240,2763,42240
7450,379132,379039,363927,15112,363927,363927,378971,359450,19521,359450
7451,7317,6526,6661,-135,6526,6526,6526,6466,60,6466
7452,27630,26525,25367,1158,25367,25367,26533,25115,1418,25115
7453,34926,33947,32721,1226,32721,32721,33961,32539,1422,32539
7454,1720555,1720683,1615831,104852,1615831,1615831,1720437,1576751,143686,1576751
7455,14885,14963,15221,-258,14963,14885,14968,14885,83,14885
7456,63962,51925,49715,2210,49715,49715,51928,48498,3430,48498
7457,55005,52745,49705,3040,49705,49705,52742,49545,3197,49545
7458,284,284,519,-235,284,284,284,331,-47,284
7459,97777,87429,82591,4838,82591,82591,87454,79232,8222,79232
7460,12982,12975,12633,342,12633,12633,12982,12564,418,12564
7461,35179,34464,33416,1048,33416,33416,34465,33297,1168,33297
7462,450828,426706,410925,15781,410925,410925,426992,408501,18491,408501
7463,603102,599762,583494,16268,583494,583494,599748,577524,22224,577524
7464,32278,33825,32210,1615,32210,32210,33819,30808,3011,30808
7465,2021,2029,2253,-224,2029,2021,2030,1977,53,1977
7466,2021,2029,2253,-224,2029,2021,2030,1977,53,1977
7467,42553,42398,42463,-65,42398,42398,42419,41854,565,41854
7468,9100,8335,8478,-143,8335,8335,8349,8138,211,8138
7469,17053,17202,17221,-19,17202,17053,17205,16431,774,16431
7470,64236,67979,65046,2933,65046,64236,68023,64236,3787,64236
7471,17317,15597,16354,-757,15597,15597,15601,14970,631,14970
7472,35453,36145,35703,442,35703,35453,36139,35453,686,35453
7473,20109,20108,19532,576,19532,19532,20109,18865,1244,18865
7474,41250,40423,39173,1250,39173,39173,40410,38968,1442,38968
7475,24728,23273,22347,926,22347,22347,23279,21833,1446,21833
7476,91513,90161,88449,1712,88449,88449,90191,87903,2288,87903
7477,7408,6363,6408,-45,6363,6363,6370,6218,152,6218
7478,26279,27768,26279,1489,26279,26279,27745,26122,1623,26122
7479,23874,24442,23453,989,23453,23453,24438,23328,1110,23328
7480,56474,56417,53665,2752,53665,53665,56413,53495,2918,53495
7481,6797,6801,6812,-11,6801,6797,6797,6669,128,6669
7482,16278,15852,15194,658,15194,15194,15868,15125,743,15125
7483,452620,452646,427709,24937,427709,427709,452620,421964,30656,421964
7484,12906,12899,13196,-297,12899,12899,12906,12869,37,12869
7485,257593,246814,242722,4092,242722,242722,246941,241070,5871,241070
7486,7860,7303,7290,13,7290,7290,7306,6889,417,6889
7487,58914,56603,54356,2247,54356,54356,56587,53811,2776,53811
7488,181371,158397,154573,3824,154573,154573,158478,152167,6311,152167
7489,7864,7824,7992,-168,7824,7824,7827,7797,30,7797
7490,30717,11086,10381,705,10381,10381,11087,9893,1194,9893
7491,5519,5519,5534,-15,5519,5519,5522,5450,72,5450
7492,156422,155588,146465,9123,146465,146465,155549,141422,14127,141422
7493,26813,29633,28125,1508,28125,26813,29626,26731,2895,26731
7494,73534,70642,66471,4171,66471,66471,70647,65528,5119,65528
7495,2902,2495,2664,-169,2495,2495,2497,2530,-33,2530
7496,79749,78952,74270,4682,74270,74270,78971,72058,6913,72058
7497,34578,33621,33377,244,33377,33377,33648,33100,548,33100
7498,35003,34215,34163,52,34163,34163,34249,33616,633,33616
7499,63444,60004,56885,3119,56885,56885,60012,56258,3754,56258
7500,17877,10876,10712,164,10712,10712,10879,10671,208,10671
7501,4209,3793,3944,-151,3793,3793,3799,3713,86,3713
7502,11041,10824,11040,-216,10824,10824,10826,10728,98,10728
7503,42491,44318,42490,1828,42490,42490,44311,42210,2101,42210
7504,11595,10991,10917,74,10917,10917,10992,10741,251,10741
7505,134268,137211,134264,2947,134264,134264,137169,133551,3618,133551
7506,109300,112118,109261,2857,109261,109261,112108,107112,4996,107112
7507,9770,9768,9569,199,9569,9569,9770,8896,874,8896
7508,32151,32137,31381,756,31381,31381,32151,30790,1361,30790
7509,7292,7303,7294,9,7294,7292,7305,7154,151,7154
7510,51657,51648,52854,-1206,51648,51648,51658,51341,317,51341
7511,13442,12949,12823,126,12823,12823,12944,12666,278,12666
7512,39454,45382,41939,3443,41939,39454,45374,39472,5902,39454
7513,122553,122753,123867,-1114,122753,122553,122793,121593,1200,121593
7514,58055,22268,21886,382,21886,21886,22273,21676,597,21676
7515,21866,21399,20369,1030,20369,20369,21392,20129,1263,20129
7516,675648,652243,619946,32297,619946,619946,652334,614624,37710,614624
7517,32316,24550,25363,-813,24550,24550,24553,21830,2723,21830
7518,24921,24289,22869,1420,22869,22869,24291,22797,1494,22797
7519,64215,63499,61579,1920,61579,61579,63489,61144,2345,61144
7520,2533,2532,2745,-213,2532,2532,2533,2582,-49,2533
7521,4547,3779,3966,-187,3779,3779,3781,3560,221,3560
7522,45631,45608,43119,2489,43119,43119,45631,42795,2836,42795
7523,11892,7845,8192,-347,7845,7845,7844,4383,3461,4383
7524,122939,121230,115798,5432,115798,115798,121266,115345,5921,115345
7525,290059,290096,272638,17458,272638,272638,290059,267981,22078,267981
7526,122603,127375,122555,4820,122555,122555,127393,122293,5100,122293
7527,76566,75629,74231,1398,74231,74231,75625,72259,3366,72259
7528,57963,50958,50846,112,50846,50846,50989,49433,1556,49433
7529,1710,867,1109,-242,867,867,867,926,-59,926
7530,12116,8406,8334,72,8334,8334,8404,8242,162,8242
7531,441746,422754,407565,15189,407565,407565,422755,402155,20600,402155
7532,157524,156577,148940,7637,148940,148940,156571,147507,9064,147507
7533,226422,61309,59590,1719,59590,59590,61308,58815,2493,58815
7534,121316,108074,101692,6382,101692,101692,108094,101185,6909,101185
7535,415305,428348,416527,11821,416527,415305,428386,415305,13081,415305
7536,3248,2671,2853,-182,2671,2671,2671,2673,-2,2673
7537,9711,9081,9271,-190,9081,9081,9083,9003,80,9003
7538,51951,51920,49656,2264,49656,49656,51887,49517,2370,49517
7539,15708,14748,15014,-266,14748,14748,14762,14394,368,14394
7540,76006,74771,69348,5423,69348,69348,74777,67602,7175,67602
7541,2951,2816,2891,-75,2816,2816,2816,2762,54,2762
7542,10374,10795,10365,430,10365,10365,10802,9646,1156,9646
7543,189993,187090,184035,3055,184035,184035,187193,182900,4293,182900
7544,78014,77975,76804,1171,76804,76804,77999,75689,2310,75689
7545,39936,39960,38518,1442,38518,38518,39936,38451,1485,38451
7546,78608,73040,71106,1934,71106,71106,73061,70584,2477,70584
7547,19120,19051,18812,239,18812,18812,19059,18679,380,18679
7548,11355,11647,11389,258,11389,11355,11645,10733,912,10733
7549,78074,80260,77835,2425,77835,77835,80272,77452,2820,77452
7550,3860,3456,3626,-170,3456,3456,3456,3444,12,3444
7551,12446,12817,12608,209,12608,12446,12821,12446,375,12446
7552,33452,25997,25203,794,25203,25203,25999,25004,995,25004
7553,106409,105800,104789,1011,104789,104789,105855,103436,2419,103436
7554,7497,7104,7007,97,7007,7007,7103,6872,231,6872
7555,11903,11918,11775,143,11775,11775,11921,11506,415,11506
7556,144494,143863,138594,5269,138594,138594,143940,137823,6117,137823
7557,873701,753566,698111,55455,698111,698111,753681,677276,76405,677276
7558,10604,10492,10600,-108,10492,10492,10490,10329,161,10329
7559,4325,3909,3993,-84,3909,3909,3910,3773,137,3773
7560,25559,24627,23772,855,23772,23772,24631,23646,985,23646
7561,1007417,1043850,999507,44343,999507,999507,1043975,997825,46150,997825
7562,248786,259471,250249,9222,250249,248786,259429,248786,10643,248786
7563,5206,4083,4105,-22,4083,4083,4081,3972,109,3972
7564,357184,345880,333222,12658,333222,333222,345879,329385,16494,329385
7565,38439,35426,34121,1305,34121,34121,35426,33934,1492,33934
7566,218183,188524,181352,7172,181352,181352,188680,173315,15365,173315
7567,856884,863520,816260,47260,816260,816260,863606,810506,53100,810506
7568,133250,132333,127947,4386,127947,127947,132399,126632,5767,126632
7569,67664,66840,65093,1747,65093,65093,66849,64692,2157,64692
7570,2966,2499,2797,-298,2499,2499,2497,2569,-72,2569
7571,37808,34595,33571,1024,33571,33571,34604,32326,2278,32326
7572,57048,61043,56971,4072,56971,56971,61052,56883,4169,56883
7573,486313,445850,437143,8707,437143,437143,445787,437215,8572,437215
7574,18988,18466,18078,388,18078,18078,18465,17980,485,17980
7575,114951,122238,120112,2126,120112,114951,122278,114943,7335,114943
7576,4255,3752,3876,-124,3752,3752,3753,3731,22,3731
7577,117243,103815,97514,6301,97514,97514,103810,95857,7953,95857
7578,6928,6927,7083,-156,6927,6927,6938,6815,123,6815
7579,183164,189338,183161,6177,183161,183161,189410,182729,6681,182729
7580,3418,3279,3521,-242,3279,3279,3281,3302,-21,3302
7581,4200,4102,4193,-91,4102,4102,4102,4077,25,4077
7582,24176,24301,24357,-56,24301,24176,24304,24168,136,24168
7583,53788,53253,50776,2477,50776,50776,53246,50452,2794,50452
7584,105864,105035,100563,4472,100563,100563,105022,99670,5352,99670
7585,10549,10546,10571,-25,10546,10546,10549,10306,243,10306
7586,5881,5458,5502,-44,5458,5458,5465,5328,137,5328
7587,31185,31182,30929,253,30929,30929,31185,30643,542,30643
7588,189464,183816,175808,8008,175808,175808,183891,173328,10563,173328
7589,616243,616380,582635,33745,582635,582635,616243,574837,41406,574837
7590,284,284,519,-235,284,284,284,331,-47,284
7591,21048,20134,19919,215,19919,19919,20130,19806,324,19806
7592,627741,621261,603325,17936,603325,603325,621511,600483,21028,600483
7593,22127,21530,22125,-595,21530,21530,21531,21050,481,21050
7594,59991,57877,56050,1827,56050,56050,57886,55542,2344,55542
7595,79236,82927,79173,3754,79173,79173,82927,78607,4320,78607
7596,103026,72978,71174,1804,71174,71174,72988,70796,2192,70796
7597,843181,841748,801775,39973,801775,801775,841422,795480,45942,795480
7598,26708,26713,26086,627,26086,26086,26726,25872,854,25872
7599,14856,14428,14205,223,14205,14205,14433,14053,380,14053
7600,97831,95806,98340,-2534,95806,95806,95881,95967,-86,95967
7601,4568,4364,4458,-94,4364,4364,4363,4321,42,4321
7602,377661,335481,320657,14824,320657,320657,335372,319390,15982,319390
7603,27533,27528,26376,1152,26376,26376,27533,26129,1404,26129
7604,13400,13395,13619,-224,13395,13395,13400,13392,8,13392
7605,3240,3239,3314,-75,3239,3239,3240,3202,38,3202
7606,21239,21223,20240,983,20240,20240,21239,20044,1195,20044
7607,28852,27195,25790,1405,25790,25790,27204,25519,1685,25519
7608,293992,238541,234507,4034,234507,234507,238597,230402,8195,230402
7609,14084,14081,13952,129,13952,13952,14084,13731,353,13731
7610,21260,20662,20375,287,20375,20375,20658,20169,489,20169
7611,43988,43662,42414,1248,42414,42414,43667,42074,1593,42074
7612,8809,8359,8304,55,8304,8304,8357,8203,154,8203
7613,47489,46744,45532,1212,45532,45532,46734,44969,1765,44969
7614,25390,26261,25496,765,25496,25390,26261,25316,945,25316
7615,40741,41068,40672,396,40672,40672,41071,40157,914,40157
7616,22990,23212,22984,228,22984,22984,23213,22327,886,22327
7617,108417,98923,95151,3772,95151,95151,98914,94803,4111,94803
7618,34050,33307,32609,698,32609,32609,33310,32116,1194,32116
7619,39733,38200,36766,1434,36766,36766,38231,36343,1888,36343
7620,27481,27722,27366,356,27366,27366,27721,27049,672,27049
7621,9343,9309,9366,-57,9309,9309,9307,9156,151,9156
7622,64874,65234,65674,-440,65234,64874,65278,64252,1026,64252
7623,9196,8817,9203,-386,8817,8817,8820,8852,-32,8852
7624,2641,1735,2024,-289,1735,1735,1735,1806,-71,1806
7625,31924,31925,30647,1278,30647,30647,31924,30572,1352,30572
7626,35772,34370,34679,-309,34370,34370,34367,33690,677,33690
7627,6317,5865,5899,-34,5865,5865,5861,5738,123,5738
7628,3788,3789,3900,-111,3789,3788,3788,3773,15,3773
7629,58561,43404,41776,1628,41776,41776,43423,41591,1832,41591
7630,131246,114433,112441,1992,112441,112441,114397,111081,3316,111081
7631,199396,168462,161068,7394,161068,161068,168567,159640,8927,159640
7632,40850,40789,39359,1430,39359,39359,40802,38925,1877,38925
7633,1486,1384,1616,-232,1384,1384,1385,1444,-59,1444
7634,18375,13698,13920,-222,13698,13698,13702,13596,106,13596
7635,13094,13169,13095,74,13095,13094,13174,12940,234,12940
7636,29522,24485,24940,-455,24485,24485,24524,23205,1319,23205
7637,44174,44145,42568,1577,42568,42568,44141,42460,1681,42460
7638,345820,319900,305588,14312,305588,305588,319930,303378,16552,303378
7639,29240,29236,27990,1246,27990,27990,29240,27848,1392,27848
7640,11236,10925,10631,294,10631,10631,10926,10395,531,10395
7641,52977,34150,32712,1438,32712,32712,34151,31948,2203,31948
7642,168774,162157,151291,10866,151291,151291,162140,148754,13386,148754
7643,21111,17758,17778,-20,17758,17758,17748,17452,296,17452
7644,113912,115121,113347,1774,113347,113347,115133,113290,1843,113290
7645,5275,5275,5301,-26,5275,5275,5275,5214,61,5214
7646,71627,70748,68822,1926,68822,68822,70737,68247,2490,68247
7647,141898,140704,132472,8232,132472,132472,140743,132114,8629,132114
7648,140524,143369,140543,2826,140543,140524,143382,135954,7428,135954
7649,16498,16489,16021,468,16021,16021,16498,15968,530,15968
7650,74320,74294,70448,3846,70448,70448,74320,70174,4146,70174
7651,156283,165210,156255,8955,156255,156255,165272,156040,9232,156040
7652,52158,46503,46892,-389,46503,46503,46529,44509,2020,44509
7653,32265,31907,32269,-362,31907,31907,31911,31401,510,31401
7654,9689,9688,9813,-125,9688,9688,9690,9588,102,9588
7655,17166,17120,17147,-27,17120,17120,17124,16544,580,16544
7656,71118,59054,61295,-2241,59054,59054,59053,56538,2515,56538
7657,47211,46330,45221,1109,45221,45221,46343,44977,1366,44977
7658,105418,97580,93792,3788,93792,93792,97616,92820,4796,92820
7659,257617,249000,236692,12308,236692,236692,249001,234902,14099,234902
7660,10220,7576,7387,189,7387,7387,7585,6869,716,6869
7661,46620,46969,46322,647,46322,46322,46987,45998,989,45998
7662,86052,83243,79188,4055,79188,79188,83229,78784,4445,78784
7663,276959,276212,262907,13305,262907,262907,276405,262185,14220,262185
7664,63338,44296,43418,878,43418,43418,44302,42189,2113,42189
7665,238395,247367,240469,6898,240469,238395,247293,237841,9452,237841
7666,179279,179233,170576,8657,170576,170576,179279,167432,11847,167432
7667,253938,247433,237374,10059,237374,237374,247598,236153,11445,236153
7668,3944,3846,3961,-115,3846,3846,3846,3737,109,3737
7669,96047,88214,85611,2603,85611,85611,88221,84379,3842,84379
7670,41443,38850,37568,1282,37568,37568,38887,37369,1518,37369
7671,3787,3607,3806,-199,3607,3607,3607,3620,-13,3620
7672,116252,116200,115319,881,115319,115319,116233,109875,6358,109875
7673,133238,139847,135067,4780,135067,133238,139938,133238,6700,133238
7674,6917,6916,6936,-20,6916,6916,6917,6267,650,6267
7675,90166,86776,79104,7672,79104,79104,86795,78509,8286,78509
7676,10775,9223,9339,-116,9223,9223,9225,9138,87,9138
7677,18232,18245,17910,335,17910,17910,18254,17703,551,17703
7678,384746,403521,384717,18804,384717,384717,403505,381108,22397,381108
7679,3202,2811,3031,-220,2811,2811,2812,2851,-39,2851
7680,90240,88297,82105,6192,82105,82105,88234,81891,6343,81891
7681,12289,11890,11748,142,11748,11748,11885,11611,274,11611
7682,17484,17969,17484,485,17484,17484,17971,17356,615,17356
7683,4342,3927,4003,-76,3927,3927,3931,3884,47,3884
7684,50856,49195,46038,3157,46038,46038,49211,45895,3316,45895
7685,7998,7056,7021,35,7021,7021,7060,6880,180,6880
7686,109539,108796,104143,4653,104143,104143,108763,100822,7941,100822
7687,665766,706721,665615,41106,665615,665615,707046,661101,45945,661101
7688,51491,50966,49788,1178,49788,49788,50949,49525,1424,49525
7689,6078,5463,5624,-161,5463,5463,5465,5406,59,5406
7690,19639,18797,18323,474,18323,18323,18798,18357,441,18357
7691,10105,9552,9349,203,9349,9349,9551,9069,482,9069
7692,64604,63661,61690,1971,61690,61690,63656,61361,2295,61361
7693,115461,114259,114344,-85,114259,114259,114282,112414,1868,112414
7694,2588,2221,2430,-209,2221,2221,2221,2250,-29,2250
7695,446341,458468,447088,11380,447088,446341,458452,445238,13214,445238
7696,19678,18741,18025,716,18025,18025,18754,17869,885,17869
7697,7180,7166,7297,-131,7166,7166,7163,7153,10,7153
7698,4771,4118,4397,-279,4118,4118,4117,4142,-25,4142
7699,6244,6242,6265,-23,6242,6242,6244,6088,156,6088
7700,9761,9192,9001,191,9001,9001,9193,8953,240,8953
7701,45919,39976,37951,2025,37951,37951,40002,37436,2566,37436
7702,82820,88865,89900,-1035,88865,82820,88874,82812,6062,82812
7703,41194,40202,39843,359,39843,39843,40221,39202,1019,39202
7704,18954,10460,10134,326,10134,10134,10468,9969,499,9969
7705,5762,5524,5699,-175,5524,5524,5530,5364,166,5364
7706,27655,24940,24557,383,24557,24557,24942,24151,791,24151
7707,38566,38889,39329,-440,38889,38566,38908,38525,383,38525
7708,2767,2403,2574,-171,2403,2403,2404,2410,-6,2410
7709,13629,12949,13097,-148,12949,12949,12954,12839,115,12839
7710,2179,1965,2158,-193,1965,1965,1964,1997,-33,1997
7711,127830,122048,118025,4023,118025,118025,122011,117661,4350,117661
7712,58012,59313,58762,551,58762,58012,59312,58004,1308,58004
7713,13372,12936,12670,266,12670,12670,12935,12556,379,12556
7714,1182199,1071743,1037388,34355,1037388,1037388,1071564,1025305,46259,1025305
7715,8315,8315,8309,6,8309,8309,8315,8212,103,8212
7716,22127,22528,21872,656,21872,21872,22527,21538,989,21538
7717,1163872,1120206,1056670,63536,1056670,1056670,1120062,1038819,81243,1038819
7718,2412,2391,2584,-193,2391,2391,2391,2431,-40,2412
7719,18709,18684,17697,987,17697,17697,18683,17189,1494,17189
7720,5899,5531,5511,20,5511,5511,5534,5415,119,5415
7721,29655,21242,20632,610,20632,20632,21241,20567,674,20567
7722,24567,24579,24160,419,24160,24160,24585,23585,1000,23585
7723,24509,23573,22764,809,22764,22764,23578,22501,1077,22501
7724,15432,15430,14963,467,14963,14963,15432,14833,599,14833
7725,20928,19185,18197,988,18197,18197,19183,18095,1088,18095
7726,42279,40403,38572,1831,38572,38572,40412,37737,2675,37737
7727,11825,11825,11822,3,11822,11822,11839,11618,221,11618
7728,48953,48410,47039,1371,47039,47039,48399,46838,1561,46838
7729,269208,268162,266847,1315,266847,266847,268304,263689,4615,263689
7730,49406,48471,47348,1123,47348,47348,48490,46794,1696,46794
7731,6660,6659,6850,-191,6659,6659,6662,6512,150,6512
7732,8801,8342,8571,-229,8342,8342,8346,8302,44,8302
7733,74688,74624,71269,3355,71269,71269,74629,69491,5138,69491
7734,340253,303833,291308,12525,291308,291308,303882,287981,15901,287981
7735,49874,33535,32316,1219,32316,32316,33547,32192,1355,32192
7736,33024,33002,31092,1910,31092,31092,33024,30281,2743,30281
7737,501216,500143,484442,15701,484442,484442,500316,481567,18749,481567
7738,11446,9803,9798,5,9798,9798,9807,9725,82,9725
7739,1245917,1244652,1203950,40702,1203950,1203950,1244601,1192969,51632,1192969
7740,12499,11841,11499,342,11499,11499,11844,11443,401,11443
7741,16148,15611,15498,113,15498,15498,15603,15360,243,15360
7742,1302991,1342578,1310352,32226,1310352,1302991,1342867,1302991,39876,1302991
7743,30151,30325,30144,181,30144,30144,30338,29669,669,29669
7744,8542,8537,8575,-38,8537,8537,8542,8260,282,8260
7745,26129,8056,8200,-144,8056,8056,8058,8016,42,8016
7746,37953,38534,37624,910,37624,37624,38531,37511,1020,37511
7747,83562,77358,77123,235,77123,77123,77373,76013,1360,76013
7748,35439,34957,33808,1149,33808,33808,34956,33691,1265,33691
7749,17653,17605,17692,-87,17605,17605,17618,17382,236,17382
7750,7161,6630,6595,35,6595,6595,6631,6460,171,6460
7751,92261,91386,86825,4561,86825,86825,91416,86586,4830,86586
7752,31357,30375,29984,391,29984,29984,30379,29794,585,29794
7753,9737,9756,9648,108,9648,9648,9755,9574,181,9574
7754,124252,119954,112339,7615,112339,112339,119892,111539,8353,111539
7755,9244,8472,8283,189,8283,8283,8471,8212,259,8212
7756,74868,74812,71374,3438,71374,71374,74886,71015,3871,71015
7757,60395,52646,50356,2290,50356,50356,52664,50185,2479,50185
7758,145440,141265,135107,6158,135107,135107,141260,134813,6447,134813
7759,62912,62025,58904,3121,58904,58904,62056,58803,3253,58803
7760,261694,216575,206663,9912,206663,206663,216597,204216,12381,204216
7761,27331,23667,23353,314,23353,23353,23667,22245,1422,22245
7762,11318,11587,11255,332,11255,11255,11588,10993,595,10993
7763,14985,14988,14999,-11,14988,14985,14985,14763,222,14763
7764,3339,3338,3420,-82,3338,3338,3339,3331,8,3331
7765,2625,1715,1926,-211,1715,1715,1715,1757,-42,1757
7766,2105,1611,1822,-211,1611,1611,1610,1589,21,1589
7767,16694,12900,12662,238,12662,12662,12900,12560,340,12560
7768,160538,166471,166330,141,166330,160538,166482,159996,6486,159996
7769,34165,33228,33540,-312,33228,33228,33244,32661,583,32661
7770,25388,24828,24409,419,24409,24409,24834,24065,769,24065
7771,30767,31468,30767,701,30767,30767,31470,30190,1280,30190
7772,2157,1739,1971,-232,1739,1739,1738,1799,-61,1799
7773,1869,1866,2073,-207,1866,1866,1869,1864,5,1864
7774,13499,14411,14399,12,14399,13499,14415,13555,860,13499
7775,28353,28341,26973,1368,26973,26973,28353,26920,1433,26920
7776,6928,6669,6477,192,6477,6477,6674,6304,370,6304
7777,1780,1313,1468,-155,1313,1313,1312,1269,43,1269
7778,21895,20898,19621,1277,19621,19621,20893,19182,1711,19182
7779,10793,9975,9827,148,9827,9827,9980,9461,519,9461
7780,108041,105352,103767,1585,103767,103767,105377,102549,2828,102549
7781,76031,78873,75475,3398,75475,75475,78870,75174,3696,75174
7782,387676,409871,390623,19248,390623,387676,409636,387646,21990,387646
7783,1397,1396,1631,-235,1396,1396,1397,1458,-61,1397
7784,111077,107185,100217,6968,100217,100217,107200,99880,7320,99880
7785,36944,36184,35546,638,35546,35546,36184,35233,951,35233
7786,26919,27411,26912,499,26912,26912,27423,26697,726,26697
7787,24827,24937,24596,341,24596,24596,24944,24205,739,24205
7788,2238,1864,2107,-243,1864,1864,1865,1919,-54,1919
7789,18622,18093,17574,519,17574,17574,18092,17440,652,17440
7790,10805,10732,10748,-16,10732,10732,10729,10396,333,10396
7791,11880,11278,11011,267,11011,11011,11285,10685,600,10685
7792,250875,250275,245011,5264,245011,245011,250321,243834,6487,243834
7793,111909,104943,99146,5797,99146,99146,104929,98641,6288,98641
7794,89331,95329,89236,6093,89236,89236,95277,85819,9458,85819
7795,6853,6381,6450,-69,6381,6381,6382,6260,122,6260
7796,215658,215590,219936,-4346,215590,215590,215676,212193,3483,212193
7797,1957498,669090,647049,22041,647049,647049,669303,631754,37549,631754
7798,32473,32429,31841,588,31841,31841,32430,31471,959,31471
7799,425814,425000,411183,13817,411183,411183,424973,400586,24387,400586
7800,17265,16814,16376,438,16376,16376,16801,16232,569,16232
7801,5479,5125,5156,-31,5125,5125,5126,5008,118,5008
7802,464237,464281,444559,19722,444559,444559,464274,440190,24084,440190
7803,36462,36998,37561,-563,36998,36462,37005,36416,589,36416
7804,10727,10695,10664,31,10664,10664,10689,10494,195,10494
7805,320122,298213,282801,15412,282801,282801,298176,278276,19900,278276
7806,488622,489713,469522,20191,469522,469522,489442,464050,25392,464050
7807,137928,137084,130092,6992,130092,130092,137169,128378,8791,128378
7808,190010,189079,179803,9276,179803,179803,189080,176577,12503,176577
7809,21900,22252,21630,622,21630,21630,22249,21278,971,21278
7810,37537,36170,34972,1198,34972,34972,36169,34907,1262,34907
7811,15659,15193,14931,262,14931,14931,15195,14728,467,14728
7812,163763,162764,155374,7390,155374,155374,162780,154393,8387,154393
7813,2021,2021,2287,-266,2021,2021,2021,2064,-43,2021
7814,135293,128448,122656,5792,122656,122656,128442,121067,7375,121067
7815,41484,12570,12437,133,12437,12437,12570,12350,220,12350
7816,13375,13269,13421,-152,13269,13269,13263,13181,82,13181
7817,20362,19834,19686,148,19686,19686,19839,19513,326,19513
7818,435880,434908,415758,19150,415758,415758,434916,412180,22736,412180
7819,55264,57592,60198,-2606,57592,55264,57574,55231,2343,55231
7820,1059,1018,1241,-223,1018,1018,1017,1077,-60,1059
7821,147474,153122,147473,5649,147473,147473,153127,143312,9815,143312
7822,29335,29318,28226,1092,28226,28226,29324,26240,3084,26240
7823,18399,18387,18341,46,18341,18341,18399,18031,368,18031
7824,13799,12911,12600,311,12600,12600,12920,12419,501,12419
7825,404368,415891,407621,8270,407621,404368,415896,404368,11528,404368
7826,16075,3279,3476,-197,3279,3279,3282,3294,-12,3294
7827,24140,23626,23003,623,23003,23003,23623,22835,788,22835
7828,22678,22140,21661,479,21661,21661,22142,21463,679,21463
7829,8076,7239,7298,-59,7239,7239,7239,7007,232,7007
7830,49098,47254,48169,-915,47254,47254,47285,47283,2,47283
7831,3904,3861,3988,-127,3861,3861,3861,3845,16,3845
7832,26628,14773,14134,639,14134,14134,14777,13939,838,13939
7833,109059,116866,112756,4110,112756,109059,116908,108970,7938,108970
7834,47929,47268,46538,730,46538,46538,47279,46042,1237,46042
7835,34927,35091,34410,681,34410,34410,35097,34305,792,34305
7836,50873,44538,44969,-431,44538,44538,44559,44345,214,44345
7837,12268,12247,12093,154,12093,12093,12251,10816,1435,10816
7838,1430,1447,1668,-221,1447,1430,1448,1498,-50,1430
7839,50994,53454,52583,871,52583,50994,53471,50986,2485,50986
7840,48949,35489,34882,607,34882,34882,35482,32676,2806,32676
7841,9466,9442,9363,79,9363,9363,9439,9176,263,9176
7842,19820,20221,19817,404,19817,19817,20232,19451,781,19451
7843,80912,80861,77725,3136,77725,77725,80871,76926,3945,76926
7844,118695,117740,111697,6043,111697,111697,117755,109539,8216,109539
7845,60105,58897,57891,1006,57891,57891,58891,57549,1342,57549
7846,13245,12564,12112,452,12112,12112,12564,11924,640,11924
7847,83446,82396,82958,-562,82396,82396,82455,80880,1575,80880
7848,17902,17299,17009,290,17009,17009,17297,16802,495,16802
7849,357401,340178,326601,13577,326601,326601,340314,324273,16041,324273
7850,3142,3042,3079,-37,3042,3042,3043,2875,168,2875
7851,353322,330977,327659,3318,327659,327659,330929,323455,7474,323455
7852,83681,85991,82633,3358,82633,82633,85998,81379,4619,81379
7853,181125,179819,173789,6030,173789,173789,179822,172612,7210,172612
7854,43908,42137,40537,1600,40537,40537,42165,40117,2048,40117
7855,65867,58860,56537,2323,56537,56537,58883,56515,2368,56515
7856,26204,27318,26186,1132,26186,26186,27334,25988,1346,25988
7857,54846,50676,48721,1955,48721,48721,50714,47843,2871,47843
7858,5259,4749,4881,-132,4749,4749,4747,4701,46,4701
7859,112623,109334,104953,4381,104953,104953,109318,104666,4652,104666
7860,123695,126386,124521,1865,124521,123695,126425,123697,2728,123695
7861,52075,51118,51140,-22,51118,51118,51137,49871,1266,49871
7862,37970,36905,36072,833,36072,36072,36910,35822,1088,35822
7863,11087,10553,10472,81,10472,10472,10556,10347,209,10347
7864,19348,19356,19098,258,19098,19098,19354,18562,792,18562
7865,78250,75008,72474,2534,72474,72474,75005,72001,3004,72001
7866,5398,5002,5045,-43,5002,5002,5001,4920,81,4920
7867,43546,43532,42436,1096,42436,42436,43546,42331,1215,42331
7868,14586,14587,13627,960,13627,13627,14586,12532,2054,12532
7869,12530,12886,12466,420,12466,12466,12887,12239,648,12239
7870,1898,991,1226,-235,991,991,988,1035,-47,1035
7871,34418,34442,32943,1499,32943,32943,34436,31064,3372,31064
7872,8535,8773,8475,298,8475,8475,8772,8174,598,8174
7873,15019,12901,12614,287,12614,12614,12895,12484,411,12484
7874,314,314,549,-235,314,314,314,359,-45,314
7875,284,284,519,-235,284,284,284,331,-47,284
7876,2179,2183,2327,-144,2183,2179,2179,2194,-15,2179
7877,19403,18559,18168,391,18168,18168,18562,17980,582,17980
7878,3875,3020,3204,-184,3020,3020,3017,3068,-51,3068
7879,312625,327457,312582,14875,312582,312582,327393,311040,16353,311040
7880,54542,52065,50177,1888,50177,50177,52066,49869,2197,49869
7881,17003,16949,16671,278,16671,16671,16951,16203,748,16203
7882,11694,11997,11989,8,11989,11694,11999,11666,333,11666
7883,50558,49498,47521,1977,47521,47521,49484,47356,2128,47356
7884,83835,83868,79497,4371,79497,79497,83877,75418,8459,75418
7885,37202,37176,36441,735,36441,36441,37177,35822,1355,35822
7886,6305645,5711474,5540585,170889,5540585,5540585,5710308,5486994,223314,5486994
7887,14434,14437,14256,181,14256,14256,14434,14109,325,14109
7888,126955,124084,115965,8119,115965,115965,124062,115720,8342,115720
7889,8428018,237994,223202,14792,223202,223202,238070,222306,15764,222306
7890,80062,81546,79971,1575,79971,79971,81563,79758,1805,79758
7891,6910,6354,6242,112,6242,6242,6356,5760,596,5760
7892,29726,29738,28898,840,28898,28898,29744,28777,967,28777
7893,125588,124398,122104,2294,122104,122104,124388,120764,3624,120764
7894,475833,475179,459246,15933,459246,459246,475279,451825,23454,451825
7895,6609,6735,6755,-20,6735,6609,6733,5987,746,5987
7896,280513,293630,280380,13250,280380,280380,293673,279085,14588,279085
7897,170993,155598,146510,9088,146510,146510,155669,144107,11562,144107
7898,2391,2017,2209,-192,2017,2017,2015,2059,-44,2059
7899,13649,12753,12412,341,12412,12412,12750,12117,633,12117
7900,31399,30357,29122,1235,29122,29122,30361,29000,1361,29000
7901,43335,43126,43439,-313,43126,43126,43162,42713,449,42713
7902,140444,138949,136170,2779,136170,136170,139011,135432,3579,135432
7903,8875,8745,8810,-65,8745,8745,8749,8551,198,8551
7904,3963,3442,3567,-125,3442,3442,3444,3449,-5,3449
7905,148120,147486,138008,9478,138008,138008,147566,137823,9743,137823
7906,3710,3277,3372,-95,3277,3277,3277,3201,76,3201
7907,46563,33398,33413,-15,33398,33398,33405,33087,318,33087
7908,34089,34089,33306,783,33306,33306,34089,33223,866,33223
7909,154483,178858,193688,-14830,178858,154483,178921,154475,24446,154475
7910,22611,22594,22277,317,22277,22277,22611,21950,661,21950
7911,18575,14996,14752,244,14752,14752,14998,14637,361,14637
7912,82493,87386,84192,3194,84192,82493,87385,82408,4977,82408
7913,181609,174411,165208,9203,165208,165208,174384,164363,10021,164363
7914,439,419,658,-239,419,419,419,456,-37,439
7915,20601,20828,20827,1,20827,20601,20830,20568,262,20568
7916,2299,2302,2554,-252,2302,2299,2303,2346,-43,2299
7917,4138,3299,3565,-266,3299,3299,3302,3308,-6,3308
7918,21321,20809,20498,311,20498,20498,20811,20142,669,20142
7919,30226,29594,29059,535,29059,29059,29592,28838,754,28838
7920,54192,31157,30987,170,30987,30987,31160,30618,542,30618
7921,348209,303938,296434,7504,296434,296434,303989,294788,9201,294788
7922,20442,19397,19484,-87,19397,19397,19404,19209,195,19209
7923,218144,232366,218096,14270,218096,218096,232252,216187,16065,216187
7924,60649,60641,59071,1570,59071,59071,60649,58629,2020,58629
7925,245806,244882,244344,538,244344,244344,244919,238853,6066,238853
7926,23414,23416,22697,719,22697,22697,23414,22538,876,22538
7927,14894,13592,13372,220,13372,13372,13586,12987,599,12987
7928,21767,21123,21156,-33,21123,21123,21122,20804,318,20804
7929,125516,125476,122037,3439,122037,122037,125516,120170,5346,120170
7930,29083,29584,29492,92,29492,29083,29591,29031,560,29031
7931,57779,57754,54816,2938,54816,54816,57779,54302,3477,54302
7932,68264,68286,64931,3355,64931,64931,68264,64806,3458,64806
7933,65062,65088,67368,-2280,65088,65062,65062,63883,1179,63883
7934,1099,803,1040,-237,803,803,804,858,-54,858
7935,128779,128790,126133,2657,126133,126133,128779,124992,3787,124992
7936,8216,8317,8152,165,8152,8152,8315,7822,493,7822
7937,82001,81003,77908,3095,77908,77908,80954,77590,3364,77590
7938,5997,5225,5321,-96,5225,5225,5225,5106,119,5106
7939,105961,105108,104655,453,104655,104655,105138,102728,2410,102728
7940,9574,9010,9146,-136,9010,9010,9014,8932,82,8932
7941,70921,70915,70995,-80,70915,70915,70921,69739,1182,69739
7942,15752,15277,14539,738,14539,14539,15267,14484,783,14484
7943,6228,6204,6219,-15,6204,6204,6205,5861,344,5861
7944,78550,72799,69288,3511,69288,69288,72770,68684,4086,68684
7945,278752,246383,221722,24661,221722,221722,246406,210155,36251,210155
7946,2685,2631,2873,-242,2631,2631,2634,2685,-51,2685
7947,41184,40530,39198,1332,39198,39198,40538,38874,1664,38874
7948,23095,23047,22601,446,22601,22601,23047,22482,565,22482
7949,37486,20593,20189,404,20189,20189,20592,19942,650,19942
7950,25578,24367,23300,1067,23300,23300,24383,22767,1616,22767
7951,36271,35059,33988,1071,33988,33988,35064,33783,1281,33783
7952,74657,71735,68563,3172,68563,68563,71715,68269,3446,68269
7953,44485,52389,48609,3780,48609,44485,52399,44485,7914,44485
7954,9337,10131,10390,-259,10131,9337,10130,9337,793,9337
7955,65531,63892,62121,1771,62121,62121,63914,61804,2110,61804
7956,45627,13952,13996,-44,13952,13952,13958,13801,157,13801
7957,1284382,1262598,1257177,5421,1257177,1257177,1262898,1228938,33960,1228938
7958,32300,33282,32538,744,32538,32300,33284,32300,984,32300
7959,7384,7298,7382,-84,7298,7298,7300,7093,207,7093
7960,34157,34117,33743,374,33743,33743,34118,33386,732,33386
7961,20204,19669,19317,352,19317,19317,19667,19162,505,19162
7962,2111,1181,1407,-226,1181,1181,1181,1236,-55,1236
7963,6680,6204,6302,-98,6204,6204,6206,6147,59,6147
7964,10740,8808,8972,-164,8808,8808,8808,7933,875,7933
7965,7547,6976,6922,54,6922,6922,6980,6643,337,6643
7966,27215,26622,26149,473,26149,26149,26611,25954,657,25954
7967,14404,13968,13931,37,13931,13931,13970,13732,238,13732
7968,303490,247682,229716,17966,229716,229716,247781,223382,24399,223382
7969,1422,1023,1246,-223,1023,1023,1023,1080,-57,1080
7970,614603,42408,37777,4631,37777,37777,42404,35587,6817,35587
7971,150386,150365,151945,-1580,150365,150365,150386,147849,2537,147849
7972,6785,6379,6521,-142,6379,6379,6387,6327,60,6327
7973,8771,8773,8686,87,8686,8686,8771,8584,187,8584
7974,12248,12410,12343,67,12343,12248,12410,12248,162,12248
7975,42756,44840,43060,1780,43060,42756,44851,42756,2095,42756
7976,15423,14856,14776,80,14776,14776,14858,14581,277,14581
7977,523045,518352,487834,30518,487834,487834,518174,486225,31949,486225
7978,371183,327856,307712,20144,307712,307712,327889,304398,23491,304398
7979,2815,2776,2910,-134,2776,2776,2774,2750,24,2750
7980,11288,10648,10562,86,10562,10562,10653,10362,291,10362
7981,165804,175518,165776,9742,165776,165776,175598,164907,10691,164907
7982,73025,46071,44796,1275,44796,44796,46061,44444,1617,44444
7983,12700,12656,12641,15,12641,12641,12653,12476,177,12476
7984,34526,34686,34447,239,34447,34447,34697,34132,565,34132
7985,53567,57264,59212,-1948,57264,53567,57297,53524,3773,53524
7986,5632,4676,4783,-107,4676,4676,4677,4422,255,4422
7987,57206,30156,30335,-179,30156,30156,30174,29759,415,29759
7988,348456,316862,312675,4187,312675,312675,316845,309396,7449,309396
7989,22727,20536,18710,1826,18710,18710,20542,18295,2247,18295
7990,157370,134927,125800,9127,125800,125800,135005,123905,11100,123905
7991,30482,31057,30585,472,30585,30482,31072,30448,624,30448
7992,9754,8726,8628,98,8628,8628,8723,8465,258,8465
7993,18862,16007,15147,860,15147,15147,16007,14969,1038,14969
7994,141672,148096,150592,-2496,148096,141672,148129,141664,6465,141664
7995,92211,91340,89172,2168,89172,89172,91320,88615,2705,88615
7996,6501,5504,5543,-39,5504,5504,5506,5427,79,5427
7997,7512,7513,7446,67,7446,7446,7512,7281,231,7281
7998,5695,5318,5283,35,5283,5283,5320,5162,158,5162
7999,5515,4684,4821,-137,4684,4684,4686,4525,161,4525
8000,184948,193003,184891,8112,184891,184891,193126,183510,9616,183510
8001,54080,54982,53517,1465,53517,53517,54975,53054,1921,53054
8002,4410,3923,4111,-188,3923,3923,3923,3932,-9,3932
8003,7238,6505,6437,68,6437,6437,6500,6183,317,6183
8004,7615,7095,6941,154,6941,6941,7092,6790,302,6790
8005,39571,39545,39531,14,39531,39531,39571,39024,547,39024
8006,83792,83730,79756,3974,79756,79756,83760,74244,9516,74244
8007,16094,16091,16383,-292,16091,16091,16094,16074,20,16074
8008,390427,354532,341705,12827,341705,341705,354693,333847,20846,333847
8009,384557,384481,372528,11953,372528,372528,384557,367943,16614,367943
8010,9659,9564,9546,18,9546,9546,9559,9182,377,9182
8011,96314,74988,72053,2935,72053,72053,74947,71949,2998,71949
8012,4456,4832,4788,44,4788,4456,4828,4456,372,4456
8013,23470,23910,23710,200,23710,23470,23913,23470,443,23470
8014,46128,42983,42152,831,42152,42152,42983,41268,1715,41268
8015,218542,217274,215323,1951,215323,215323,217240,199180,18060,199180
8016,5354,4880,4906,-26,4880,4880,4881,4739,142,4739
8017,40193,40397,40179,218,40179,40179,40402,39330,1072,39330
8018,334946,333802,317281,16521,317281,317281,333804,305878,27926,305878
8019,206473,155812,148261,7551,148261,148261,155843,147364,8479,147364
8020,3294,2922,3067,-145,2922,2922,2919,2925,-6,2925
8021,74659,74882,75899,-1017,74882,74659,74887,74651,236,74651
8022,22636,23970,23521,449,23521,22636,23976,22014,1962,22014
8023,243967,238792,229436,9356,229436,229436,238873,223512,15361,223512
8024,10735,10731,11021,-290,10731,10731,10735,10727,8,10727
8025,15021,14463,13887,576,13887,13887,14467,13513,954,13513
8026,43442,42887,41094,1793,41094,41094,42888,40957,1931,40957
8027,2384,1938,2086,-148,1938,1938,1939,1917,22,1917
8028,12027,12025,11924,101,11924,11924,12027,11744,283,11744
8029,120411,114044,119159,-5115,114044,114044,114024,113093,931,113093
8030,45843,43648,42827,821,42827,42827,43671,42467,1204,42467
8031,147650,148231,151402,-3171,148231,147650,148225,147857,368,147650
8032,14025,13438,13529,-91,13438,13438,13447,13331,116,13331
8033,50043,49903,46889,3014,46889,46889,49933,46748,3185,46748
8034,44937,44090,42787,1303,42787,42787,44117,42351,1766,42351
8035,165749,161914,151807,10107,151807,151807,161839,145787,16052,145787
8036,56129,52911,53075,-164,52911,52911,52921,51612,1309,51612
8037,9783,9778,9917,-139,9778,9778,9783,9649,134,9649
8038,3507,2932,3060,-128,2932,2932,2931,2941,-10,2941
8039,9239,9236,9227,9,9227,9227,9239,9012,227,9012
8040,24752,23987,23996,-9,23987,23987,24002,23583,419,23583
8041,8120,8119,8123,-4,8119,8119,8122,7976,146,7976
8042,33644,32209,32014,195,32014,32014,32221,31585,636,31585
8043,11817,11817,11738,79,11738,11738,11817,11232,585,11232
8044,35084,34982,33914,1068,33914,33914,34991,33748,1243,33748
8045,4035,4032,4200,-168,4032,4032,4035,4065,-30,4035
8046,967705,929307,898206,31101,898206,898206,929422,891490,37932,891490
8047,30264,16040,15617,423,15617,15617,16032,15410,622,15410
8048,23880,23192,22703,489,22703,22703,23196,22579,617,22579
8049,14805,11605,11279,326,11279,11279,11605,11181,424,11181
8050,109587,108440,103613,4827,103613,103613,108436,98321,10115,98321
8051,422111,397476,384703,12773,384703,384703,397480,383219,14261,383219
8052,213742,214076,206564,7512,206564,206564,214154,203547,10607,203547
8053,10554,9980,9745,235,9745,9745,9979,9589,390,9589
8054,15271,15285,14545,740,14545,14545,15289,14050,1239,14050
8055,72016,71082,68212,2870,68212,68212,71103,66209,4894,66209
8056,7065,6533,6541,-8,6533,6533,6535,6454,81,6454
8057,15281,15292,15048,244,15048,15048,15281,14972,309,14972
8058,11281,12107,11703,404,11703,11281,12119,11276,843,11276
8059,13729,13558,13866,-308,13558,13558,13565,13485,80,13485
8060,17910,17906,17256,650,17256,17256,17910,17178,732,17178
8061,1112,790,1050,-260,790,790,790,849,-59,849
8062,38195,36949,35266,1683,35266,35266,36937,34839,2098,34839
8063,3222,3206,3379,-173,3206,3206,3205,3222,-17,3222
8064,335332,335113,322923,12190,322923,322923,335216,319943,15273,319943
8065,253826,269194,253820,15374,253820,253820,269088,250644,18444,250644
8066,133806,132318,125340,6978,125340,125340,132366,125136,7230,125136
8067,181407,163259,155869,7390,155869,155869,163275,154521,8754,154521
8068,156682,165990,157712,8278,157712,156682,166027,154779,11248,154779
8069,6151,5406,5571,-165,5406,5406,5408,5456,-48,5456
8070,252586,237989,224157,13832,224157,224157,237957,223349,14608,223349
8071,67712,64006,58720,5286,58720,58720,64006,58438,5568,58438
8072,3863,3382,3679,-297,3382,3382,3381,3379,2,3379
8073,130510,129950,125081,4869,125081,125081,129956,124212,5744,124212
8074,5025,4553,4626,-73,4553,4553,4559,4457,102,4457
8075,7629,7008,7040,-32,7008,7008,7007,7007,0,7007
8076,7894,6389,6666,-277,6389,6389,6390,6203,187,6203
8077,8229,8232,8160,72,8160,8160,8229,7950,279,7950
8078,290873,272721,254805,17916,254805,254805,272851,254053,18798,254053
8079,184310,186850,185565,1285,185565,184310,186869,184302,2567,184302
8080,48149,45866,46072,-206,45866,45866,45866,45103,763,45103
8081,18256,17833,17274,559,17274,17274,17839,17183,656,17183
8082,12427,12404,12259,145,12259,12259,12396,11919,477,11919
8083,49190,47436,46507,929,46507,46507,47433,46208,1225,46208
8084,501277,501107,485896,15211,485896,485896,501277,482322,18955,482322
8085,147451,147473,139643,7830,139643,139643,147451,139308,8143,139308
8086,466401,466289,435846,30443,435846,435846,466401,431892,34509,431892
8087,480277,469015,449290,19725,449290,449290,469018,445362,23656,445362
8088,19706,19250,18672,578,18672,18672,19242,18470,772,18470
8089,45590,45584,43287,2297,43287,43287,45590,43142,2448,43142
8090,16999,16303,16020,283,16020,16020,16307,15728,579,15728
8091,6894,6176,6381,-205,6176,6176,6190,6129,61,6129
8092,222828,188225,184856,3369,184856,184856,188256,182629,5627,182629
8093,5272,4588,4566,22,4566,4566,4592,4317,275,4317
8094,57416,54478,52212,2266,52212,52212,54492,51634,2858,51634
8095,24476,23958,23091,867,23091,23091,23950,22882,1068,22882
8096,7150,6621,6691,-70,6621,6621,6620,6450,170,6450
8097,13329,13290,13110,180,13110,13110,13297,12779,518,12779
8098,11878,10496,10302,194,10302,10302,10480,9706,774,9706
8099,14663,14664,14669,-5,14664,14663,14667,13786,881,13786
8100,412939,404591,390331,14260,390331,390331,404689,387177,17512,387177
8101,2739,2738,2944,-206,2738,2738,2739,2798,-59,2739
8102,48120,44901,45172,-271,44901,44901,44940,44189,751,44189
8103,46221,46217,44904,1313,44904,44904,46221,44686,1535,44686
8104,58404,61520,58391,3129,58391,58391,61508,58226,3282,58226
8105,80656,82187,81093,1094,81093,80656,82197,80934,1263,80656
8106,75367,75540,73297,2243,73297,73297,75558,72816,2742,72816
8107,9227,9227,9145,82,9145,9145,9227,9039,188,9039
8108,9960,10241,10732,-491,10241,9960,10240,10107,133,9960
8109,2035,1080,1308,-228,1080,1080,1080,1137,-57,1137
8110,17418,17476,17467,9,17467,17418,17476,17376,100,17376
8111,85464,84456,81529,2927,81529,81529,84479,80839,3640,80839
8112,29174,25062,24826,236,24826,24826,25065,24572,493,24572
8113,2466,2100,2279,-179,2100,2100,2098,2115,-17,2115
8114,730059,723483,697964,25519,697964,697964,723655,689314,34341,689314
8115,37741,30131,29943,188,29943,29943,30137,27761,2376,27761
8116,28736,28604,27817,787,27817,27817,28602,27663,939,27663
8117,73150,75356,73362,1994,73362,73150,75354,72604,2750,72604
8118,27659,11299,11171,128,11171,11171,11296,10251,1045,10251
8119,27669,10400,10377,23,10377,10377,10406,10123,283,10123
8120,9779,10020,10008,12,10008,9779,10022,9778,244,9778
8121,60816,61839,60744,1095,60744,60744,61814,60308,1506,60308
8122,131533,131555,126765,4790,126765,126765,131533,126303,5230,126303
8123,14580,14025,13917,108,13917,13917,14026,13697,329,13697
8124,16847,13085,12902,183,12902,12902,13093,12689,404,12689
8125,2283,2281,2427,-146,2281,2281,2283,2070,213,2070
8126,4146,3904,4093,-189,3904,3904,3909,3926,-17,3926
8127,7658,7248,7157,91,7157,7157,7249,7025,224,7025
8128,7613,6560,6637,-77,6560,6560,6561,6488,73,6488
8129,128512,128571,124186,4385,124186,124186,128530,123908,4622,123908
8130,795860,788391,758851,29540,758851,758851,788517,755967,32550,755967
8131,10615,10228,10093,135,10093,10093,10229,9947,282,9947
8132,1517,1330,1535,-205,1330,1330,1328,1371,-43,1371
8133,4987,4895,5044,-149,4895,4895,4895,4913,-18,4913
8134,612501,611902,585052,26850,585052,585052,611947,582191,29756,582191
8135,35173,35166,32593,2573,32593,32593,35173,31916,3257,31916
8136,13499,13580,13435,145,13435,13435,13585,13154,431,13154
8137,22692,22695,22488,207,22488,22488,22692,22177,515,22177
8138,6298,1322,1531,-209,1322,1322,1322,1369,-47,1369
8139,34630,32492,32018,474,32018,32018,32490,31936,554,31936
8140,62957,59292,56125,3167,56125,56125,59296,55344,3952,55344
8141,183577,183489,176005,7484,176005,176005,183489,175278,8211,175278
8142,24275,24264,23504,760,23504,23504,24275,23297,978,23297
8143,8406,8404,8406,-2,8404,8404,8406,8275,131,8275
8144,12368,12363,11959,404,11959,11959,12368,11450,918,11450
8145,161338,159929,155059,4870,155059,155059,159934,154442,5492,154442
8146,3897,3466,3777,-311,3466,3466,3468,3507,-39,3507
8147,12527,12519,12519,0,12519,12519,12527,11820,707,11820
8148,268371,250811,238320,12491,238320,238320,250804,234459,16345,234459
8149,13157,12602,12647,-45,12602,12602,12603,12446,157,12446
8150,15678,15677,15956,-279,15677,15677,15678,15625,53,15625
8151,87009,86946,83552,3394,83552,83552,86948,83272,3676,83272
8152,11422,10914,10771,143,10771,10771,10912,10656,256,10656
8153,34519,35181,34527,654,34527,34519,35198,34128,1070,34128
8154,49325,51066,49426,1640,49426,49325,51067,49325,1742,49325
8155,3463,3442,3671,-229,3442,3442,3442,3473,-31,3463
8156,11024,10542,10545,-3,10542,10542,10538,10363,175,10363
8157,24004,23993,23633,360,23633,23633,23995,23432,563,23432
8158,91641,90383,90425,-42,90383,90383,90405,89560,845,89560
8159,797405,863610,790006,73604,790006,790006,863829,772686,91143,772686
8160,14002,13986,13642,344,13642,13642,13980,13453,527,13453
8161,142046,134370,128322,6048,128322,128322,134380,128106,6274,128106
8162,8290,4799,5063,-264,4799,4799,4797,4644,153,4644
8163,40549,40535,40239,296,40239,40239,40549,39710,839,39710
8164,19409,19572,19404,168,19404,19404,19584,19227,357,19227
8165,36825,37121,36942,179,36942,36825,37136,36203,933,36203
8166,11409,10878,11038,-160,10878,10878,10888,10703,185,10703
8167,14747,14269,14026,243,14026,14026,14264,13885,379,13885
8168,1259,1038,1259,-221,1038,1038,1038,1087,-49,1087
8169,113938,113115,108820,4295,108820,108820,113124,107758,5366,107758
8170,2185,1885,2124,-239,1885,1885,1885,1917,-32,1917
8171,58608,57725,58385,-660,57725,57725,57752,56600,1152,56600
8172,13167,12597,12375,222,12375,12375,12598,12217,381,12217
8173,131182,89391,86071,3320,86071,86071,89378,84542,4836,84542
8174,2238,2257,2507,-250,2257,2238,2254,2252,2,2238
8175,16534,15945,16333,-388,15945,15945,15956,15912,44,15912
8176,6803,6631,6806,-175,6631,6631,6635,6641,-6,6641
8177,6704,6522,6702,-180,6522,6522,6519,6476,43,6476
8178,3289,3289,3379,-90,3289,3289,3289,3220,69,3220
8179,71617,73812,71617,2195,71617,71617,73799,70590,3209,70590
8180,2868097,2865029,2683982,181047,2683982,2683982,2864935,2644442,220493,2644442
8181,25551,24991,24255,736,24255,24255,24997,24103,894,24103
8182,121868,116570,111218,5352,111218,111218,116530,110031,6499,110031
8183,2542,2401,2542,-141,2401,2401,2400,2405,-5,2405
8184,12692,12815,12690,125,12690,12690,12824,12469,355,12469
8185,144505,148469,143930,4539,143930,143930,148584,139231,9353,139231
8186,26405,26268,25996,272,25996,25996,26279,25783,496,25783
8187,53773,54654,54214,440,54214,53773,54673,53908,765,53773
8188,60924,55092,52553,2539,52553,52553,55067,50859,4208,50859
8189,71338,73312,71332,1980,71332,71332,73337,70539,2798,70539
8190,15917,16424,15910,514,15910,15910,16417,15827,590,15827
8191,16679,15977,15464,513,15464,15464,15976,15482,494,15482
8192,122512,126645,122521,4124,122521,122512,126667,121890,4777,121890
8193,24065,24213,24139,74,24139,24065,24199,23837,362,23837
8194,8016,6663,6849,-186,6663,6663,6663,6667,-4,6667
8195,65486,65430,64038,1392,64038,64038,65435,63060,2375,63060
8196,63731,64147,63714,433,63714,63714,64171,62803,1368,62803
8197,125537,128445,127345,1100,127345,125537,128464,125529,2935,125529
8198,56962,56914,57821,-907,56914,56914,56962,56722,240,56722
8199,13688,11917,11823,94,11823,11823,11914,11155,759,11155
8200,84573,43258,41225,2033,41225,41225,43242,40801,2441,40801
8201,20213,20666,20773,-107,20666,20213,20649,20369,280,20213
8202,60597,59410,57357,2053,57357,57357,59381,57180,2201,57180
8203,14025,14017,13520,497,13520,13520,14025,12928,1097,12928
8204,108888,108280,110551,-2271,108280,108280,108303,108771,-468,108771
8205,23064,3840,3881,-41,3840,3840,3841,3792,49,3792
8206,262952,270771,264486,6285,264486,262952,270874,262012,8862,262012
8207,33242,32562,31514,1048,31514,31514,32569,31390,1179,31390
8208,17727,17209,17328,-119,17209,17209,17207,17105,102,17105
8209,158155,157943,149153,8790,149153,149153,158045,148745,9300,148745
8210,9645,9929,9582,347,9582,9582,9928,9540,388,9540
8211,1370,702,972,-270,702,702,702,748,-46,748
8212,9371,8893,8641,252,8641,8641,8894,8527,367,8527
8213,9898,9000,9184,-184,9000,9000,9006,8739,267,8739
8214,180206,154790,143581,11209,143581,143581,154733,143223,11510,143223
8215,6402,6026,6025,1,6025,6025,6023,5905,118,5905
8216,26008,25877,25002,875,25002,25002,25874,24859,1015,24859
8217,57989,55222,52554,2668,52554,52554,55256,52213,3043,52213
8218,63646,40324,39436,888,39436,39436,40331,39219,1112,39219
8219,10964,10425,10188,237,10188,10188,10420,9995,425,9995
8220,33221,33177,31973,1204,31973,31973,33179,31130,2049,31130
8221,69929,69120,67419,1701,67419,67419,69135,66920,2215,66920
8222,2055,1380,1626,-246,1380,1380,1380,1433,-53,1433
8223,105400,96723,94010,2713,94010,94010,96729,93267,3462,93267
8224,618199,617337,580086,37251,580086,580086,617027,570207,46820,570207
8225,49587,48086,47460,626,47460,47460,48107,46861,1246,46861
8226,1027108,1092079,1027332,64747,1027332,1027108,1092123,1013975,78148,1013975
8227,427049,412994,386170,26824,386170,386170,413051,383168,29883,383168
8228,130081,130061,122488,7573,122488,122488,130081,121270,8811,121270
8229,15805,4617,4689,-72,4617,4617,4615,4554,61,4554
8230,2195,1819,2019,-200,1819,1819,1819,1857,-38,1857
8231,10747,11085,10745,340,10745,10745,11089,10650,439,10650
8232,3800,3366,3489,-123,3366,3366,3366,3331,35,3331
8233,95553,95004,89640,5364,89640,89640,94987,88733,6254,88733
8234,11542,10551,10183,368,10183,10183,10558,10046,512,10046
8235,7740,6911,6750,161,6750,6750,6906,6608,298,6608
8236,192154,191269,181965,9304,181965,181965,191194,181513,9681,181513
8237,863034,851032,817710,33322,817710,817710,850986,806181,44805,806181
8238,41059,41051,40794,257,40794,40794,41059,40382,677,40382
8239,56275,58811,56269,2542,56269,56269,58782,55947,2835,55947
8240,28369,27753,27112,641,27112,27112,27749,26962,787,26962
8241,11290,10735,10841,-106,10735,10735,10736,9964,772,9964
8242,31191,26381,24774,1607,24774,24774,26389,23947,2442,23947
8243,22662,21839,20594,1245,20594,20594,21834,19825,2009,19825
8244,26165,27007,26103,904,26103,26103,27028,25510,1518,25510
8245,125923,109532,104507,5025,104507,104507,109520,103674,5846,103674
8246,780458,739643,700142,39501,700142,700142,739490,692852,46638,692852
8247,120310,98455,93661,4794,93661,93661,98491,90309,8182,90309
8248,30394,29761,29103,658,29103,29103,29758,28936,822,28936
8249,480471,479444,461589,17855,461589,461589,479687,457784,21903,457784
8250,36578,11958,11466,492,11466,11466,11958,11293,665,11293
8251,48279,48276,46611,1665,46611,46611,48234,46088,2146,46088
8252,1328,1018,1231,-213,1018,1018,1019,1070,-51,1070
8253,29745,29756,29150,606,29150,29150,29759,27120,2639,27120
8254,248670,255751,251844,3907,251844,248670,255865,248662,7203,248662
8255,13426,13430,12987,443,12987,12987,13426,12869,557,12869
8256,10007,9558,9714,-156,9558,9558,9562,9493,69,9493
8257,4619,4194,4310,-116,4194,4194,4193,4122,71,4122
8258,31417,14511,13987,524,13987,13987,14505,13728,777,13728
8259,15343,14614,14552,62,14552,14552,14623,14348,275,14348
8260,25678,25665,25468,197,25468,25468,25678,24403,1275,24403
8261,58113,46582,48889,-2307,46582,46582,46580,45910,670,45910
8262,8219,8204,8271,-67,8204,8204,8203,7141,1062,7141
8263,429819,426684,412221,14463,412221,412221,426657,394741,31916,394741
8264,277933,291107,284110,6997,284110,277933,291193,277943,13250,277933
8265,146255,146250,143812,2438,143812,143812,146255,142893,3362,142893
8266,7671,7137,7089,48,7089,7089,7137,6946,191,6946
8267,6938,6519,6504,15,6504,6504,6515,6372,143,6372
8268,8492,8465,8494,-29,8465,8465,8463,8246,217,8246
8269,1369030,1366030,1243777,122253,1243777,1243777,1365730,1231383,134347,1231383
8270,6044,6279,6474,-195,6279,6044,6280,6036,244,6036
8271,17988,17463,16633,830,16633,16633,17469,16398,1071,16398
8272,15947,8656,8542,114,8542,8542,8659,8446,213,8446
8273,172860,174649,175429,-780,174649,172860,174674,172852,1822,172852
8274,3695,450,694,-244,450,450,450,500,-50,500
8275,6176,6546,6401,145,6401,6176,6541,6176,365,6176
8276,26549,25689,25292,397,25292,25292,25700,24762,938,24762
8277,303248,320873,304581,16292,304581,303248,320916,303248,17668,303248
8278,5886,5095,5077,18,5077,5077,5096,4991,105,4991
8279,26078,25829,26662,-833,25829,25829,25845,26045,-200,26045
8280,75634,74567,73033,1534,73033,73033,74604,72705,1899,72705
8281,14273,14495,14377,118,14377,14273,14495,14273,222,14273
8282,8647,8541,8586,-45,8541,8541,8540,8408,132,8408
8283,10993,9849,9736,113,9736,9736,9849,9646,203,9646
8284,79301,49428,48084,1344,48084,48084,49423,47633,1790,47633
8285,18827,19178,18907,271,18907,18827,19186,18850,336,18827
8286,8894,8891,9066,-175,8891,8891,8894,8291,603,8291
8287,21947,22463,21947,516,21947,21947,22469,21819,650,21819
8288,5546,4707,4867,-160,4707,4707,4707,4660,47,4660
8289,4020,3642,3847,-205,3642,3642,3643,3677,-34,3677
8290,149237,141167,136035,5132,136035,136035,141155,128302,12853,128302
8291,46571,47929,46467,1462,46467,46467,47959,46029,1930,46029
8292,178477,165990,155043,10947,155043,155043,166069,154652,11417,154652
8293,16715,16186,16202,-16,16186,16186,16191,16093,98,16093
8294,298507,241651,236119,5532,236119,236119,241651,233559,8092,233559
8295,8772,8844,8769,75,8769,8769,8843,8650,193,8650
8296,21176,20493,21172,-679,20493,20493,20502,20520,-18,20520
8297,17297,16612,16128,484,16128,16128,16617,15811,806,15811
8298,44105,44096,42136,1960,42136,42136,44105,41594,2511,41594
8299,1638,732,985,-253,732,732,732,778,-46,778
8300,6085,5141,5141,0,5141,5141,5139,4827,312,4827
8301,19480,18627,17360,1267,17360,17360,18627,16128,2499,16128
8302,20832,19961,19803,158,19803,19803,19963,19320,643,19320
8303,178352,177805,167652,10153,167652,167652,177798,165333,12465,165333
8304,25021,24081,24175,-94,24081,24081,24078,23430,648,23430
8305,17784,17258,16728,530,16728,16728,17260,16534,726,16534
8306,30490,29378,28342,1036,28342,28342,29384,28257,1127,28257
8307,32716,34362,32699,1663,32699,32699,34351,32514,1837,32514
8308,13845,13830,13837,-7,13830,13830,13845,13623,222,13623
8309,34254,33104,32468,636,32468,32468,33119,32391,728,32391
8310,18686,18922,18623,299,18623,18623,18924,18381,543,18381
8311,7126,3844,3962,-118,3844,3844,3844,3784,60,3784
8312,37977,20897,19935,962,19935,19935,20883,19626,1257,19626
8313,72238,50767,49839,928,49839,49839,50764,49585,1179,49585
8314,77285,55105,53029,2076,53029,53029,55095,52819,2276,52819
8315,5388,5388,5431,-43,5388,5388,5388,5338,50,5338
8316,21562,19943,19805,138,19805,19805,19954,19604,350,19604
8317,107056,107036,103714,3322,103714,103714,107039,99187,7852,99187
8318,59897,61306,59865,1441,59865,59865,61317,59311,2006,59311
8319,33993,33964,34640,-676,33964,33964,33966,29848,4118,29848
8320,227757,223621,213480,10141,213480,213480,223611,212648,10963,212648
8321,88749,94592,89490,5102,89490,88749,94587,88749,5838,88749
8322,12820,12977,12818,159,12818,12818,12979,12582,397,12582
8323,40387,40391,40398,-7,40391,40387,40387,37691,2696,37691
8324,16905,16865,16844,21,16844,16844,16848,15011,1837,15011
8325,3098,3120,3344,-224,3120,3098,3116,2892,224,2892
8326,8811,617,875,-258,617,617,617,667,-50,667
8327,13825,12727,12340,387,12340,12340,12720,12302,418,12302
8328,146234,146158,138464,7694,138464,138464,146234,135966,10268,135966
8329,148430,152294,149818,2476,149818,148430,152288,148422,3866,148422
8330,14524,14961,14926,35,14926,14524,14959,14576,383,14524
8331,26149,23754,23262,492,23262,23262,23764,22987,777,22987
8332,122782,130935,122682,8253,122682,122682,130991,120762,10229,120762
8333,36395,32153,31550,603,31550,31550,32148,31433,715,31433
8334,23266,22477,21588,889,21588,21588,22485,21360,1125,21360
8335,42175,39595,38477,1118,38477,38477,39614,37863,1751,37863
8336,213012,212915,205236,7679,205236,205236,212975,204302,8673,204302
8337,1978,876,1122,-246,876,876,876,903,-27,903
8338,22681,15983,16174,-191,15983,15983,15983,15788,195,15788
8339,8104,7595,7551,44,7551,7551,7591,7465,126,7465
8340,93967,90658,86232,4426,86232,86232,90691,86188,4503,86188
8341,2263,1396,1571,-175,1396,1396,1396,1413,-17,1413
8342,19344,19341,18484,857,18484,18484,19344,17826,1518,17826
8343,198608,196506,189884,6622,189884,189884,196423,189443,6980,189443
8344,52291,51602,49944,1658,49944,49944,51609,49524,2085,49524
8345,32543,33594,32552,1042,32552,32543,33600,32427,1173,32427
8346,28965,28258,28128,130,28128,28128,28263,27852,411,27852
8347,12906,9737,9330,407,9330,9330,9744,9232,512,9232
8348,240151,228481,210909,17572,210909,210909,228462,208189,20273,208189
8349,20521,20532,20125,407,20125,20125,20521,19920,601,19920
8350,33766,33162,30823,2339,30823,30823,33148,30550,2598,30550
8351,18450,19636,18630,1006,18630,18450,19651,17828,1823,17828
8352,11497,10650,10272,378,10272,10272,10655,10194,461,10194
8353,21128,20563,19694,869,19694,19694,20574,19450,1124,19450
8354,8234,8180,8303,-123,8180,8180,8173,8156,17,8156
8355,233782,230694,217838,12856,217838,217838,230740,214703,16037,214703
8356,21150,21148,21284,-136,21148,21148,21166,20472,694,20472
8357,15724,14545,14530,15,14530,14530,14544,14019,525,14019
8358,25583,21283,20539,744,20539,20539,21276,20364,912,20364
8359,22142,22140,22347,-207,22140,22140,22142,21934,208,21934
8360,222210,222131,211867,10264,211867,211867,222210,211573,10637,211573
8361,44333,41962,40029,1933,40029,40029,41972,39275,2697,39275
8362,263758,269976,266084,3892,266084,263758,270098,263136,6962,263136
8363,9090,8651,8829,-178,8651,8651,8652,8601,51,8601
8364,133486,131958,130380,1578,130380,130380,131990,128932,3058,128932
8365,17211,17450,17323,127,17323,17211,17455,17215,240,17211
8366,44490,44430,43595,835,43595,43595,44429,43148,1281,43148
8367,1883,911,1148,-237,911,911,911,967,-56,967
8368,32807,34614,32807,1807,32807,32807,34603,32692,1911,32692
8369,8173,8018,8171,-153,8018,8018,8017,7954,63,7954
8370,62878,64795,63477,1318,63477,62878,64787,62800,1987,62800
8371,12068,12068,11661,407,11661,11661,12068,11571,497,11571
8372,11788,11779,11587,192,11587,11587,11788,11363,425,11363
8373,11922,12495,12604,-109,12495,11922,12497,11300,1197,11300
8374,87807,83577,80271,3306,80271,80271,83598,79630,3968,79630
8375,36805,35961,35363,598,35363,35363,35996,34064,1932,34064
8376,52786,52765,50347,2418,50347,50347,52786,49982,2804,49982
8377,277749,218280,210614,7666,210614,210614,218287,207637,10650,207637
8378,7430,7432,7382,50,7382,7382,7430,7236,194,7236
8379,34775,34773,33429,1344,33429,33429,34775,33311,1464,33311
8380,45482,44916,42659,2257,42659,42659,44928,41036,3892,41036
8381,3482,2839,3183,-344,2839,2839,2838,2870,-32,2870
8382,12674,12606,12598,8,12598,12598,12612,12369,243,12369
8383,38737,38679,37487,1192,37487,37487,38689,37284,1405,37284
8384,10196,9197,9174,23,9174,9174,9197,9032,165,9032
8385,31843,31791,31775,16,31775,31775,31817,31184,633,31184
8386,218891,215122,202624,12498,202624,202624,215245,200890,14355,200890
8387,513483,539765,522631,17134,522631,513483,539838,515258,24580,513483
8388,7639,6808,6821,-13,6808,6808,6804,6708,96,6708
8389,107487,74881,70148,4733,70148,70148,74875,69374,5501,69374
8390,246366,228917,221518,7399,221518,221518,228939,219171,9768,219171
8391,9139,8743,8911,-168,8743,8743,8746,8681,65,8681
8392,18960,17181,16786,395,16786,16786,17180,15928,1252,15928
8393,10663,3626,3528,98,3528,3528,3625,3271,354,3271
8394,208628,178792,171726,7066,171726,171726,178837,168167,10670,168167
8395,3180,3165,3336,-171,3165,3165,3167,3138,29,3138
8396,28264,28246,27629,617,27629,27629,28245,27406,839,27406
8397,699366,680827,654041,26786,654041,654041,680441,650352,30089,650352
8398,39003,38086,37038,1048,37038,37038,38077,36801,1276,36801
8399,3938,3518,3704,-186,3518,3518,3517,3522,-5,3522
8400,115484,115223,110089,5134,110089,110089,115235,109515,5720,109515
8401,250902,229898,220594,9304,220594,220594,229966,218956,11010,218956
8402,61415,60613,58758,1855,58758,58758,60640,58469,2171,58469
8403,20017,18327,17452,875,17452,17452,18320,17377,943,17377
8404,156420,154239,146527,7712,146527,146527,154310,146506,7804,146506
8405,36644,35985,34126,1859,34126,34126,36022,34049,1973,34049
8406,62625,62637,59271,3366,59271,59271,62625,58981,3644,58981
8407,47868,46883,44740,2143,44740,44740,46882,28687,18195,28687
8408,2958,2958,3178,-220,2958,2958,2958,3002,-44,2958
8409,31263,10516,10111,405,10111,10111,10518,9947,571,9947
8410,10412,10407,10356,51,10356,10356,10412,10203,209,10203
8411,225558,208269,198968,9301,198968,198968,208261,195989,12272,195989
8412,21920,21074,20193,881,20193,20193,21070,20038,1032,20038
8413,10333,9771,9933,-162,9771,9771,9779,9574,205,9574
8414,15854,15873,15759,114,15759,15759,15872,15536,336,15536
8415,278970,275376,276039,-663,275376,275376,275382,273576,1806,273576
8416,182639,181303,173230,8073,173230,173230,181293,172857,8436,172857
8417,14291,13389,13068,321,13068,13068,13391,12946,445,12946
8418,17614,14725,14109,616,14109,14109,14724,14014,710,14014
8419,65021,63172,62904,268,62904,62904,63189,61986,1203,61986
8420,8187,8197,8133,64,8133,8133,8187,7876,311,7876
8421,14336,13793,13656,137,13656,13656,13799,13364,435,13364
8422,9079,9083,9224,-141,9083,9079,9079,8999,80,8999
8423,63583,60022,56149,3873,56149,56149,60022,55447,4575,55447
8424,5654,5658,5618,40,5618,5618,5654,5451,203,5451
8425,1605,1236,1458,-222,1236,1236,1236,1291,-55,1291
8426,222677,221664,219466,2198,219466,219466,221747,217476,4271,217476
8427,5115,4940,5069,-129,4940,4940,4935,4890,45,4890
8428,3024,2776,3026,-250,2776,2776,2775,2824,-49,2824
8429,21955,22913,21952,961,21952,21952,22922,21885,1037,21885
8430,21449,20369,19650,719,19650,19650,20371,19549,822,19549
8431,5888,5445,5517,-72,5445,5445,5448,5410,38,5410
8432,5837,5196,5265,-69,5196,5196,5201,5138,63,5138
8433,34563,31600,30785,815,30785,30785,31604,29078,2526,29078
8434,27868,26779,27125,-346,26779,26779,26800,26408,392,26408
8435,3516,3340,3586,-246,3340,3340,3344,3390,-46,3390
8436,4824,4832,4788,44,4788,4788,4828,4456,372,4456
8437,18516,15265,15017,248,15017,15017,15265,14888,377,14888
8438,25018,25505,25017,488,25017,25017,25512,24836,676,24836
8439,209249,208280,196975,11305,196975,196975,208319,190682,17637,190682
8440,758879,758815,725468,33347,725468,725468,758810,719813,38997,719813
8441,4609,4290,4414,-124,4290,4290,4290,4270,20,4270
8442,44131,42454,41398,1056,41398,41398,42473,40531,1942,40531
8443,32164,33400,32164,1236,32164,32164,33391,32093,1298,32093
8444,257642,273814,257561,16253,257561,257561,274083,257219,16864,257219
8445,164572,164446,156826,7620,156826,156826,164446,155408,9038,155408
8446,351233,373004,351169,21835,351169,351169,372949,349643,23306,349643
8447,34616,24159,24691,-532,24159,24159,24156,22799,1357,22799
8448,996432,971994,930689,41305,930689,930689,972227,930006,42221,930006
8449,31764,32496,31259,1237,31259,31259,32491,31142,1349,31142
8450,16879,16891,16093,798,16093,16093,16889,15896,993,15896
8451,314972,314557,294217,20340,294217,294217,314418,290340,24078,290340
8452,10387,10299,10325,-26,10299,10299,10301,10109,192,10109
8453,12011,11488,10981,507,10981,10981,11479,10891,588,10891
8454,75497,74558,73829,729,73829,73829,74562,73099,1463,73099
8455,203098,203587,203086,501,203086,203086,203713,200842,2871,200842
8456,365502,365125,362322,2803,362322,362322,365186,353248,11938,353248
8457,4273,4271,4399,-128,4271,4271,4273,4237,36,4237
8458,55634,45138,45533,-395,45138,45138,45163,44253,910,44253
8459,52888,54298,52830,1468,52830,52830,54298,51969,2329,51969
8460,63497,63446,63250,196,63250,63250,63466,62270,1196,62270
8461,1990,1990,2236,-246,1990,1990,1990,1844,146,1844
8462,7081,7081,6898,183,6898,6898,7079,6589,490,6589
8463,134012,133079,128246,4833,128246,128246,133108,127570,5538,127570
8464,12971,9812,9783,29,9783,9783,9809,9262,547,9262
8465,78667,82972,79078,3894,79078,78667,82970,78081,4889,78081
8466,97614,80503,79571,932,79571,79571,80504,79016,1488,79016
8467,114736,90691,89081,1610,89081,89081,90646,88331,2315,88331
8468,3658,3367,3552,-185,3367,3367,3368,3297,71,3297
8469,18013,6639,6800,-161,6639,6639,6639,6646,-7,6646
8470,73952,72583,69835,2748,69835,69835,72566,69355,3211,69355
8471,952,284,518,-234,284,284,284,330,-46,330
8472,17594,16761,16364,397,16364,16364,16759,16213,546,16213
8473,125984,125953,122750,3203,122750,122750,125984,122188,3796,122188
8474,11911,12085,11906,179,11906,11906,12087,11767,320,11767
8475,1538644,1452645,1440123,12522,1440123,1440123,1453039,1402987,50052,1402987
8476,11040,11037,10796,241,10796,10796,11040,10651,389,10651
8477,31764,30510,29015,1495,29015,29015,30514,28599,1915,28599
8478,21147,22147,21139,1008,21139,21139,22141,21096,1045,21096
8479,10993,10417,10417,0,10417,10417,10418,10266,152,10266
8480,637037,487234,456198,31036,456198,456198,487212,449500,37712,449500
8481,5418,4843,5352,-509,4843,4843,4848,4944,-96,4944
8482,58540,57384,55746,1638,55746,55746,57409,55344,2065,55344
8483,16378,16375,16060,315,16060,16060,16378,15081,1297,15081
8484,13310,13455,13401,54,13401,13310,13458,13228,230,13228
8485,16827,16330,16095,235,16095,16095,16336,15869,467,15869
8486,14899,14280,13501,779,13501,13501,14285,13398,887,13398
8487,15756,12303,12550,-247,12303,12303,12302,11851,451,11851
8488,5607,5537,5607,-70,5537,5537,5536,5465,71,5465
8489,17792,17796,17682,114,17682,17682,17792,17529,263,17529
8490,294824,293607,282606,11001,282606,282606,293606,277975,15631,277975
8491,19287,15730,15906,-176,15730,15730,15740,15637,103,15637
8492,628,567,812,-245,567,567,567,623,-56,623
8493,158735,136354,135169,1185,135169,135169,136404,133156,3248,133156
8494,62338,59273,55873,3400,55873,55873,59270,55216,4054,55216
8495,8833,8830,8759,71,8759,8759,8833,8622,211,8622
8496,51342,50423,48409,2014,48409,48409,50421,48324,2097,48324
8497,785641,813695,784919,28776,784919,784919,813625,778054,35571,778054
8498,168612,168667,159210,9457,159210,159210,168612,158309,10303,158309
8499,6248,5789,5777,12,5777,5777,5790,5660,130,5660
8500,11344,10914,10596,318,10596,10596,10908,10480,428,10480
8501,11978,11911,11776,135,11776,11776,11917,11358,559,11358
8502,4562,4053,4258,-205,4053,4053,4054,4085,-31,4085
8503,5278,5275,5468,-193,5275,5275,5278,5341,-63,5278
8504,18441,18368,17908,460,17908,17908,18361,17819,542,17819
8505,58843,58844,57945,899,57945,57945,58843,56855,1988,56855
8506,10901,10835,10772,63,10772,10772,10843,10279,564,10279
8507,1142458,360613,344727,15886,344727,344727,360767,342867,17900,342867
8508,9454,8664,8836,-172,8664,8664,8672,8539,133,8539
8509,30305,30562,29912,650,29912,29912,30556,29877,679,29877
8510,98416,98243,93781,4462,93781,93781,98226,93487,4739,93487
8511,6975,6976,7077,-101,6976,6975,6975,6908,67,6908
8512,86436,86428,83798,2630,83798,83798,86436,83743,2693,83743
8513,14607,14628,14219,409,14219,14219,14625,13923,702,13923
8514,953,284,519,-235,284,284,284,331,-47,331
8515,34610,34847,34333,514,34333,34333,34849,33988,861,33988
8516,14871,15075,14804,271,14804,14804,15068,14722,346,14722
8517,225399,188405,181152,7253,181152,181152,188437,177902,10535,177902
8518,170904,166897,167001,-104,166897,166897,167009,166204,805,166204
8519,6907,6483,6509,-26,6483,6483,6484,6329,155,6329
8520,2845,2847,3062,-215,2847,2845,2845,2759,86,2759
8521,152151,144988,135364,9624,135364,135364,144999,134178,10821,134178
8522,10906,10410,10056,354,10056,10056,10405,9884,521,9884
8523,17412,16564,16291,273,16291,16291,16569,16081,488,16081
8524,42559,39860,37944,1916,37944,37944,39872,37821,2051,37821
8525,12045,12232,12042,190,12042,12042,12234,11660,574,11660
8526,16413,15849,15857,-8,15849,15849,15847,15512,335,15512
8527,31158,33060,31091,1969,31091,31091,33052,31008,2044,31008
8528,323248,322233,312636,9597,312636,312636,322322,311949,10373,311949
8529,13625,13149,13034,115,13034,13034,13145,12887,258,12887
8530,38242,38204,37445,759,37445,37445,38206,37116,1090,37116
8531,4569,497,759,-262,497,497,498,531,-33,531
8532,27241,29957,27177,2780,27177,27177,29966,26941,3025,26941
8533,53445,15465,15363,102,15363,15363,15469,15139,330,15139
8534,1952,1952,2167,-215,1952,1952,1952,2011,-59,1952
8535,248791,244739,234494,10245,234494,234494,244849,233718,11131,233718
8536,4635,4596,4630,-34,4596,4596,4601,4352,249,4352
8537,59300,26701,26308,393,26308,26308,26707,26007,700,26007
8538,634660,634518,607459,27059,607459,607459,634660,606079,28581,606079
8539,41190,41110,38871,2239,38871,38871,41129,38820,2309,38820
8540,80895,79007,76422,2585,76422,76422,79033,76079,2954,76079
8541,427800,394806,389687,5119,389687,389687,394844,386765,8079,386765
8542,13104,809,1078,-269,809,809,810,837,-27,837
8543,57794,57711,56208,1503,56208,56208,57686,55905,1781,55905
8544,209858,209696,195380,14316,195380,195380,209858,194623,15235,194623
8545,230783,226888,221322,5566,221322,221322,226906,219716,7190,219716
8546,29810,29245,29013,232,29013,29013,29244,28464,780,28464
8547,8503,8762,8911,-149,8762,8503,8772,8459,313,8459
8548,2292,1845,2084,-239,1845,1845,1845,1907,-62,1907
8549,7441,6977,6972,5,6972,6972,6979,6829,150,6829
8550,55049,59530,55049,4481,55049,55049,59533,52432,7101,52432
8551,267346,266479,258360,8119,258360,258360,266529,255492,11037,255492
8552,15636,14779,15514,-735,14779,14779,14786,13537,1249,13537
8553,16577,15895,15268,627,15268,15268,15905,15167,738,15167
8554,17073,16221,15695,526,15695,15695,16222,15455,767,15455
8555,15745,14126,13288,838,13288,13288,14134,12935,1199,12935
8556,135737,135125,128635,6490,128635,128635,135183,128492,6691,128492
8557,21973,21986,23019,-1033,21986,21973,21978,20446,1532,20446
8558,27498,26658,25276,1382,25276,25276,26653,21198,5455,21198
8559,43017,15555,15640,-85,15555,15555,15556,15169,387,15169
8560,60610,63125,60520,2605,60520,60520,63114,60286,2828,60286
8561,28480,4466,4579,-113,4466,4466,4469,4505,-36,4505
8562,8034,7513,7329,184,7329,7329,7516,7029,487,7029
8563,31499,30568,29904,664,29904,29904,30565,29807,758,29807
8564,7505,7501,7387,114,7387,7387,7505,7216,289,7216
8565,31906,30516,29643,873,29643,29643,30531,29362,1169,29362
8566,23059,22503,22427,76,22427,22427,22513,22117,396,22117
8567,46662,46622,46518,104,46518,46518,46636,45617,1019,45617
8568,1065483,1104187,1079409,24778,1079409,1065483,1104129,1064861,39268,1064861
8569,2077,2089,2324,-235,2089,2077,2093,2126,-33,2077
8570,1213,1212,1646,-434,1212,1212,1213,1204,9,1204
8571,27311,28579,27300,1279,27300,27300,28579,27199,1380,27199
8572,28043,24930,24158,772,24158,24158,24935,23163,1772,23163
8573,9218,8766,8485,281,8485,8485,8773,8323,450,8323
8574,75939,56207,53362,2845,53362,53362,56197,52074,4123,52074
8575,15257,14246,14208,38,14208,14208,14249,14041,208,14041
8576,62028,62355,62268,87,62268,62028,62399,61016,1383,61016
8577,10955,10085,9813,272,9813,9813,10087,9767,320,9767
8578,42814,39326,39370,-44,39326,39326,39332,39094,238,39094
8579,373,373,618,-245,373,373,373,422,-49,373
8580,16076,13586,13172,414,13172,13172,13579,12001,1578,12001
8581,62705,64872,63446,1426,63446,62705,64918,62705,2213,62705
8582,102822,99931,97277,2654,97277,97277,99958,96643,3315,96643
8583,11597,9300,9509,-209,9300,9300,9304,8795,509,8795
8584,6335,5722,5708,14,5708,5708,5728,5396,332,5396
8585,10656,11316,11426,-110,11316,10656,11314,10034,1280,10034
8586,45841,43315,41881,1434,41881,41881,43315,41541,1774,41541
8587,23474,22906,22659,247,22659,22659,22920,22465,455,22465
8588,6247,2687,2811,-124,2687,2687,2687,2563,124,2563
8589,4496,4463,4498,-35,4463,4463,4463,4399,64,4399
8590,41378,41324,40542,782,40542,40542,41328,40306,1022,40306
8591,23307,22623,22270,353,22270,22270,22643,21956,687,21956
8592,10321,10397,10262,135,10262,10262,10398,10115,283,10115
8593,27951,27944,27378,566,27378,27378,27951,26235,1716,26235
8594,17462,16450,15553,897,15553,15553,16453,15081,1372,15081
8595,581416,568939,542782,26157,542782,542782,569177,540599,28578,540599
8596,466843,438061,429720,8341,429720,429720,438031,422354,15677,422354
8597,6606,6602,6778,-176,6602,6602,6606,6588,18,6588
8598,2043,1800,1981,-181,1800,1800,1798,1839,-41,1839
8599,114305,111162,109467,1695,109467,109467,111143,107392,3751,107392
8600,113032,112878,110886,1992,110886,110886,112902,110046,2856,110046
8601,382,383,625,-242,383,382,382,435,-53,382
8602,229596,228623,218317,10306,218317,218317,228645,217034,11611,217034
8603,32163,34791,32985,1806,32985,32163,34805,32155,2650,32155
8604,29972,30156,29911,245,29911,29911,30175,29615,560,29615
8605,409568,408549,401270,7279,401270,401270,408577,397623,10954,397623
8606,67466,62209,59141,3068,59141,59141,62213,58549,3664,58549
8607,44874,43575,42064,1511,42064,42064,43566,41966,1600,41966
8608,243816,233442,218789,14653,218789,218789,233447,217578,15869,217578
8609,41444,41447,40271,1176,40271,40271,41444,39975,1469,39975
8610,22870,21989,21297,692,21297,21297,21987,21164,823,21164
8611,7400,6796,7086,-290,6796,6796,6799,6778,21,6778
8612,26712,26202,24777,1425,24777,24777,26218,24658,1560,24658
8613,186969,185909,181001,4908,181001,181001,185979,175890,10089,175890
8614,44377,45124,43105,2019,43105,43105,45154,40867,4287,40867
8615,38498,38605,39120,-515,38605,38498,38599,37876,723,37876
8616,13221,11550,11568,-18,11550,11550,11548,11399,149,11399
8617,101923,82033,76160,5873,76160,76160,82029,75861,6168,75861
8618,100947,100937,99567,1370,99567,99567,100964,97774,3190,97774
8619,272219,271666,257405,14261,257405,257405,271665,254715,16950,254715
8620,11732,11066,10781,285,10781,10781,11067,10598,469,10598
8621,3929,3657,3773,-116,3657,3657,3658,3630,28,3630
8622,147014,118612,111473,7139,111473,111473,118715,107045,11670,107045
8623,6842,6511,6517,-6,6511,6511,6510,6339,171,6339
8624,41815,39327,38123,1204,38123,38123,39320,37601,1719,37601
8625,144238,144096,136794,7302,136794,136794,144200,134842,9358,134842
8626,232410,224444,225905,-1461,224444,224444,224519,223082,1437,223082
8627,14116,9874,10173,-299,9874,9874,9869,9807,62,9807
8628,4257,4113,4196,-83,4113,4113,4111,4025,86,4025
8629,84085,79489,77363,2126,77363,77363,79540,77144,2396,77144
8630,35028,36913,34945,1968,34945,34945,36891,34491,2400,34491
8631,36276,36236,35512,724,35512,35512,36263,35133,1130,35133
8632,1494,1457,1706,-249,1457,1457,1457,1474,-17,1474
8633,22289,21859,21960,-101,21859,21859,21857,21667,190,21667
8634,194143,185741,188213,-2472,185741,185741,185806,185066,740,185066
8635,12359,11587,11485,102,11485,11485,11591,11121,470,11121
8636,26940,26050,26030,20,26030,26030,26046,25784,262,25784
8637,239811,233442,225203,8239,225203,225203,233514,224272,9242,224272
8638,10552,10551,10473,78,10473,10473,10552,10340,212,10340
8639,42194,24418,23486,932,23486,23486,24435,23410,1025,23410
8640,1506,1295,1505,-210,1295,1295,1295,1337,-42,1337
8641,300675,312781,300577,12204,300577,300577,312995,298598,14397,298598
8642,280179,277272,270941,6331,270941,270941,277359,260066,17293,260066
8643,16998,16437,16492,-55,16437,16437,16444,16077,367,16077
8644,64013,64017,61828,2189,61828,61828,64013,60331,3682,60331
8645,17596,17595,17571,24,17571,17571,17596,17093,503,17093
8646,3929,3755,3929,-174,3755,3755,3752,3780,-28,3780
8647,22980,21727,21426,301,21426,21426,21730,21193,537,21193
8648,16194,16150,15889,261,15889,15889,16146,15713,433,15713
8649,3764,3518,3704,-186,3518,3518,3515,3454,61,3454
8650,69351,72326,69330,2996,69330,69330,72347,68963,3384,68963
8651,50558,46943,46500,443,46500,46500,46944,46097,847,46097
8652,7385,7028,7014,14,7014,7014,7025,6840,185,6840
8653,632594,632734,616929,15805,616929,616929,632594,614098,18496,614098
8654,135668,139358,135643,3715,135643,135643,139414,134826,4588,134826
8655,34353,34271,33319,952,33319,33319,34296,33148,1148,33148
8656,10341,10337,9925,412,9925,9925,10341,8758,1583,8758
8657,26227,25003,23648,1355,23648,23648,24993,23535,1458,23535
8658,21718,20260,19854,406,19854,19854,20240,19476,764,19476
8659,623013,620250,584822,35428,584822,584822,620413,582991,37422,582991
8660,10042,9980,9710,270,9710,9710,9981,9147,834,9147
8661,65504,62745,60552,2193,60552,60552,62762,60343,2419,60343
8662,55273,52489,49969,2520,49969,49969,52493,49742,2751,49742
8663,82240,85306,83442,1864,83442,82240,85308,82232,3076,82232
8664,7126,7101,6970,131,6970,6970,7100,6721,379,6721
8665,5864,5310,5312,-2,5310,5310,5310,5094,216,5094
8666,4616,4585,4655,-70,4585,4585,4581,4544,37,4544
8667,302600,319227,304014,15213,304014,302600,319190,302058,17132,302058
8668,12471,11888,12195,-307,11888,11888,11893,11882,11,11882
8669,135351,133047,135385,-2338,133047,133047,133034,127366,5668,127366
8670,688148,687192,659156,28036,659156,659156,687190,653300,33890,653300
8671,43795,17532,17698,-166,17532,17532,17537,17355,182,17355
8672,235375,213257,209666,3591,209666,209666,213341,202571,10770,202571
8673,36671,37056,36664,392,36664,36664,37071,36479,592,36479
8674,101353,98112,97248,864,97248,97248,98145,94525,3620,94525
8675,665139,525912,495624,30288,495624,495624,525973,483406,42567,483406
8676,116136,112508,107179,5329,107179,107179,112483,106743,5740,106743
8677,80549,83967,80530,3437,80530,80530,83971,80434,3537,80434
8678,132596,126956,122079,4877,122079,122079,126887,121204,5683,121204
8679,61311,59602,57458,2144,57458,57458,59586,56789,2797,56789
8680,30838,30390,29095,1295,29095,29095,30390,28987,1403,28987
8681,94478,98529,102291,-3762,98529,94478,98561,94470,4091,94470
8682,193372,191583,188552,3031,188552,188552,191658,184701,6957,184701
8683,588288,537453,501947,35506,501947,501947,537545,499944,37601,499944
8684,897,633,897,-264,633,633,633,692,-59,692
8685,14622,14824,14622,202,14622,14622,14827,14496,331,14496
8686,14011,13540,13317,223,13317,13317,13531,13191,340,13191
8687,144329,127169,122277,4892,122277,122277,127211,121824,5387,121824
8688,6481,5268,5529,-261,5268,5268,5269,5320,-51,5320
8689,8101,8144,8098,46,8098,8098,8142,7991,151,7991
8690,36352,36337,34770,1567,34770,34770,36352,34683,1669,34683
8691,10395,10191,10168,23,10168,10168,10190,9923,267,9923
8692,206519,184990,188053,-3063,184990,184990,185104,181081,4023,181081
8693,590928,623184,595386,27798,595386,590928,622671,590928,31743,590928
8694,145023,145892,139415,6477,139415,139415,145928,137659,8269,137659
8695,51400,52051,51720,331,51720,51400,52083,50778,1305,50778
8696,12431,12302,12550,-248,12302,12302,12310,12097,213,12097
8697,30066,26691,26330,361,26330,26330,26695,25755,940,25755
8698,13352,13241,13433,-192,13241,13241,13248,13152,96,13152
8699,21034,21031,20296,735,20296,20296,21034,20101,933,20101
8700,144204,143313,136119,7194,136119,136119,143408,127251,16157,127251
8701,527606,523768,495250,28518,495250,495250,523917,489945,33972,489945
8702,25142,25146,24256,890,24256,24256,25142,22287,2855,22287
8703,68484,67574,66342,1232,66342,66342,67615,65800,1815,65800
8704,14313,13846,13550,296,13550,13550,13851,13310,541,13310
8705,52345,52320,50238,2082,50238,50238,52305,49691,2614,49691
8706,64462,62443,59555,2888,59555,59555,62455,59373,3082,59373
8707,35602,35065,32775,2290,32775,32775,35048,32502,2546,32502
8708,51003,44592,42851,1741,42851,42851,44598,42128,2470,42128
8709,135794,105062,96814,8248,96814,96814,105082,94362,10720,94362
8710,37908,36458,35805,653,35805,35805,36470,35387,1083,35387
8711,335998,334757,316913,17844,316913,316913,334550,315676,18874,315676
8712,3145,2729,2889,-160,2729,2729,2728,2697,31,2697
8713,12841,12192,12151,41,12151,12151,12187,11909,278,11909
8714,8334,7781,7989,-208,7781,7781,7780,7730,50,7730
8715,368104,368230,347495,20735,347495,347495,368104,343538,24566,343538
8716,288321,288186,275752,12434,275752,275752,288291,273807,14484,273807
8717,43203,42418,41864,554,41864,41864,42412,41647,765,41647
8718,383724,341771,333947,7824,333947,333947,341910,331657,10253,331657
8719,11032,11048,11285,-237,11048,11032,11050,10661,389,10661
8720,84251,83145,79764,3381,79764,79764,83146,79546,3600,79546
8721,34098,33539,32609,930,32609,32609,33552,32294,1258,32294
8722,5785,5803,6000,-197,5803,5785,5801,5730,71,5730
8723,10264,9706,9566,140,9566,9566,9710,9276,434,9276
8724,157223,143710,135997,7713,135997,135997,143775,135431,8344,135431
8725,234254,239941,234215,5726,234215,234215,240055,232410,7645,232410
8726,7446,6721,6873,-152,6721,6721,6722,6615,107,6615
8727,162293,155781,146359,9422,146359,146359,155793,146101,9692,146101
8728,9114,9235,9054,181,9054,9054,9230,8952,278,8952
8729,38237,36815,36915,-100,36815,36815,36816,36232,584,36232
8730,99959,99415,97254,2161,97254,97254,99405,96737,2668,96737
8731,1547,1546,1811,-265,1546,1546,1547,1604,-57,1547
8732,125408,118523,114007,4516,114007,114007,118508,113758,4750,113758
8733,6975,6415,6533,-118,6415,6415,6420,6278,142,6278
8734,21121,16679,16486,193,16486,16486,16689,16321,368,16321
8735,2035,1054,1286,-232,1054,1054,1054,1114,-60,1114
8736,2805,2804,3099,-295,2804,2804,2805,2854,-49,2805
8737,5194,5198,5328,-130,5198,5194,5194,5167,27,5167
8738,8518,8002,7913,89,7913,7913,8003,7719,284,7719
8739,13724,13941,13656,285,13656,13656,13944,12774,1170,12774
8740,128608,132538,125469,7069,125469,125469,132523,125000,7523,125000
8741,352,352,589,-237,352,352,352,399,-47,352
8742,107049,106921,104072,2849,104072,104072,106939,103609,3330,103609
8743,5288,4870,5068,-198,4870,4870,4878,4904,-26,4904
8744,457039,456117,432356,23761,432356,432356,456150,428956,27194,428956
8745,67763,74123,70812,3311,70812,67763,74124,67141,6983,67141
8746,50278,49642,47840,1802,47840,47840,49634,47655,1979,47655
8747,23047,24095,23982,113,23982,23047,24092,23248,844,23047
8748,19983,18682,17733,949,17733,17733,18681,17174,1507,17174
8749,26339,23679,22930,749,22930,22930,23680,22511,1169,22511
8750,67163,47943,48067,-124,47943,47943,47964,47184,780,47184
8751,38208,39014,37902,1112,37902,37902,39024,37586,1438,37586
8752,118702,122348,118686,3662,118686,118686,122337,117776,4561,117776
8753,130482,127182,123951,3231,123951,123951,127231,123193,4038,123193
8754,16784,16252,15920,332,15920,15920,16261,15695,566,15695
8755,206827,182098,172848,9250,172848,172848,182108,172429,9679,172429
8756,26604,25296,24455,841,24455,24455,25310,24355,955,24355
8757,104704,103505,101627,1878,101627,101627,103521,100884,2637,100884
8758,39598,39030,38727,303,38727,38727,39044,37475,1569,37475
8759,1266087,1200269,1137365,62904,1137365,1137365,1200655,1130580,70075,1130580
8760,128736,127803,124137,3666,124137,124137,127806,122941,4865,122941
8761,65101,48413,48014,399,48014,48014,48435,47523,912,47523
8762,66725,66709,65056,1653,65056,65056,66725,64368,2357,64368
8763,13805,13433,13357,76,13357,13357,13448,13183,265,13183
8764,16303,13556,13316,240,13316,13316,13560,13141,419,13141
8765,24148,23535,23669,-134,23535,23535,23550,23170,380,23170
8766,22427,22415,22598,-183,22415,22415,22427,22271,156,22271
8767,39495,43854,39435,4419,39435,39435,43872,39274,4598,39274
8768,303284,275438,262073,13365,262073,262073,275566,261626,13940,261626
8769,3882,3489,3655,-166,3489,3489,3493,3507,-14,3507
8770,4700,4516,4642,-126,4516,4516,4517,4314,203,4314
8771,79075,75385,76664,-1279,75385,75385,75410,74767,643,74767
8772,31293,32357,31844,513,31844,31293,32367,31491,876,31293
8773,195229,192774,186378,6396,186378,186378,192768,183616,9152,183616
8774,118124,114934,112509,2425,112509,112509,114947,111669,3278,111669
8775,43146,43085,41798,1287,41798,41798,43123,41392,1731,41392
8776,212285,212281,193820,18461,193820,193820,212268,180971,31297,180971
8777,14032,14027,13758,269,13758,13758,14032,13514,518,13514
8778,28570,30275,28560,1715,28560,28560,30278,27169,3109,27169
8779,13130,13828,13435,393,13435,13130,13825,13097,728,13097
8780,4908,4501,4650,-149,4501,4501,4503,4498,5,4498
8781,10358,11577,11478,99,11478,10358,11578,9736,1842,9736
8782,470923,490091,472240,17851,472240,470923,490234,470301,19933,470301
8783,22796,21938,21059,879,21059,21059,21946,20503,1443,20503
8784,45498,45446,45042,404,45042,45042,45454,44052,1402,44052
8785,33604,34408,33580,828,33580,33580,34419,32982,1437,32982
8786,179517,149284,139607,9677,139607,139607,149279,135316,13963,135316
8787,30245,30245,29239,1006,29239,29239,30263,29099,1164,29099
8788,2614,2218,2456,-238,2218,2218,2217,2271,-54,2271
8789,32048,31058,30638,420,30638,30638,31071,29834,1237,29834
8790,23229,22759,22804,-45,22759,22759,22775,22607,168,22607
8791,11300,12016,11856,160,11856,11300,12020,11306,714,11300
8792,9099,8492,8782,-290,8492,8492,8505,8515,-10,8515
8793,230230,206809,205417,1392,205417,205417,206824,198684,8140,198684
8794,98308,94286,91329,2957,91329,91329,94302,90386,3916,90386
8795,1332,1255,1501,-246,1255,1255,1255,1295,-40,1295
8796,89044,94168,91664,2504,91664,89044,94209,89389,4820,89044
8797,89151,87157,83526,3631,83526,83526,87192,83505,3687,83505
8798,2905,2875,3078,-203,2875,2875,2874,2905,-31,2905
8799,8373,8716,8949,-233,8716,8373,8719,8373,346,8373
8800,49981,51698,50273,1425,50273,49981,51705,49981,1724,49981
8801,10431,10674,10708,-34,10674,10431,10686,10431,255,10431
8802,13360,12885,12549,336,12549,12549,12879,12396,483,12396
8803,18590,18584,18352,232,18352,18352,18585,17866,719,17866
8804,39787,41375,41097,278,41097,39787,41392,39989,1403,39787
8805,44413,45456,44407,1049,44407,44407,45450,44173,1277,44173
8806,1270,1286,1501,-215,1286,1270,1288,1255,33,1255
8807,22150,19822,19892,-70,19822,19822,19826,19677,149,19677
8808,5231,4872,4959,-87,4872,4872,4876,4748,128,4748
8809,7099,7112,7482,-370,7112,7099,7106,6927,179,6927
8810,5067,4734,4951,-217,4734,4734,4735,4774,-39,4774
8811,59405,55713,52751,2962,52751,52751,55710,52052,3658,52052
8812,462707,462634,449951,12683,449951,449951,462707,447517,15190,447517
8813,25872,26821,26041,780,26041,25872,26824,25872,952,25872
8814,132422,132403,127742,4661,127742,127742,132422,117036,15386,117036
8815,23988,24990,23988,1002,23988,23988,24994,23837,1157,23837
8816,18571,18559,18335,224,18335,18335,18568,17982,586,17982
8817,8150,7404,7505,-101,7404,7404,7407,7176,231,7176
8818,831983,828305,758047,70258,758047,758047,828613,741949,86664,741949
8819,48695,53152,50231,2921,50231,48695,53175,48141,5034,48141
8820,1600,1600,1826,-226,1600,1600,1600,1647,-47,1600
8821,80743,85873,82079,3794,82079,80743,85922,80735,5187,80735
8822,40233,39290,38774,516,38774,38774,39302,38463,839,38463
8823,153470,143134,144047,-913,143134,143134,143200,138165,5035,138165
8824,167204,161684,156209,5475,156209,156209,161688,154180,7508,154180
8825,73810,71782,69083,2699,69083,69083,71817,68845,2972,68845
8826,4627,4625,4637,-12,4625,4625,4627,4471,156,4471
8827,17799,17765,17471,294,17471,17471,17772,17326,446,17326
8828,281300,265872,258451,7421,258451,258451,265832,259176,6656,259176
8829,23526,22679,21928,751,21928,21928,22677,20086,2591,20086
8830,68349,68384,66214,2170,66214,66214,68367,65980,2387,65980
8831,90767,73636,71944,1692,71944,71944,73656,70751,2905,70751
8832,648296,64617,61319,3298,61319,61319,64634,60098,4536,60098
8833,54101,52176,51574,602,51574,51574,52206,50738,1468,50738
8834,3285,3037,3223,-186,3037,3037,3038,2852,186,2852
8835,13311,13269,13249,20,13249,13249,13276,12830,446,12830
8836,417847,416028,396197,19831,396197,396197,416153,393198,22955,393198
8837,141364,138305,132927,5378,132927,132927,138336,132392,5944,132392
8838,8924,8849,8920,-71,8849,8849,8857,8629,228,8629
8839,13974,13967,13994,-27,13967,13967,13974,13767,207,13767
8840,69709,54475,52887,1588,52887,52887,54500,52505,1995,52505
8841,23950,23073,22341,732,22341,22341,23059,22191,868,22191
8842,2311,1837,2064,-227,1837,1837,1836,1891,-55,1891
8843,34564,36486,34500,1986,34500,34500,36468,34344,2124,34344
8844,76403,70387,67531,2856,67531,67531,70390,61967,8423,61967
8845,106503,102786,97311,5475,97311,97311,102787,97302,5485,97302
8846,311601,310606,299340,11266,299340,299340,310613,297320,13293,297320
8847,65622,59961,57914,2047,57914,57914,59968,57127,2841,57127
8848,54278,55029,53985,1044,53985,53985,55049,53656,1393,53656
8849,81433,81339,78319,3020,78319,78319,81299,77740,3559,77740
8850,4786,4673,4785,-112,4673,4673,4669,4342,327,4342
8851,2994,2665,2779,-114,2665,2665,2664,2643,21,2643
8852,7603,7606,7486,120,7486,7486,7621,7309,312,7309
8853,25938,27086,25930,1156,25930,25930,27107,25798,1309,25798
8854,73624,72164,71289,875,71289,71289,72164,70455,1709,70455
8855,8869,8795,8702,93,8702,8702,8795,8390,405,8390
8856,717904,105930,97178,8752,97178,97178,106201,92063,14138,92063
8857,97401,97385,91076,6309,91076,91076,97401,85844,11557,85844
8858,61427,47344,45227,2117,45227,45227,47363,43760,3603,43760
8859,47088,45986,45031,955,45031,45031,46020,44560,1460,44560
8860,86110,85578,83476,2102,83476,83476,85568,82979,2589,82979
8861,10571,10847,10512,335,10512,10512,10851,10454,397,10454
8862,12619,9347,9607,-260,9347,9347,9351,8273,1078,8273
8863,27641,25813,25936,-123,25813,25813,25828,25552,276,25552
8864,157436,156467,149263,7204,149263,149263,156466,148381,8085,148381
8865,18951,18128,17154,974,17154,17154,18124,17063,1061,17063
8866,44462,43703,44465,-762,43703,43703,43722,43541,181,43541
8867,271367,268344,262695,5649,262695,262695,268519,260569,7950,260569
8868,6145,6152,6054,98,6054,6054,6145,5876,269,5876
8869,102986,89838,90757,-919,89838,89838,89832,85347,4485,85347
8870,147953,143540,142387,1153,142387,142387,143575,141457,2118,141457
8871,14154,13807,13639,168,13639,13639,13807,13532,275,13532
8872,59418,63717,61223,2494,61223,59418,63727,59418,4309,59418
8873,9735,1567,1663,-96,1567,1567,1568,1555,13,1555
8874,11576,11310,11080,230,11080,11080,11312,10954,358,10954
8875,18250,18671,18628,43,18628,18250,18677,18250,427,18250
8876,350860,370522,350800,19722,350800,350800,370559,345826,24733,345826
8877,81335,86978,81313,5665,81313,81313,86926,81066,5860,81066
8878,12536,11761,11314,447,11314,11314,11755,11221,534,11221
8879,29415,29239,29324,-85,29239,29239,29235,28745,490,28745
8880,27274,26010,24592,1418,24592,24592,26006,24557,1449,24557
8881,112456,118871,112426,6445,112426,112426,118821,111834,6987,111834
8882,205189,203691,197251,6440,197251,197251,203588,196416,7172,196416
8883,344310,332942,316267,16675,316267,316267,332904,312551,20353,312551
8884,16736,16206,16051,155,16051,16051,16208,15817,391,15817
8885,24971,24433,22859,1574,22859,22859,24417,22591,1826,22591
8886,17962,17964,17268,696,17268,17268,17962,16813,1149,16813
8887,200227,200084,199715,369,199715,199715,200146,197065,3081,197065
8888,436523,414931,388953,25978,388953,388953,414892,386058,28834,386058
8889,16394,16398,15615,783,15615,15615,16394,15269,1125,15269
8890,11976,11356,11339,17,11339,11339,11352,11132,220,11132
8891,14781,14725,14344,381,14344,14344,14730,14159,571,14159
8892,1295,910,1162,-252,910,910,910,957,-47,957
8893,156887,153767,147057,6710,147057,147057,153743,146808,6935,146808
8894,18419,13006,12101,905,12101,12101,13006,11294,1712,11294
8895,11494,10479,10317,162,10317,10317,10480,10318,162,10318
8896,287350,278083,264931,13152,264931,264931,278153,263369,14784,263369
8897,487769,483174,492392,-9218,483174,483174,483261,481195,2066,481195
8898,23669,23679,23275,404,23275,23275,23669,22001,1668,22001
8899,16369,14845,14614,231,14614,14614,14859,13801,1058,13801
8900,44215,41161,37825,3336,37825,37825,41171,36885,4286,36885
8901,512028,485478,484675,803,484675,484675,485630,481146,4484,481146
8902,151830,144297,133844,10453,133844,133844,144381,133335,11046,133335
8903,21013,19867,19530,337,19530,19530,19869,19468,401,19468
8904,39056,40286,39696,590,39696,39056,40288,39256,1032,39056
8905,21061,20201,20037,164,20037,20037,20203,19821,382,19821
8906,15459,14730,13840,890,13840,13840,14734,13773,961,13773
8907,26323,26321,25328,993,25328,25328,26323,25180,1143,25180
8908,902362,885519,854423,31096,854423,854423,885554,849568,35986,849568
8909,3446,2988,3206,-218,2988,2988,2992,2960,32,2960
8910,123758,123179,115524,7655,115524,115524,123204,109748,13456,109748
8911,15121,14584,14548,36,14548,14548,14586,14304,282,14304
8912,13103,12583,12213,370,12213,12213,12581,12123,458,12123
8913,345065,333887,324103,9784,324103,324103,333898,322369,11529,322369
8914,45581,45714,45574,140,45574,45574,45728,45027,701,45027
8915,32126,33059,32049,1010,32049,32049,33053,31825,1228,31825
8916,247773,279387,252899,26488,252899,247773,279419,248219,31200,247773
8917,80035,84431,80147,4284,80147,80035,84403,80035,4368,80035
8918,14483,13859,13610,249,13610,13610,13861,13422,439,13422
8919,3772229,3728397,3600835,127562,3600835,3600835,3726990,3540540,186450,3540540
8920,15535,15101,14943,158,14943,14943,15104,14751,353,14751
8921,34186,32851,32985,-134,32851,32851,32854,32429,425,32429
8922,5798,4662,4727,-65,4662,4662,4661,4645,16,4645
8923,80436,68487,65031,3456,65031,65031,68512,64034,4478,64034
8924,56826,55894,54350,1544,54350,54350,55911,54063,1848,54063
8925,30400,31920,30336,1584,30336,30336,31918,29311,2607,29311
8926,8360,8527,8295,232,8295,8295,8512,7565,947,7565
8927,21390,22018,21381,637,21381,21381,22009,21217,792,21217
8928,4027,4026,4190,-164,4026,4026,4027,4023,4,4023
8929,54383,51960,49371,2589,49371,49371,51954,48916,3038,48916
8930,31440,30596,29590,1006,29590,29590,30596,28867,1729,28867
8931,51265,46882,44328,2554,44328,44328,46898,44244,2654,44244
8932,2092,2076,2373,-297,2076,2076,2075,2159,-84,2092
8933,102003,101923,99764,2159,99764,99764,101974,98664,3310,98664
8934,22365,21826,21010,816,21010,21010,21842,20889,953,20889
8935,13496,12951,13317,-366,12951,12951,12954,12926,28,12926
8936,54608,47893,45738,2155,45738,45738,47894,44150,3744,44150
8937,10135,9238,9275,-37,9238,9238,9237,9192,45,9192
8938,31549,28607,27634,973,27634,27634,28610,27420,1190,27420
8939,1938,1651,1877,-226,1651,1651,1648,1629,19,1629
8940,1432446,734738,690214,44524,690214,690214,734802,688339,46463,688339
8941,175396,181881,176309,5572,176309,175396,181958,174774,7184,174774
8942,20120,19500,18547,953,18547,18547,19504,18275,1229,18275
8943,51079,49485,47444,2041,47444,47444,49493,46961,2532,46961
8944,88005,93373,87463,5910,87463,87463,93407,87374,6033,87374
8945,25962,22653,21522,1131,21522,21522,22659,21308,1351,21308
8946,13225,13221,12889,332,12889,12889,13225,12767,458,12767
8947,2187,1257,1461,-204,1257,1257,1256,1305,-49,1305
8948,109618,109648,106874,2774,106874,106874,109636,106342,3294,106342
8949,284217,283281,259666,23615,259666,259666,283357,251531,31826,251531
8950,133052,133003,126757,6246,126757,126757,133033,121999,11034,121999
8951,21684,19904,19551,353,19551,19551,19896,18576,1320,18576
8952,75407,74240,73592,648,73592,73592,74260,72946,1314,72946
8953,125651,121533,116388,5145,116388,116388,121510,116245,5265,116245
8954,3263,2965,3202,-237,2965,2965,2961,2987,-26,2987
8955,23289,23113,23416,-303,23113,23113,23117,22684,433,22684
8956,206223,212574,206182,6392,206182,206182,212530,204929,7601,204929
8957,923,923,1180,-257,923,923,923,967,-44,923
8958,22729,22737,22729,8,22729,22729,22747,22298,449,22298
8959,30306,28700,27430,1270,27430,27430,28698,27333,1365,27333
8960,67013,67960,67307,653,67307,67013,67946,67186,760,67013
8961,22679,22126,21049,1077,21049,21049,22125,20937,1188,20937
8962,920597,845907,803270,42637,803270,803270,845787,792870,52917,792870
8963,143107,140011,134029,5982,134029,134029,139984,133945,6039,133945
8964,6951,6571,6643,-72,6571,6571,6572,6479,93,6479
8965,26602,24899,23721,1178,23721,23721,24902,23632,1270,23632
8966,28077,28073,27275,798,27275,27275,28077,26995,1082,26995
8967,118796,118843,111384,7459,111384,111384,118796,110995,7801,110995
8968,21824,21118,20258,860,20258,20258,21120,20159,961,20159
8969,2902,2901,3088,-187,2901,2901,2902,2839,63,2839
8970,15910,15438,15344,94,15344,15344,15438,15131,307,15131
8971,35850,35004,33862,1142,33862,33862,35016,33551,1465,33551
8972,90226,90167,87819,2348,87819,87819,90165,86573,3592,86573
8973,27164,27014,26605,409,26605,26605,27017,26158,859,26158
8974,8481,8453,8644,-191,8453,8453,8453,8369,84,8369
8975,19315,18695,18400,295,18400,18400,18696,18160,536,18160
8976,25442,24870,24368,502,24368,24368,24858,24122,736,24122
8977,622450,38176,37011,1165,37011,37011,38198,36857,1341,36857
8978,16605,16599,16310,289,16310,16310,16605,16101,504,16101
8979,54005,20539,19573,966,19573,19573,20541,19500,1041,19500
8980,691899,647552,643681,3871,643681,643681,647971,633612,14359,633612
8981,110812,109956,108462,1494,108462,108462,109921,107532,2389,107532
8982,39589,38351,36692,1659,36692,36692,38343,36277,2066,36277
8983,21976,22705,21479,1226,21479,21479,22716,21354,1362,21354
8984,56560,58898,56760,2138,56760,56560,58878,56013,2865,56013
8985,115252,97071,90784,6287,90784,90784,97084,89145,7939,89145
8986,8110,7845,8109,-264,7845,7845,7847,7731,116,7731
8987,15916,15449,14905,544,14905,14905,15462,14808,654,14808
8988,3645,3214,3282,-68,3214,3214,3215,3191,24,3191
8989,28977,28037,28330,-293,28037,28037,28044,27419,625,27419
8990,24360,19667,19156,511,19156,19156,19665,17021,2644,17021
8991,199932,199925,194491,5434,194491,194491,199932,189788,10144,189788
8992,17075,15448,15183,265,15183,15183,15444,15161,283,15161
8993,11626,515,760,-245,515,515,515,568,-53,568
8994,16422,17055,16404,651,16404,16404,17057,15800,1257,15800
8995,22984,24092,22926,1166,22926,22926,24102,22613,1489,22613
8996,1142,876,1081,-205,876,876,876,859,17,859
8997,28325,26914,26319,595,26319,26319,26927,25703,1224,25703
8998,14340,17245,17912,-667,17245,14340,17251,14332,2919,14332
8999,1994,1595,1824,-229,1595,1595,1594,1655,-61,1655
9000,7542,7310,7479,-169,7310,7310,7305,7155,150,7155
9001,123673,123641,119287,4354,119287,119287,123673,117674,5999,117674
9002,374383,297373,292780,4593,292780,292780,297162,288841,8321,288841
9003,13286,12776,12785,-9,12776,12776,12783,12612,171,12612
9004,43106,17699,17269,430,17269,17269,17703,17068,635,17068
9005,116256,116229,111891,4338,111891,111891,116274,111435,4839,111435
9006,3867,3504,3794,-290,3504,3504,3506,3561,-55,3561
9007,260825,259343,248415,10928,248415,248415,259398,248014,11384,248014
9008,77112,69638,65309,4329,65309,65309,69639,64509,5130,64509
9009,107278,93082,91169,1913,91169,91169,93058,90653,2405,90653
9010,54598,54627,52738,1889,52738,52738,54598,52448,2150,52448
9011,74577,65872,63742,2130,63742,63742,65871,60290,5581,60290
9012,9862,9416,9370,46,9370,9370,9421,9227,194,9227
9013,116714,116701,109447,7254,109447,109447,116714,109037,7677,109037
9014,9852,9299,9343,-44,9299,9299,9298,9109,189,9109
9015,10379,9205,9442,-237,9205,9205,9204,8915,289,8915
9016,54491,52944,51305,1639,51305,51305,52933,50846,2087,50846
9017,7860,7408,7395,13,7395,7395,7403,7252,151,7252
9018,686635,719269,678057,41212,678057,678057,719387,648661,70726,648661
9019,5821,5779,5899,-120,5779,5779,5781,5791,-10,5791
9020,45312,45319,44248,1071,44248,44248,45312,44010,1302,44010
9021,139702,130431,130352,79,130352,130352,130553,126804,3749,126804
9022,11991,11982,12133,-151,11982,11982,11991,11799,192,11799
9023,53425,55340,53455,1885,53455,53425,55354,51912,3442,51912
9024,40743,40738,40384,354,40384,40384,40743,39940,803,39940
9025,36516,36491,36398,93,36398,36398,36516,35762,754,35762
9026,619534,560467,546051,14416,546051,546051,560610,538496,22114,538496
9027,199257,211315,199247,12068,199247,199247,211427,193082,18345,193082
9028,121456,117831,114793,3038,114793,114793,117838,113594,4244,113594
9029,58327,58332,56697,1635,56697,56697,58348,55903,2445,55903
9030,102627,109714,104229,5485,104229,102627,109695,102580,7115,102580
9031,287910,278592,266510,12082,266510,266510,278605,264972,13633,264972
9032,40740,41329,41395,-66,41329,40740,41355,40732,623,40732
9033,4706,4338,4340,-2,4338,4338,4338,4206,132,4206
9034,11234,11197,11199,-2,11197,11197,11202,10969,233,10969
9035,167373,161431,150414,11017,150414,150414,161409,149840,11569,149840
9036,35059,35386,34571,815,34571,34571,35395,34437,958,34437
9037,13525,13647,13756,-109,13647,13525,13649,13497,152,13497
9038,3023,2660,2868,-208,2660,2660,2661,2702,-41,2702
9039,84828,87368,84758,2610,84758,84758,87351,84410,2941,84410
9040,16493,16103,15742,361,15742,15742,16103,15629,474,15629
9041,47821,45095,42619,2476,42619,42619,45077,42561,2516,42561
9042,30674,28382,27772,610,27772,27772,28404,26486,1918,26486
9043,112557,88688,86441,2247,86441,86441,88701,84933,3768,84933
9044,109339,111754,109320,2434,109320,109320,111827,107226,4601,107226
9045,608191,640887,608038,32849,608038,608038,641252,603329,37923,603329
9046,24288,24290,24517,-227,24290,24288,24288,24031,257,24031
9047,24727,24723,24228,495,24228,24228,24727,24059,668,24059
9048,377346,377427,378047,-620,377427,377346,377466,374779,2687,374779
9049,65755,65735,66318,-583,65735,65735,65763,64538,1225,64538
9050,2974,2326,2641,-315,2326,2326,2326,2267,59,2267
9051,45669,46596,46400,196,46400,45669,46625,45669,956,45669
9052,12056,11194,11478,-284,11194,11194,11206,11229,-23,11229
9053,195475,191065,182967,8098,182967,182967,191108,182448,8660,182448
9054,15991,14872,14485,387,14485,14485,14878,14007,871,14007
9055,238115,247959,244115,3844,244115,238115,247977,239635,8342,238115
9056,14411,14242,14072,170,14072,14072,14239,13760,479,13760
9057,14457,14459,14540,-81,14459,14457,14457,14325,132,14325
9058,37122,36499,34620,1879,34620,34620,36528,34522,2006,34522
9059,188440,158708,151924,6784,151924,151924,158740,149897,8843,149897
9060,1254,862,1099,-237,862,862,861,892,-31,892
9061,57970,58808,57964,844,57964,57964,58819,57568,1251,57568
9062,31406,5425,5816,-391,5425,5425,5424,5715,-291,5715
9063,2627,2455,2626,-171,2455,2455,2456,2491,-35,2491
9064,309857,309562,303568,5994,303568,303568,309722,298456,11266,298456
9065,439328,432953,431135,1818,431135,431135,433170,421184,11986,421184
9066,128209,130928,129598,1330,129598,128209,130955,128209,2746,128209
9067,5309,4876,4938,-62,4876,4876,4878,4812,66,4812
9068,4372,4303,4310,-7,4303,4303,4301,4184,117,4184
9069,4188,3835,4047,-212,3835,3835,3835,3837,-2,3837
9070,14068,13101,12833,268,12833,12833,13106,11831,1275,11831
9071,16289,16263,16208,55,16208,16208,16263,15999,264,15999
9072,150564,156390,151202,5188,151202,150564,156348,150564,5784,150564
9073,41245,43487,41244,2243,41244,41244,43495,40730,2765,40730
9074,659,659,898,-239,659,659,659,707,-48,659
9075,716146,715354,697522,17832,697522,697522,715641,693546,22095,693546
9076,225106,224119,218627,5492,218627,218627,224253,214991,9262,214991
9077,1015,921,1178,-257,921,921,920,973,-53,973
9078,43172,43176,44585,-1409,43176,43172,43169,41574,1595,41574
9079,340425,352886,340364,12522,340364,340364,352733,335791,16942,335791
9080,9498,9503,9610,-107,9503,9498,9501,9354,147,9354
9081,65492,39551,37810,1741,37810,37810,39570,37234,2336,37234
9082,1502,1502,1727,-225,1502,1502,1502,1531,-29,1502
9083,9539,8141,7751,390,7751,7751,8141,7162,979,7162
9084,113329,119397,114801,4596,114801,113329,119452,113329,6123,113329
9085,77531,74506,70241,4265,70241,70241,74487,68744,5743,68744
9086,12011,10835,10780,55,10780,10780,10839,10653,186,10653
9087,59883,59393,56299,3094,56299,56299,59395,56168,3227,56168
9088,1883,937,1168,-231,937,937,937,997,-60,997
9089,233076,232919,219303,13616,219303,219303,233030,214377,18653,214377
9090,33517,14755,14594,161,14594,14594,14760,14407,353,14407
9091,2111,1173,1389,-216,1173,1173,1173,1224,-51,1224
9092,81285,82639,81625,1014,81625,81285,82663,81524,1139,81285
9093,30338,29792,27807,1985,27807,27807,29796,26388,3408,26388
9094,14725,14237,14021,216,14021,14021,14226,13862,364,13862
9095,92727,90050,88812,1238,88812,88812,90074,87838,2236,87838
9096,26309,26326,25709,617,25709,25709,26327,25488,839,25488
9097,9587,10716,10657,59,10657,9587,10712,9479,1233,9479
9098,34888,34188,33536,652,33536,33536,34193,29373,4820,29373
9099,22520,22057,21375,682,21375,21375,22053,21207,846,21207
9100,3850,3853,4002,-149,3853,3850,3850,3790,60,3790
9101,17946,17563,17436,127,17436,17436,17566,17324,242,17324
9102,19437,17396,17033,363,17033,17033,17403,16892,511,16892
9103,5628,5173,5249,-76,5173,5173,5174,5104,70,5104
9104,426864,441637,430838,10799,430838,426864,441665,428707,12958,426864
9105,15420,15788,15413,375,15413,15413,15778,15276,502,15276
9106,7104,6720,6737,-17,6720,6720,6723,6603,120,6603
9107,313947,311347,296756,14591,296756,296756,311269,295047,16222,295047
9108,9133,9135,9579,-444,9135,9133,9138,9090,48,9090
9109,22361,22363,21886,477,21886,21886,22361,21611,750,21611
9110,18760,18964,18691,273,18691,18691,18974,18314,660,18314
9111,55850,57456,55783,1673,55783,55783,57467,55228,2239,55228
9112,2516,2105,2249,-144,2105,2105,2106,2095,11,2095
9113,354181,350643,330866,19777,330866,330866,350681,326119,24562,326119
9114,195187,194289,182678,11611,182678,182678,194303,175372,18931,175372
9115,161550,158936,154783,4153,154783,154783,158941,152980,5961,152980
9116,27218,26542,25710,832,25710,25710,26542,25600,942,25600
9117,106538,93809,93143,666,93143,93143,93837,92880,957,92880
9118,16385,16833,16384,449,16384,16384,16828,16278,550,16278
9119,57477,51467,50530,937,50530,50530,51488,50412,1076,50412
9120,7673,7575,7611,-36,7575,7575,7573,7450,123,7450
9121,303802,294442,278004,16438,278004,278004,294566,276871,17695,276871
9122,1664,1681,1947,-266,1681,1664,1682,1727,-45,1664
9123,183100,164563,157812,6751,157812,157812,164607,154964,9643,154964
9124,25737,26203,25879,324,25879,25737,26202,25729,473,25729
9125,41495,41100,39457,1643,39457,39457,41090,36995,4095,36995
9126,3644,3629,3764,-135,3629,3629,3630,3557,73,3557
9127,16720,15994,15751,243,15751,15751,15989,15638,351,15638
9128,448360,419011,388320,30691,388320,388320,419151,380881,38270,380881
9129,17318,17579,17734,-155,17579,17318,17576,17318,258,17318
9130,17053,16386,16137,249,16137,16137,16391,15882,509,15882
9131,33042,6463,6697,-234,6463,6463,6462,5912,550,5912
9132,8042,7487,7618,-131,7487,7487,7488,7267,221,7267
9133,94949,98175,95462,2713,95462,94949,98182,94327,3855,94327
9134,4848,4718,4788,-70,4718,4718,4717,4529,188,4529
9135,59244,58297,57345,952,57345,57345,58308,56677,1631,56677
9136,30368,29338,27996,1342,27996,27996,29330,27810,1520,27810
9137,237647,215973,205982,9991,205982,205982,216032,205303,10729,205303
9138,39936,40891,39485,1406,39485,39485,40929,39085,1844,39085
9139,42434,42917,42223,694,42223,42223,42950,41506,1444,41506
9140,128429,115821,111460,4361,111460,111460,115926,110784,5142,110784
9141,3416,2521,2727,-206,2521,2521,2517,2486,31,2486
9142,43527,43517,41685,1832,41685,41685,43527,41394,2133,41394
9143,133515,109526,106131,3395,106131,106131,109537,103818,5719,103818
9144,953,284,518,-234,284,284,284,331,-47,331
9145,2116,1743,1923,-180,1743,1743,1744,1787,-43,1787
9146,65355,68510,65579,2931,65579,65355,68529,65365,3164,65355
9147,30787,30216,30046,170,30046,30046,30223,29582,641,29582
9148,6920,6551,6706,-155,6551,6551,6551,6482,69,6482
9149,22848,22291,21600,691,21600,21600,22296,21518,778,21518
9150,176016,175132,168219,6913,168219,168219,175133,166174,8959,166174
9151,1330,1302,1571,-269,1302,1302,1300,1354,-54,1330
9152,15634,15632,15116,516,15116,15116,15634,15036,598,15036
9153,29651,30635,29647,988,29647,29647,30635,29500,1135,29500
9154,9525,9398,9599,-201,9398,9398,9395,9415,-20,9415
9155,10396,10399,10366,33,10366,10366,10399,10159,240,10159
9156,66692,42950,41511,1439,41511,41511,42958,41369,1589,41369
9157,1945,1628,1884,-256,1628,1628,1631,1683,-52,1683
9158,184430,157068,149823,7245,149823,149823,157129,148803,8326,148803
9159,26069,26943,26070,873,26070,26069,26964,24783,2181,24783
9160,34949,36000,34435,1565,34435,34435,36015,34327,1688,34327
9161,35572,32130,32953,-823,32130,32130,32129,31533,596,31533
9162,248869,248873,243805,5068,243805,243805,248887,239853,9034,239853
9163,26210,23818,24009,-191,23818,23818,23817,23123,694,23123
9164,14709,7503,7574,-71,7503,7503,7509,7447,62,7447
9165,2110,2111,2165,-54,2111,2110,2110,2056,54,2056
9166,954,285,519,-234,285,285,285,332,-47,332
9167,18418,17703,17150,553,17150,17150,17706,16961,745,16961
9168,38575,40808,40350,458,40350,38575,40815,38552,2263,38552
9169,187388,185171,187357,-2186,185171,185171,185185,175799,9386,175799
9170,17197,16509,16360,149,16360,16360,16514,16090,424,16090
9171,27611,25838,24575,1263,24575,24575,25845,24506,1339,24506
9172,93145,99267,93081,6186,93081,93081,99224,92188,7036,92188
9173,2747,2747,2936,-189,2747,2747,2747,2748,-1,2747
9174,565173,512054,494500,17554,494500,494500,512242,492394,19848,492394
9175,105925,104456,99939,4517,99939,99939,104412,99741,4671,99741
9176,46367,42677,41770,907,41770,41770,42674,41298,1376,41298
9177,217720,209103,201329,7774,201329,201329,209068,200046,9022,200046
9178,90163,88864,83349,5515,83349,83349,88901,83167,5734,83167
9179,144248,145866,142608,3258,142608,142608,145868,126697,19171,126697
9180,93039,91260,93015,-1755,91260,91260,91265,79890,11375,79890
9181,177323,187668,183846,3822,183846,177323,187678,177315,10363,177315
9182,93203,92636,88899,3737,88899,88899,92649,88433,4216,88433
9183,16762,16052,16762,-710,16052,16052,16052,11742,4310,11742
9184,5315,4923,5006,-83,4923,4923,4919,4860,59,4860
9185,27641,27629,27563,66,27563,27563,27641,25688,1953,25688
9186,19434,19446,18558,888,18558,18558,19434,16712,2722,16712
9187,340683,339694,330317,9377,330317,330317,339764,327084,12680,327084
9188,206714,175854,168864,6990,168864,168864,175854,168290,7564,168290
9189,190712,163370,164525,-1155,163370,163370,163494,161954,1540,161954
9190,56924,56118,53461,2657,53461,53461,56114,53283,2831,53283
9191,102574,101616,97744,3872,97744,97744,101637,92066,9571,92066
9192,220519,209988,197994,11994,197994,197994,210084,196887,13197,196887
9193,36787,37752,37130,622,37130,36787,37759,36890,869,36787
9194,476401,457373,432678,24695,432678,432678,457346,428705,28641,428705
9195,14898,14873,14891,-18,14873,14873,14883,14287,596,14287
9196,84156,58637,58913,-276,58637,58637,58638,58320,318,58320
9197,123494,117588,108403,9185,108403,108403,117616,107254,10362,107254
9198,8498,8496,8838,-342,8496,8496,8498,8284,214,8284
9199,85116,91236,85119,6117,85119,85116,91228,82339,8889,82339
9200,1467099,1386772,1339049,47723,1339049,1339049,1387058,1314170,72888,1314170
9201,7314,6978,7093,-115,6978,6978,6973,6917,56,6917
9202,137840,135211,132294,2917,132294,132294,135324,131526,3798,131526
9203,40168,40169,38930,1239,38930,38930,40168,38805,1363,38805
9204,203905,200729,200788,-59,200729,200729,200702,196620,4082,196620
9205,177406,189594,177852,11742,177852,177406,189674,171547,18127,171547
9206,31826,30949,31015,-66,30949,30949,30948,30466,482,30466
9207,35259,35265,34666,599,34666,34666,35259,34164,1095,34164
9208,12965,12411,12218,193,12218,12218,12411,11988,423,11988
9209,131912,128706,122949,5757,122949,122949,128642,122556,6086,122556
9210,379,379,613,-234,379,379,379,424,-45,379
9211,224543,231642,224506,7136,224506,224506,231651,222833,8818,222833
9212,11386,11390,11325,65,11325,11325,11399,10994,405,10994
9213,215083,218161,212484,5677,212484,212484,218179,210697,7482,210697
9214,25233,24115,24478,-363,24115,24115,24137,24051,86,24051
9215,41485,41479,40565,914,40565,40565,41485,40055,1430,40055
9216,3939,3433,3635,-202,3433,3433,3434,3503,-69,3503
9217,126158,116605,114342,2263,114342,114342,116606,113365,3241,113365
9218,221334,222689,221308,1381,221308,221308,222811,218829,3982,218829
9219,5655,5257,5381,-124,5257,5257,5255,5181,74,5181
9220,14542,13594,12878,716,12878,12878,13594,11660,1934,11660
9221,49776,49750,47654,2096,47654,47654,49776,47649,2127,47649
9222,25578,26409,25562,847,25562,25562,26419,24928,1491,24928
9223,44606,43425,43112,313,43112,43112,43407,42465,942,42465
9224,329603,344828,331988,12840,331988,329603,344899,330586,14313,329603
9225,7150,7156,7328,-172,7156,7150,7150,7052,98,7052
9226,24786,24131,23311,820,23311,23311,24132,23269,863,23269
9227,12078,11470,11287,183,11287,11287,11473,11005,468,11005
9228,27567,12585,12514,71,12514,12514,12594,12004,590,12004
9229,1488,1462,1669,-207,1462,1462,1462,1471,-9,1471
9230,1184,682,914,-232,682,682,682,664,18,664
9231,17707,17667,17092,575,17092,17092,17671,16912,759,16912
9232,239685,244880,239073,5807,239073,239073,244889,238580,6309,238580
9233,33906,17796,17396,400,17396,17396,17808,16815,993,16815
9234,6778,6126,6006,120,6006,6006,6128,5718,410,5718
9235,14186,14980,14402,578,14402,14186,14975,14186,789,14186
9236,12699,12051,11851,200,11851,11851,12045,11729,316,11729
9237,5856,2624,2861,-237,2624,2624,2625,2679,-54,2679
9238,5837,5446,5678,-232,5446,5446,5451,5491,-40,5491
9239,20597,18945,18269,676,18269,18269,18947,18177,770,18177
9240,5824,5534,5531,3,5531,5531,5532,5202,330,5202
9241,176972,140913,134695,6218,134695,134695,140953,134599,6354,134599
9242,148491,153057,148491,4566,148491,148491,153063,146994,6069,146994
9243,127180,120770,119607,1163,119607,119607,120858,116411,4447,116411
9244,1807,836,1083,-247,836,836,836,889,-53,889
9245,11643,11635,11728,-93,11635,11635,11643,11185,458,11185
9246,22997,23611,22936,675,22936,22936,23616,22116,1500,22116
9247,6650,6688,6645,43,6645,6645,6691,6252,439,6252
9248,13992,14381,14333,48,14333,13992,14382,13984,398,13984
9249,10177,10172,10364,-192,10172,10172,10173,10144,29,10144
9250,1388759,1313566,1226028,87538,1226028,1226028,1313649,1215354,98295,1215354
9251,106960,98978,96322,2656,96322,96322,98985,95736,3249,95736
9252,6080,5634,5780,-146,5634,5634,5637,5593,44,5593
9253,40459,42096,40381,1715,40381,40381,42108,40281,1827,40281
9254,707,466,707,-241,466,466,466,512,-46,512
9255,863566,863422,820722,42700,820722,820722,863268,813700,49568,813700
9256,19655,11495,11661,-166,11495,11495,11499,11416,83,11416
9257,36465,33429,33273,156,33273,33273,33437,32773,664,32773
9258,83840,83333,80437,2896,80437,80437,83286,79870,3416,79870
9259,5366,5367,5506,-139,5367,5366,5366,5377,-11,5366
9260,5379,5376,5398,-22,5376,5376,5372,5158,214,5158
9261,272522,229884,221576,8308,221576,221576,229971,217270,12701,217270
9262,18924,18083,17798,285,17798,17798,18086,17712,374,17712
9263,21453,21462,21053,409,21053,21053,21453,20891,562,20891
9264,121175,117139,113198,3941,113198,113198,117203,112140,5063,112140
9265,6908,6540,6718,-178,6540,6540,6541,6286,255,6286
9266,682478,635027,607294,27733,607294,607294,635180,602231,32949,602231
9267,15453,14971,14707,264,14707,14707,14973,14565,408,14565
9268,10609,10777,10648,129,10648,10609,10776,10560,216,10560
9269,189389,177863,165442,12421,165442,165442,177872,163671,14201,163671
9270,10902,10872,11371,-499,10872,10872,10876,10871,5,10871
9271,16790,16783,16777,6,16777,16777,16790,16486,304,16486
9272,16937,14616,14956,-340,14616,14616,14614,14037,577,14037
9273,239790,197119,181909,15210,181909,181909,197279,175497,21782,175497
9274,14868,14664,14860,-196,14664,14664,14671,14550,121,14550
9275,5846,5801,5979,-178,5801,5801,5804,5662,142,5662
9276,125854,131313,125312,6001,125312,125312,131295,123660,7635,123660
9277,58048,56645,52745,3900,52745,52745,56633,48215,8418,48215
9278,197330,167776,168514,-738,167776,167776,167875,151724,16151,151724
9279,204012,169753,163271,6482,163271,163271,169788,161634,8154,161634
9280,6103,6099,6203,-104,6099,6099,6098,6035,63,6035
9281,13716,13223,12758,465,12758,12758,13226,12605,621,12605
9282,22234,20453,19025,1428,19025,19025,20468,18810,1658,18810
9283,18492,18492,18327,165,18327,18327,18492,18200,292,18200
9284,24366,23301,22456,845,22456,22456,23302,22389,913,22389
9285,3632,3645,3950,-305,3645,3632,3648,3646,2,3632
9286,97170,93335,88441,4894,88441,88441,93382,87989,5393,87989
9287,39072,39054,36269,2785,36269,36269,39068,35534,3534,35534
9288,954,285,519,-234,285,285,285,332,-47,332
9289,77620,71866,67573,4293,67573,67573,71855,67363,4492,67363
9290,4453,4042,4133,-91,4042,4042,4044,4025,19,4025
9291,38897,25256,24068,1188,24068,24068,25252,23955,1297,23955
9292,108913,107793,106136,1657,106136,106136,107799,105140,2659,105140
9293,46257,45191,44713,478,44713,44713,45187,43713,1474,43713
9294,29287,29271,29533,-262,29271,29271,29287,29052,235,29052
9295,18833,18007,17557,450,17557,17557,17994,17340,654,17340
9296,176645,144824,135309,9515,135309,135309,144843,134007,10836,134007
9297,40944,40105,38397,1708,38397,38397,40108,37103,3005,37103
9298,36531,37170,35827,1343,35827,35827,37196,35826,1370,35826
9299,4224,3512,3690,-178,3512,3512,3513,3516,-3,3516
9300,6956,6846,6953,-107,6846,6846,6844,6757,87,6757
9301,1009,1008,1233,-225,1008,1008,1009,1059,-50,1009
9302,114870,113656,109949,3707,109949,109949,113685,109091,4594,109091
9303,425280,380765,353718,27047,353718,353718,380785,344125,36660,344125
9304,5186,5183,5293,-110,5183,5183,5186,5172,14,5172
9305,235267,244397,235224,9173,235224,235224,244480,233971,10509,233971
9306,46797,46139,44694,1445,44694,44694,46141,44304,1837,44304
9307,115966,112175,108241,3934,108241,108241,112194,107325,4869,107325
9308,6673,6757,6778,-21,6757,6673,6760,6673,87,6673
9309,25287,25293,24732,561,24732,24732,25298,24388,910,24388
9310,82477,81482,80772,710,80772,80772,81494,80037,1457,80037
9311,18605,18001,17708,293,17708,17708,17998,17631,367,17631
9312,19870,18639,18043,596,18043,18043,18646,17835,811,17835
9313,2616,2719,2857,-138,2719,2616,2720,2608,112,2608
9314,9089,7919,7870,49,7870,7870,7920,7142,778,7142
9315,53805,54899,53191,1708,53191,53191,54902,52481,2421,52481
9316,14833,14831,15078,-247,14831,14831,14833,14687,146,14687
9317,26191,26703,26022,681,26022,26022,26709,25472,1237,25472
9318,66044,68406,66508,1898,66508,66044,68424,66274,2150,66044
9319,137297,137191,132831,4360,132831,132831,137190,131835,5355,131835
9320,35842,35669,34938,731,34938,34938,35670,33699,1971,33699
9321,5007,4647,4827,-180,4647,4647,4651,4632,19,4632
9322,1908671,1876000,1819248,56752,1819248,1819248,1875773,1808960,66813,1808960
9323,4566,4286,4244,42,4244,4244,4287,3944,343,3944
9324,2670,2239,2447,-208,2239,2239,2242,2269,-27,2269
9325,89938,56091,55022,1069,55022,55022,56083,54766,1317,54766
9326,1658280,1611786,1519242,92544,1519242,1519242,1611926,1498968,112958,1498968
9327,21116,22246,20962,1284,20962,20962,22246,20494,1752,20494
9328,870834,825106,813781,11325,813781,813781,825284,796612,28672,796612
9329,136737,115274,112187,3087,112187,112187,115319,111021,4298,111021
9330,47508,46518,45057,1461,45057,45057,46527,44468,2059,44468
9331,13031,13307,13492,-185,13307,13031,13309,13074,235,13031
9332,20627,21048,20640,408,20640,20627,21051,20321,730,20321
9333,22356,19177,18988,189,18988,18988,19194,18808,386,18808
9334,26289,27320,26224,1096,26224,26224,27325,24896,2429,24896
9335,251904,224638,216284,8354,216284,216284,224698,214094,10604,214094
9336,9177,8336,8586,-250,8336,8336,8337,8349,-12,8349
9337,11830,11795,11679,116,11679,11679,11804,11545,259,11545
9338,2034,1564,1785,-221,1564,1564,1566,1557,9,1557
9339,35837,34993,34946,47,34946,34946,34987,33713,1274,33713
9340,44127,42293,40692,1601,40692,40692,42319,39850,2469,39850
9341,24248,13549,13291,258,13291,13291,13551,12948,603,12948
9342,21294,21245,20959,286,20959,20959,21258,20859,399,20859
9343,169048,171460,168088,3372,168088,168088,171403,167382,4021,167382
9344,32372,30718,29043,1675,29043,29043,30706,28982,1724,28982
9345,12842,11745,11468,277,11468,11468,11752,11051,701,11051
9346,39301,40795,39230,1565,39230,39230,40784,39202,1582,39202
9347,8758,8763,8663,100,8663,8663,8758,8539,219,8539
9348,14415,14413,14345,68,14345,14345,14415,14234,181,14234
9349,594782,546362,540137,6225,540137,540137,546410,526647,19763,526647
9350,6214,6092,6156,-64,6092,6092,6097,5803,294,5803
9351,18891,18893,18355,538,18355,18355,18891,16660,2231,16660
9352,2367,2047,2250,-203,2047,2047,2047,2102,-55,2102
9353,20845,20844,20332,512,20332,20332,20849,20223,626,20223
9354,39405,31144,31012,132,31012,31012,31146,30354,792,30354
9355,7542,9150,9270,-120,9150,7542,9151,6673,2478,6673
9356,152516,146569,137046,9523,137046,137046,146554,135889,10665,135889
9357,366330,365315,340758,24557,340758,340758,365500,333671,31829,333671
9358,35418,32766,31054,1712,31054,31054,32774,30518,2256,30518
9359,151189,156907,153386,3521,153386,151189,156967,151189,5778,151189
9360,6652,6106,6211,-105,6106,6106,6109,6030,79,6030
9361,44307,44293,42837,1456,42837,42837,44307,42719,1588,42719
9362,414101,414087,397441,16646,397441,397441,414101,394673,19428,394673
9363,113152,102207,102856,-649,102207,102207,102245,99331,2914,99331
9364,2674,2634,2863,-229,2634,2634,2635,2686,-51,2674
9365,54105,53239,51109,2130,51109,51109,53276,50971,2305,50971
9366,2940,1983,2195,-212,1983,1983,1984,2016,-32,2016
9367,49451,49424,47717,1707,47717,47717,49434,47516,1918,47516
9368,114927,114924,117521,-2597,114924,114924,114927,113374,1553,113374
9369,187850,190580,187370,3210,187370,187370,190613,186148,4465,186148
9370,51010,50149,48869,1280,48869,48869,50147,48747,1400,48747
9371,838210,812918,777839,35079,777839,777839,813014,767763,45251,767763
9372,24548,23633,22710,923,22710,22710,23639,22687,952,22687
9373,10410,9750,9673,77,9673,9673,9750,9490,260,9490
9374,17435,16205,15802,403,15802,15802,16194,15758,436,15758
9375,145103,141554,138406,3148,138406,138406,141605,137375,4230,137375
9376,28045,14045,13633,412,13633,13633,14049,13320,729,13320
9377,2055,2056,2321,-265,2056,2055,2055,2117,-62,2055
9378,3610,3454,3548,-94,3454,3454,3455,3363,92,3363
9379,91169,66075,63456,2619,63456,63456,66046,62941,3105,62941
9380,19613,18616,17693,923,17693,17693,18615,17619,996,17619
9381,166303,166277,161638,4639,161638,161638,166242,160701,5541,160701
9382,10800,10273,10221,52,10221,10221,10276,9887,389,9887
9383,28532,27770,26984,786,26984,26984,27766,26965,801,26965
9384,1974,1540,1744,-204,1540,1540,1540,1580,-40,1580
9385,29584,27183,26311,872,26311,26311,27182,25245,1937,25245
9386,56510,56491,55737,754,55737,55737,56491,54430,2061,54430
9387,16775,16335,16293,42,16293,16293,16347,16153,194,16153
9388,17779,16097,15946,151,15946,15946,16103,15601,502,15601
9389,59372,50740,48995,1745,48995,48995,50731,48704,2027,48704
9390,26713,27370,26638,732,26638,26638,27368,26245,1123,26245
9391,10758,11279,10720,559,10720,10720,11279,10518,761,10518
9392,16669,17316,17251,65,17251,16669,17316,16079,1237,16079
9393,60771,61003,60596,407,60596,60596,61036,59669,1367,59669
9394,77023,69363,67741,1622,67741,67741,69349,67109,2240,67109
9395,70178,69481,65738,3743,65738,65738,69499,65464,4035,65464
9396,131338,130295,123782,6513,123782,123782,130320,123518,6802,123518
9397,425256,425256,401220,24036,401220,401220,425113,398164,26949,398164
9398,122699,125921,124587,1334,124587,122699,125965,122077,3888,122077
9399,11300,11154,11295,-141,11154,11154,11162,11087,75,11087
9400,1893732,1878481,1812022,66459,1812022,1812022,1878276,1774495,103781,1774495
9401,77744,75103,70653,4450,70653,70653,75121,69169,5952,69169
9402,88072,91510,88053,3457,88053,88053,91577,87260,4317,87260
9403,26627,26139,25906,233,25906,25906,26153,25708,445,25708
9404,220611,179317,168498,10819,168498,168498,179312,165436,13876,165436
9405,2240,2114,2301,-187,2114,2114,2118,2173,-55,2173
9406,1524,1231,1462,-231,1231,1231,1232,1282,-50,1282
9407,5140,4716,4781,-65,4716,4716,4716,4600,116,4600
9408,38053,37646,38194,-548,37646,37646,37649,37591,58,37591
9409,12729,13727,13387,340,13387,12729,13735,12107,1628,12107
9410,4217,4215,4262,-47,4215,4215,4217,3806,411,3806
9411,6284,5653,5761,-108,5653,5653,5652,5614,38,5614
9412,11843,10465,10365,100,10365,10365,10462,10183,279,10183
9413,4948,4449,4607,-158,4449,4449,4453,4440,13,4440
9414,18193,18623,18186,437,18186,18186,18626,17651,975,17651
9415,19818,17350,17228,122,17228,17228,17356,16116,1240,16116
9416,16534,15934,15517,417,15517,15517,15935,15390,545,15390
9417,3814,3437,3545,-108,3437,3437,3435,3411,24,3411
9418,33770,31055,30600,455,30600,30600,31056,30297,759,30297
9419,419339,419142,419264,-122,419142,419142,419625,414092,5533,414092
9420,14846,15229,14785,444,14785,14785,15230,14703,527,14703
9421,38888,38867,37214,1653,37214,37214,38862,36562,2300,36562
9422,2607588,2607908,2440204,167704,2440204,2440204,2607588,2413652,193936,2413652
9423,76980,61537,57196,4341,57196,57196,61535,56448,5087,56448
9424,21608,20210,19590,620,19590,19590,20200,19423,777,19423
9425,11916,10878,10770,108,10770,10770,10867,10653,214,10653
9426,29799,30225,29775,450,29775,29775,30221,29366,855,29366
9427,438987,437999,421206,16793,421206,421206,437937,415929,22008,415929
9428,20899,20899,20180,719,20180,20180,20899,20069,830,20069
9429,1049653,1068892,1049607,19285,1049607,1049607,1069385,1042519,26866,1042519
9430,21452,21464,21752,-288,21464,21452,21474,21254,220,21254
9431,8841,8841,8633,208,8633,8633,8841,8587,254,8587
9432,4425,4423,4484,-61,4423,4423,4425,4330,95,4330
9433,56370,59559,56362,3197,56362,56362,59558,55975,3583,55975
9434,581642,591368,564186,27182,564186,564186,591314,563324,27990,563324
9435,448674,413313,410096,3217,410096,410096,413388,406113,7275,406113
9436,66556,65603,64059,1544,64059,64059,65610,56236,9374,56236
9437,45307,43356,42484,872,42484,42484,43361,42300,1061,42300
9438,10350,10582,10290,292,10290,10290,10579,10161,418,10161
9439,19533,18816,18528,288,18528,18528,18820,18374,446,18374
9440,3888,3473,3741,-268,3473,3473,3470,3504,-34,3504
9441,15071,14658,15021,-363,14658,14658,14655,14449,206,14449
9442,13478,13666,13473,193,13473,13473,13668,13403,265,13403
9443,13202,12415,12076,339,12076,12076,12416,11715,701,11715
9444,24056,23256,22973,283,22973,22973,23261,22760,501,22760
9445,36751,27274,24863,2411,24863,24863,27278,23731,3547,23731
9446,39759,18675,18659,16,18659,18659,18688,18521,167,18521
9447,10588,10592,10441,151,10441,10441,10588,10268,320,10268
9448,11141,11138,11204,-66,11138,11138,11141,11005,136,11005
9449,46105,14836,14652,184,14652,14652,14844,14522,322,14522
9450,62535,61523,60386,1137,60386,60386,61561,59966,1595,59966
9451,677,677,907,-230,677,677,677,721,-44,677
9452,93636,93596,95437,-1841,93596,93596,93636,93129,507,93129
9453,9761,9766,9822,-56,9766,9761,9761,9638,123,9638
9454,83071,85867,83071,2796,83071,83071,85882,82626,3256,82626
9455,5601,5600,5880,-280,5600,5600,5601,5660,-59,5601
9456,3866,3393,3462,-69,3393,3393,3394,3248,146,3248
9457,76476,55743,55519,224,55519,55519,55777,52953,2824,52953
9458,2410,1474,1716,-242,1474,1474,1480,1519,-39,1519
9459,2776,2779,2891,-112,2779,2776,2776,2753,23,2753
9460,22614,23752,22613,1139,22613,22613,23752,22433,1319,22433
9461,5757,5319,5439,-120,5319,5319,5319,5261,58,5261
9462,18595,18585,18349,236,18349,18349,18599,17889,710,17889
9463,27193,27357,27284,73,27284,27193,27354,27019,335,27019
9464,8126,8593,8497,96,8497,8126,8601,8086,515,8086
9465,92536,72994,73266,-272,72994,72994,73037,68343,4694,68343
9466,18211,18207,17830,377,17830,17830,18211,17663,548,17663
9467,5566,6083,5977,106,5977,5566,6088,5562,526,5562
9468,14783,14692,14926,-234,14692,14692,14692,14486,206,14486
9469,8201,8687,8197,490,8197,8197,8695,7714,981,7714
9470,18593,18466,17812,654,17812,17812,18467,17598,869,17598
9471,23792,22468,21953,515,21953,21953,22463,21257,1206,21257
9472,25768,6281,6446,-165,6281,6281,6279,6196,83,6196
9473,16189,15458,15409,49,15409,15409,15463,15184,279,15184
9474,6566,5926,5942,-16,5926,5926,5926,5857,69,5857
9475,29793,29069,28210,859,28210,28210,29062,28007,1055,28007
9476,70348,73356,73670,-314,73356,70348,73355,71939,1416,70348
9477,11171,11617,11174,443,11174,11171,11614,11047,567,11047
9478,1119,731,975,-244,731,731,731,778,-47,778
9479,84730,91024,91222,-198,91024,84730,91053,84730,6323,84730
9480,35417,36850,35343,1507,35343,35343,36866,35104,1762,35104
9481,18039,19140,17974,1166,17974,17974,19148,17886,1262,17886
9482,425383,50527,47205,3322,47205,47205,50541,42366,8175,42366
9483,5564,4994,5231,-237,4994,4994,4998,5022,-24,5022
9484,46359,48575,46716,1859,46716,46359,48572,45737,2835,45737
9485,31881,36337,35911,426,35911,31881,36349,31873,4476,31873
9486,5548,4770,4766,4,4766,4766,4767,4608,159,4608
9487,96232,100975,100834,141,100834,96232,101032,98118,2914,96232
9488,23432,21565,20512,1053,20512,20512,21564,20118,1446,20118
9489,1153,1152,1387,-235,1152,1152,1153,1203,-50,1153
9490,7867,2985,3184,-199,2985,2985,2988,3027,-39,3027
9491,585,585,829,-244,585,585,585,630,-45,585
9492,29416,29688,29339,349,29339,29339,29679,28960,719,28960
9493,119804,89526,85711,3815,85711,85711,89531,82666,6865,82666
9494,3753,3221,3361,-140,3221,3221,3218,3203,15,3203
9495,39019,36618,34227,2391,34227,34227,36631,34063,2568,34063
9496,8173,8174,8110,64,8110,8110,8172,7520,652,7520
9497,205228,201881,197170,4711,197170,197170,201926,194819,7107,194819
9498,16871,16362,15777,585,15777,15777,16366,15704,662,15704
9499,181294,184421,181271,3150,181271,181271,184397,179337,5060,179337
9500,6329,6317,6270,47,6270,6270,6319,6096,223,6096
9501,4965,4551,4661,-110,4551,4551,4552,4449,103,4449
9502,7589,6691,6582,109,6582,6582,6691,6205,486,6205
9503,41616,40669,38687,1982,38687,38687,40672,38084,2588,38084
9504,13267,12660,12241,419,12241,12241,12671,11899,772,11899
9505,12178,11628,11435,193,11435,11435,11624,10255,1369,10255
9506,16509,16275,16503,-228,16275,16275,16274,16126,148,16126
9507,5614,5632,5629,3,5629,5614,5632,5281,351,5281
9508,98761,99944,100029,-85,99944,98761,100007,98761,1246,98761
9509,146018,146000,141057,4943,141057,141057,146028,139198,6830,139198
9510,21552,21050,20874,176,20874,20874,21057,20707,350,20707
9511,33932,2616,2816,-200,2616,2616,2614,2646,-32,2646
9512,179711,147976,138888,9088,138888,138888,147995,134151,13844,134151
9513,237593,237053,229665,7388,229665,229665,237039,227639,9400,227639
9514,26343,26673,26342,331,26342,26342,26682,26069,613,26069
9515,35971,38708,35914,2794,35914,35914,38714,35751,2963,35751
9516,2927,2557,2807,-250,2557,2557,2562,2614,-52,2614
9517,10111,9196,9144,52,9144,9144,9189,8847,342,8847
9518,2965,2927,3127,-200,2927,2927,2928,2967,-39,2965
9519,62811,64400,63855,545,63855,62811,64403,62803,1600,62803
9520,11932,668,940,-272,668,668,668,725,-57,725
9521,44996,44048,43606,442,43606,43606,44040,43247,793,43247
9522,23444,22387,21140,1247,21140,21140,22386,21036,1350,21036
9523,1137,497,734,-237,497,497,497,547,-50,547
9524,62424,42183,42254,-71,42183,42183,42198,41701,497,41701
9525,59586,39804,39271,533,39271,39271,39808,38738,1070,38738
9526,12171,11595,11139,456,11139,11139,11595,11009,586,11009
9527,7190,7208,7215,-7,7208,7190,7208,7001,207,7001
9528,46921,46086,45272,814,45272,45272,46103,43738,2365,43738
9529,13572,12755,12519,236,12519,12519,12757,12410,347,12410
9530,39174,39162,38431,731,38431,38431,39174,36985,2189,36985
9531,8171,7578,7863,-285,7578,7578,7575,7613,-38,7613
9532,1358,1358,1586,-228,1358,1358,1358,1413,-55,1358
9533,270300,281782,270710,11072,270710,270300,281870,269678,12192,269678
9534,55400,57003,55400,1603,55400,55400,57038,55255,1783,55255
9535,16294,15339,15352,-13,15339,15339,15332,15071,261,15071
9536,76613,77751,77754,-3,77751,76613,77787,77115,672,76613
9537,447171,365970,356634,9336,356634,356634,365830,351803,14027,351803
9538,32127,31004,29946,1058,29946,29946,31002,29891,1111,29891
9539,3180,3136,3348,-212,3136,3136,3137,3179,-42,3179
9540,4892,4431,4534,-103,4431,4431,4427,4445,-18,4445
9541,4665,4665,4756,-91,4665,4665,4662,4674,-12,4665
9542,133095,129617,123284,6333,123284,123284,129673,121737,7936,121737
9543,16301,14383,14197,186,14197,14197,14386,14130,256,14130
9544,506574,523477,496057,27420,496057,496057,523645,476318,47327,476318
9545,128390,126068,119262,6806,119262,119262,126112,118884,7228,118884
9546,48169,20182,19729,453,19729,19729,20169,19466,703,19466
9547,126657,126462,119500,6962,119500,119500,126429,118888,7541,118888
9548,4511,3895,3913,-18,3895,3895,3896,3774,122,3774
9549,18353,18360,19235,-875,18360,18353,18362,18332,30,18332
9550,62410,64654,64103,551,64103,62410,64684,62588,2096,62410
9551,63008,62984,63266,-282,62984,62984,63026,62679,347,62679
9552,42686,31026,29925,1101,29925,29925,31052,29516,1536,29516
9553,10438,8576,8741,-165,8576,8576,8579,8532,47,8532
9554,174032,145287,138119,7168,138119,138119,145287,136425,8862,136425
9555,28480,29181,28949,232,28949,28480,29186,28447,739,28447
9556,210170,204792,206647,-1855,204792,204792,204838,202300,2538,202300
9557,103413,102031,101711,320,101711,101711,102060,98338,3722,98338
9558,180168,195009,182029,12980,182029,180168,194997,180168,14829,180168
9559,22071,21467,21063,404,21063,21063,21476,20829,647,20829
9560,298951,296479,282134,14345,282134,282134,296666,281810,14856,281810
9561,144090,135293,129268,6025,129268,129268,135361,127226,8135,127226
9562,168044,145526,141023,4503,141023,141023,145547,139471,6076,139471
9563,52574,54481,52690,1791,52690,52574,54483,52586,1897,52574
9564,34775,25393,23828,1565,23828,23828,25414,22435,2979,22435
9565,46472,46882,46721,161,46721,46472,46891,46439,452,46439
9566,24398,23835,23649,186,23649,23649,23844,23286,558,23286
9567,160419,160316,159783,533,159783,159783,160396,156577,3819,156577
9568,36119,38425,37462,963,37462,36119,38425,36129,2296,36119
9569,342045,363541,341985,21556,341985,341985,363498,339275,24223,339275
9570,44834,42680,41061,1619,41061,41061,42703,41005,1698,41005
9571,2729,2522,2729,-207,2522,2522,2524,2539,-15,2539
9572,9446,8892,8741,151,8741,8741,8892,8573,319,8573
9573,17216,14690,14393,297,14393,14393,14694,14126,568,14126
9574,5555,5335,5554,-219,5335,5335,5330,5235,95,5235
9575,864378,840775,800168,40607,800168,800168,841193,783662,57531,783662
9576,31397,13878,13853,25,13853,13853,13878,13616,262,13616
9577,17141,16209,15717,492,15717,15717,16208,15180,1028,15180
9578,6814,3204,3475,-271,3204,3204,3205,3205,0,3205
9579,21007,21165,20999,166,20999,20999,21173,20095,1078,20095
9580,27923,26436,26619,-183,26436,26436,26449,26268,181,26268
9581,97249,93664,92036,1628,92036,92036,93701,91620,2081,91620
9582,127927,127915,122244,5671,122244,122244,127927,121337,6590,121337
9583,730025,730054,703875,26179,703875,703875,730025,698105,31920,698105
9584,11229,10679,10757,-78,10679,10679,10675,10538,137,10538
9585,16062,15651,15239,412,15239,15239,15648,15109,539,15109
9586,127193,127548,130020,-2472,127548,127193,127572,127185,387,127185
9587,2050,2050,2241,-191,2050,2050,2050,2086,-36,2050
9588,23542,22702,21789,913,21789,21789,22706,21620,1086,21620
9589,767,378,618,-240,378,378,378,425,-47,425
9590,4680,3885,4091,-206,3885,3885,3889,3628,261,3628
9591,25654,19702,19265,437,19265,19265,19700,17270,2430,17270
9592,173066,180490,173039,7451,173039,173039,180482,172806,7676,172806
9593,324220,323810,324148,-338,323810,323810,323822,315995,7827,315995
9594,588194,612243,581339,30904,581339,581339,612166,576805,35361,576805
9595,1514,1517,1745,-228,1517,1514,1514,1585,-71,1514
9596,41585,39671,38568,1103,38568,38568,39681,38344,1337,38344
9597,9192,9112,9131,-19,9112,9112,9115,8757,358,8757
9598,39777,41838,39716,2122,39716,39716,41831,38775,3056,38775
9599,202505,165612,161109,4503,161109,161109,165638,152789,12849,152789
9600,6868,6867,7005,-138,6867,6867,6868,6824,44,6824
9601,35388,35300,35150,150,35150,35150,35296,34343,953,34343
9602,5243,5093,5242,-149,5093,5093,5096,5070,26,5070
9603,73236,76584,73205,3379,73205,73205,76610,72196,4414,72196
9604,23829,25006,23869,1137,23869,23829,25011,23207,1804,23207
9605,393946,389869,377735,12134,377735,377735,390003,377263,12740,377263
9606,93282,95212,96413,-1201,95212,93282,95223,93274,1949,93274
9607,33229,33231,31420,1811,31420,31420,33229,30993,2236,30993
9608,326114,315241,294926,20315,294926,294926,315411,286789,28622,286789
9609,7203,6437,6514,-77,6437,6437,6437,6446,-9,6446
9610,27562,27512,26806,706,26806,26806,27520,26798,722,26798
9611,6505,6502,6637,-135,6502,6502,6505,6459,46,6459
9612,11137,9851,10295,-444,9851,9851,9853,7833,2020,7833
9613,2691,1849,2110,-261,1849,1849,1850,1903,-53,1903
9614,187370,187243,183015,4228,183015,183015,187196,181011,6185,181011
9615,31557,24081,23192,889,23192,23192,24075,23102,973,23102
9616,206478,210929,206413,4516,206413,206413,211013,205726,5287,205726
9617,435661,446498,432538,13960,432538,432538,446585,426476,20109,426476
9618,43372,42348,40546,1802,40546,40546,42371,40286,2085,40286
9619,5156,5345,5317,28,5317,5156,5346,5138,208,5138
9620,24803,24168,23770,398,23770,23770,24169,23605,564,23605
9621,108877,93439,88759,4680,88759,88759,93434,88126,5308,88126
9622,8080,8083,8473,-390,8083,8080,8080,7619,461,7619
9623,251981,268029,256270,11759,256270,251981,268274,251981,16293,251981
9624,5069,4877,5011,-134,4877,4877,4875,4706,169,4706
9625,9416,8865,8736,129,8736,8736,8869,8613,256,8613
9626,286924,239843,234274,5569,234274,234274,240054,230473,9581,230473
9627,33805,22874,22044,830,22044,22044,22877,18443,4434,18443
9628,18886,19922,18885,1037,18885,18885,19916,18617,1299,18617
9629,87430,82399,76476,5923,76476,76476,82443,76208,6235,76208
9630,44191,41770,39637,2133,39637,39637,41787,38822,2965,38822
9631,40058,40027,40075,-48,40027,40027,40035,39163,872,39163
9632,129259,99761,98721,1040,98721,98721,99788,96905,2883,96905
9633,2969,2132,2338,-206,2132,2132,2130,2142,-12,2142
9634,39512,16682,16324,358,16324,16324,16689,16004,685,16004
9635,54084,56210,54931,1279,54931,54084,56242,54084,2158,54084
9636,49175,38893,37838,1055,37838,37838,38889,37551,1338,37551
9637,38146,41242,43315,-2073,41242,38146,41257,39379,1878,38146
9638,2290034,2025864,1933486,92378,1933486,1933486,2026833,1923007,103826,1923007
9639,80387,75291,74367,924,74367,74367,75284,71780,3504,71780
9640,197141,172996,161789,11207,161789,161789,172966,157472,15494,157472
9641,23001,22156,22560,-404,22156,22156,22158,21888,270,21888
9642,187114,200252,187107,13145,187107,187107,200278,179765,20513,179765
9643,751432,730356,725905,4451,725905,725905,729839,707191,22648,707191
9644,532236,554762,532143,22619,532143,532143,555244,527137,28107,527137
9645,436,436,693,-257,436,436,436,490,-54,436
9646,25526,25871,26115,-244,25871,25526,25876,25493,383,25493
9647,23152,22578,22188,390,22188,22188,22598,21894,704,21894
9648,32315,33382,32306,1076,32306,32306,33385,32225,1160,32225
9649,19684,19684,19101,583,19101,19101,19684,18936,748,18936
9650,80503,56303,55579,724,55579,55579,56385,55311,1074,55311
9651,72440,69128,69290,-162,69128,69128,69166,67983,1183,67983
9652,4683,4149,4308,-159,4149,4149,4150,4099,51,4099
9653,50909,40574,40329,245,40329,40329,40599,37526,3073,37526
9654,38886,39833,38877,956,38877,38877,39845,38650,1195,38650
9655,686577,686868,657970,28898,657970,657970,686577,653153,33424,653153
9656,23335,23458,22714,744,22714,22714,23453,22713,740,22713
9657,5913,5910,6329,-419,5910,5910,5913,5972,-59,5913
9658,14698,13788,13805,-17,13788,13788,13790,13327,463,13327
9659,51251,50307,47704,2603,47704,47704,50285,47529,2756,47529
9660,62632,61126,59011,2115,59011,59011,61158,58910,2248,58910
9661,446208,456883,449229,7654,449229,446208,456843,446200,10643,446200
9662,160630,165197,162184,3013,162184,160630,165184,160657,4527,160630
9663,45002,44664,45003,-339,44664,44664,44677,43778,899,43778
9664,5316,4809,4814,-5,4809,4809,4806,4675,131,4675
9665,42254,43442,42187,1255,42187,42187,43432,42068,1364,42068
9666,5930,5904,5873,31,5873,5873,5906,5647,259,5647
9667,5281,4944,4972,-28,4944,4944,4941,4862,79,4862
9668,44084,42135,41558,577,41558,41558,42137,40717,1420,40717
9669,45109,41903,39946,1957,39946,39946,41921,39498,2423,39498
9670,17879,17323,16793,530,16793,16793,17319,16618,701,16618
9671,203622,192046,182900,9146,182900,182900,192070,180463,11607,180463
9672,7498,6997,7287,-290,6997,6997,6997,6961,36,6961
9673,208714,216751,211947,4804,211947,208714,216810,208706,8104,208706
9674,17698,17224,16395,829,16395,16395,17221,16226,995,16226
9675,85679,78449,75462,2987,75462,75462,78454,74870,3584,74870
9676,44339,38091,35998,2093,35998,35998,38090,35747,2343,35747
9677,8599,9186,8766,420,8766,8599,9192,8599,593,8599
9678,2624,1935,2176,-241,1935,1935,1936,2002,-66,2002
9679,82140,72431,70779,1652,70779,70779,72460,70238,2222,70238
9680,34299,34420,34299,121,34299,34299,34430,33511,919,33511
9681,435661,402592,386457,16135,386457,386457,402641,384621,18020,384621
9682,323945,323987,321956,2031,321956,321956,323945,313923,10022,313923
9683,5427,5430,5479,-49,5430,5427,5427,5345,82,5345
9684,47569,49403,47573,1830,47573,47569,49411,47421,1990,47421
9685,125280,114303,109760,4543,109760,109760,114297,108818,5479,108818
9686,7241,7184,7239,-55,7184,7184,7188,7100,88,7100
9687,14636,13801,13656,145,13656,13656,13813,13330,483,13330
9688,189618,196148,192930,3218,192930,189618,196146,189638,6508,189618
9689,21971,7829,7441,388,7441,7441,7833,6734,1099,6734
9690,101273,101292,100155,1137,100155,100155,101273,99217,2056,99217
9691,55917,54996,52989,2007,52989,52989,54987,52814,2173,52814
9692,1012354,964261,930303,33958,930303,930303,964278,924148,40130,924148
9693,92923,90106,88812,1294,88812,88812,90141,88240,1901,88240
9694,116704,131994,128088,3906,128088,116704,131986,116626,15360,116626
9695,8576,8755,8936,-181,8755,8576,8753,8647,106,8576
9696,5478,5027,5202,-175,5027,5027,5025,5017,8,5017
9697,5312,4661,4755,-94,4661,4661,4661,4615,46,4615
9698,4321,3929,3985,-56,3929,3929,3927,3812,115,3812
9699,27971,27131,26774,357,26774,26774,27126,26218,908,26218
9700,641910,669730,644987,24743,644987,641910,669488,641910,27578,641910
9701,444174,428108,432610,-4502,428108,428108,428097,417958,10139,417958
9702,11267,10503,10401,102,10401,10401,10508,10126,382,10126
9703,1965,1560,1793,-233,1560,1560,1560,1609,-49,1609
9704,33009,29798,29198,600,29198,29198,29794,28864,930,28864
9705,206943,168927,160669,8258,160669,160669,168927,158535,10392,158535
9706,327774,327651,304511,23140,304511,304511,327712,301827,25885,301827
9707,2261,1585,1824,-239,1585,1585,1585,1639,-54,1639
9708,18193,16384,16043,341,16043,16043,16382,15999,383,15999
9709,11412,11416,11201,215,11201,11201,11412,11105,307,11105
9710,9175,8126,8019,107,8019,8019,8123,7928,195,7928
9711,173034,142328,135664,6664,135664,135664,142306,135266,7040,135266
9712,63288,63146,60291,2855,60291,60291,63146,59986,3160,59986
9713,85499,84791,85998,-1207,84791,84791,84811,84622,189,84622
9714,18427,17868,17580,288,17580,17580,17873,17425,448,17425
9715,240449,210037,205706,4331,205706,205706,210148,201794,8354,201794
9716,22587,23225,22581,644,22581,22581,23202,22414,788,22414
9717,5673,5499,5611,-112,5499,5499,5500,5318,182,5318
9718,90714,84488,81125,3363,81125,81125,84497,80722,3775,80722
9719,5582,5112,5088,24,5088,5088,5115,4859,256,4859
9720,44861,42658,40177,2481,40177,40177,42646,40094,2552,40094
9721,16877,16828,16877,-49,16828,16828,16823,16495,328,16495
9722,318310,318248,306103,12145,306103,306103,318363,305380,12983,305380
9723,386490,385448,382481,2967,382481,382481,385525,375632,9893,375632
9724,48231,48242,45924,2318,45924,45924,48223,45435,2788,45435
9725,25175,25643,25156,487,25156,25156,25651,24743,908,24743
9726,63030,64337,63881,456,63881,63030,64349,63030,1319,63030
9727,10936,10486,10592,-106,10486,10486,10492,10361,131,10361
9728,1036147,1042557,989372,53185,989372,989372,1042914,979619,63295,979619
9729,227705,217223,207807,9416,207807,207807,217253,206021,11232,206021
9730,19554,19116,18569,547,18569,18569,19122,18364,758,18364
9731,45915,43797,41285,2512,41285,41285,43781,41176,2605,41176
9732,12508,11907,11592,315,11592,11592,11912,11413,499,11413
9733,22096,21652,20818,834,20818,20818,21656,20636,1020,20636
9734,179502,178628,171913,6715,171913,171913,178628,170677,7951,170677
9735,6245,5897,5923,-26,5897,5897,5892,5786,106,5786
9736,6022,5982,5996,-14,5982,5982,5986,5858,128,5858
9737,24305,23381,22319,1062,22319,22319,23383,22001,1382,22001
9738,74974,74049,72762,1287,72762,72762,74035,71816,2219,71816
9739,8098,8094,8211,-117,8094,8094,8098,7885,213,7885
9740,144706,140636,136184,4452,136184,136184,140606,133124,7482,133124
9741,12635,12073,11930,143,11930,11930,12070,11814,256,11814
9742,14062,14065,13935,130,13935,13935,14062,13892,170,13892
9743,38112,38709,37395,1314,37395,37395,38712,37319,1393,37319
9744,10275,10560,10493,67,10493,10275,10561,10280,281,10275
9745,3505,2964,3108,-144,2964,2964,2965,2927,38,2927
9746,20637,20013,19588,425,19588,19588,20023,19322,701,19322
9747,87209,87078,83119,3959,83119,83119,87151,82973,4178,82973
9748,153373,147396,148094,-698,147396,147396,147411,145571,1840,145571
9749,9533,2890,3142,-252,2890,2890,2889,2951,-62,2951
9750,222789,221797,220672,1125,220672,220672,221775,216210,5565,216210
9751,197848,200395,198095,2300,198095,197848,200417,197960,2457,197848
9752,2880,2880,3029,-149,2880,2880,2880,2915,-35,2880
9753,462184,433447,421968,11479,421968,421968,433596,419536,14060,419536
9754,8153,7236,7098,138,7098,7098,7242,6877,365,6877
9755,98484,82321,75792,6529,75792,75792,82374,73381,8993,73381
9756,85590,84685,81684,3001,81684,81684,84695,80768,3927,80768
9757,35823,15631,15907,-276,15631,15631,15629,15552,77,15552
9758,9797,6629,6688,-59,6629,6629,6635,6566,69,6566
9759,74355,79039,74345,4694,74345,74345,79061,72725,6336,72725
9760,38649,40139,38901,1238,38901,38649,40145,38597,1548,38597
9761,1264,877,1125,-248,877,877,877,927,-50,927
9762,5636,5636,5796,-160,5636,5636,5643,5561,82,5561
9763,94733,97799,97601,198,97601,94733,97812,94733,3079,94733
9764,9894,9891,9805,86,9805,9805,9894,9686,208,9686
9765,16939,16936,16638,298,16638,16638,16939,16510,429,16510
9766,260009,258896,252881,6015,252881,252881,258949,250227,8722,250227
9767,207696,188449,171675,16774,171675,171675,188510,158741,29769,158741
9768,2970,2959,3195,-236,2959,2959,2959,2937,22,2937
9769,16317,16325,16370,-45,16325,16317,16318,15695,623,15695
9770,9811,8864,8770,94,8770,8770,8867,8254,613,8254
9771,68194,68202,66009,2193,66009,66009,68194,65335,2859,65335
9772,5671,5238,5188,50,5188,5188,5238,5078,160,5078
9773,13803,2340,2588,-248,2340,2340,2342,2376,-34,2376
9774,91014,90088,90224,-136,90088,90088,90120,88623,1497,88623
9775,14565,13602,12890,712,12890,12890,13596,12518,1078,12518
9776,365197,365453,346639,18814,346639,346639,365197,343620,21577,343620
9777,1175907,1197878,1183824,14054,1183824,1175907,1197691,1177793,19898,1175907
9778,54519,35840,34351,1489,34351,34351,35850,34170,1680,34170
9779,779281,822598,779281,43317,779281,779281,822165,775320,46845,775320
9780,3294,3388,3483,-95,3388,3294,3389,3257,132,3257
9781,124853,123898,118794,5104,118794,118794,123917,103258,20659,103258
9782,21947,20284,19220,1064,19220,19220,20288,18499,1789,18499
9783,120774,125931,127486,-1555,125931,120774,125949,120766,5183,120766
9784,49355,49390,47343,2047,47343,47343,49355,47204,2151,47204
9785,48403,47599,46770,829,46770,46770,47613,46481,1132,46481
9786,14959,10788,10824,-36,10788,10788,10799,10381,418,10381
9787,126055,121719,117847,3872,117847,117847,121718,117419,4299,117419
9788,59587,58915,57179,1736,57179,57179,58915,56825,2090,56825
9789,21128,20366,19619,747,19619,19619,20370,19527,843,19527
9790,18881,18008,17383,625,17383,17383,18019,17154,865,17154
9791,11560,11494,11940,-446,11494,11494,11499,11474,25,11474
9792,28476,27880,27695,185,27695,27695,27883,27407,476,27407
9793,40923,40917,39582,1335,39582,39582,40923,39260,1663,39260
9794,502343,485986,470229,15757,470229,470229,485968,466700,19268,466700
9795,16190,16177,16321,-144,16177,16177,16172,16006,166,16006
9796,1303,923,1165,-242,923,923,923,944,-21,944
9797,13970,14022,13902,120,13902,13902,14015,13742,273,13742
9798,2375,2171,2375,-204,2171,2171,2170,2223,-53,2223
9799,3833,3834,3968,-134,3834,3833,3833,3747,86,3747
9800,165067,175797,180265,-4468,175797,165067,175837,165059,10778,165059
9801,18959,17002,16312,690,16312,16312,17000,16212,788,16212
9802,21262,20816,20049,767,20049,20049,20817,19914,903,19914
9803,357232,371158,356979,14179,356979,356979,371283,355853,15430,355853
9804,50497,50956,51622,-666,50956,50497,51000,50449,551,50449
9805,20978,21415,22172,-757,21415,20978,21413,20970,443,20970
9806,12977,12973,12558,415,12558,12558,12977,12028,949,12028
9807,40709,40733,39720,1013,39720,39720,40709,39556,1153,39556
9808,6261,5669,5748,-79,5669,5669,5668,5581,87,5581
9809,12050,12049,12267,-218,12049,12049,12050,12016,34,12016
9810,71862,68544,67444,1100,67444,67444,68587,66739,1848,66739
9811,5424,4752,4909,-157,4752,4752,4746,4592,154,4592
9812,141895,137250,134773,2477,134773,134773,137218,133929,3289,133929
9813,345531,360470,345227,15243,345227,345227,360484,344909,15575,344909
9814,130470,120710,114667,6043,114667,114667,120718,113981,6737,113981
9815,24943,24415,24286,129,24286,24286,24428,24067,361,24067
9816,3150,2739,2909,-170,2739,2739,2737,2759,-22,2759
9817,41388,43218,41684,1534,41684,41388,43217,41388,1829,41388
9818,94360,90898,88675,2223,88675,88675,90963,88040,2923,88040
9819,1752,1477,1691,-214,1477,1477,1477,1535,-58,1535
9820,8539,8474,8604,-130,8474,8474,8478,8365,113,8365
9821,6405,5765,5793,-28,5765,5765,5767,5531,236,5531
9822,245324,255709,245261,10448,245261,245261,255579,244141,11438,244141
9823,44491,44472,44276,196,44276,44276,44491,43631,860,43631
9824,68340,66931,65382,1549,65382,65382,66921,65268,1653,65268
9825,5181,5375,5582,-207,5375,5181,5371,5199,172,5181
9826,31972,33235,31972,1263,31972,31972,33236,31423,1813,31423
9827,193224,195692,187962,7730,187962,187962,195796,184320,11476,184320
9828,6583,6584,6519,65,6519,6519,6583,6322,261,6322
9829,118452,116956,112811,4145,112811,112811,116958,112141,4817,112141
9830,80811,71525,70819,706,70819,70819,71553,70508,1045,70508
9831,68302,59930,58409,1521,58409,58409,59928,58260,1668,58260
9832,13475,13704,13475,229,13475,13475,13714,13293,421,13293
9833,7481,7659,7415,244,7415,7415,7663,6883,780,6883
9834,12250,12255,12571,-316,12255,12250,12250,12187,63,12187
9835,43257,43052,41054,1998,41054,41054,43059,40012,3047,40012
9836,10100,10506,10100,406,10100,10100,10505,9953,552,9953
9837,1085,1102,1343,-241,1102,1085,1103,1155,-52,1085
9838,173517,147391,142876,4515,142876,142876,147388,142247,5141,142247
9839,6997,6719,6936,-217,6719,6719,6722,6647,75,6647
9840,172478,164874,158980,5894,158980,158980,164865,157422,7443,157422
9841,60054,54518,52506,2012,52506,52506,54521,51946,2575,51946
9842,266221,238496,242866,-4370,238496,238496,238579,233329,5250,233329
9843,166483,164300,155490,8810,155490,155490,164285,154702,9583,154702
9844,7657,7756,7967,-211,7756,7657,7759,7612,147,7612
9845,11836,11446,11450,-4,11446,11446,11454,11258,196,11258
9846,32155,14518,14449,69,14449,14449,14521,14189,332,14189
9847,22276,20800,19515,1285,19515,19515,20798,18790,2008,18790
9848,10992,10132,9790,342,9790,9790,10134,9591,543,9591
9849,103483,103423,102912,511,102912,102912,103464,101645,1819,101645
9850,42868,42848,41413,1435,41413,41413,42868,41168,1700,41168
9851,141463,141328,137106,4222,137106,137106,141463,133865,7598,133865
9852,94780,90661,86468,4193,86468,86468,90677,84944,5733,84944
9853,76486,74216,70051,4165,70051,70051,74215,69839,4376,69839
9854,123440,119870,120537,-667,119870,119870,119891,118933,958,118933
9855,8217,7708,7632,76,7632,7632,7710,7481,229,7481
9856,50981,50977,49259,1718,49259,49259,50981,49094,1887,49094
9857,3343,3100,3344,-244,3100,3100,3100,3144,-44,3144
9858,178528,143554,140263,3291,140263,140263,143546,139680,3866,139680
9859,25663,25641,25133,508,25133,25133,25663,24727,936,24727
9860,33327,35023,33253,1770,33253,33253,35020,33107,1913,33107
9861,120423,117060,116027,1033,116027,116027,117081,114699,2382,114699
9862,73342,74571,73328,1243,73328,73328,74547,72840,1707,72840
9863,81786,84602,81779,2823,81779,81779,84581,81224,3357,81224
9864,93631,96183,93612,2571,93612,93612,96204,92986,3218,92986
9865,33656,33505,32981,524,32981,32981,33496,32825,671,32825
9866,93030,92083,97388,-5305,92083,92083,92095,90083,2012,90083
9867,13803,12897,12643,254,12643,12643,12905,12469,436,12469
9868,30974,33143,31678,1465,31678,30974,33151,30983,2168,30974
9869,356196,375032,353641,21391,353641,353641,375017,351662,23355,351662
9870,467994,467169,440324,26845,440324,440324,467440,438567,28873,438567
9871,256859,257504,249600,7904,249600,249600,257545,247076,10469,247076
9872,50085,48799,49816,-1017,48799,48799,48827,48540,287,48540
9873,7296,6851,6982,-131,6851,6851,6852,6819,33,6819
9874,54746,54735,52165,2570,52165,52165,54746,49024,5722,49024
9875,59795,59253,56609,2644,56609,56609,59230,56476,2754,56476
9876,151519,130009,125897,4112,125897,125897,130031,122364,7667,122364
9877,9797,9313,9327,-14,9313,9313,9321,9125,196,9125
9878,136509,135605,137154,-1549,135605,135605,135607,130123,5484,130123
9879,157450,149485,144102,5383,144102,144102,149492,142397,7095,142397
9880,64178,49223,48297,926,48297,48297,49199,46614,2585,46614
9881,182648,182649,172954,9695,172954,172954,182583,172027,10556,172027
9882,43724,47727,43663,4064,43663,43663,47748,43502,4246,43502
9883,52418,51195,50972,223,50972,50972,51219,50463,756,50463
9884,56456,33709,32542,1167,32542,32542,33708,32365,1343,32365
9885,16295,15618,15386,232,15386,15386,15621,15140,481,15140
9886,555946,584357,555140,29217,555140,555140,584278,553924,30354,553924
9887,13871,13406,13432,-26,13406,13406,13406,13237,169,13237
9888,41707,40495,39526,969,39526,39526,40505,39464,1041,39464
9889,439177,435652,423626,12026,423626,423626,435658,418500,17158,418500
9890,17107,17958,17101,857,17101,17101,17966,17007,959,17007
9891,34702,34661,32998,1663,32998,32998,34667,32528,2139,32528
9892,2686,2309,2500,-191,2309,2309,2311,2348,-37,2348
9893,4122,3796,3869,-73,3796,3796,3795,3743,52,3743
9894,24423,23462,23279,183,23279,23279,23465,22971,494,22971
9895,259767,259689,253563,6126,253563,253563,259761,252317,7444,252317
9896,134349,133449,128497,4952,128497,128497,133431,125889,7542,125889
9897,295147,246488,239658,6830,239658,239658,246632,232506,14126,232506
9898,10179,9620,9654,-34,9620,9620,9621,9472,149,9472
9899,13916,13358,13068,290,13068,13068,13362,12885,477,12885
9900,28248,29580,28242,1338,28242,28242,29585,28190,1395,28190
9901,28209,28591,28174,417,28174,28174,28588,27990,598,27990
9902,188706,212002,195283,16719,195283,188706,212144,188084,24060,188084
9903,101395,101357,95397,5960,95397,95397,101395,94721,6674,94721
9904,5339,4932,5110,-178,4932,4932,4931,4902,29,4902
9905,1107,807,1046,-239,807,807,806,858,-52,858
9906,21939,22483,21880,603,21880,21880,22486,21417,1069,21417
9907,42369,38625,37051,1574,37051,37051,38617,36509,2108,36509
9908,3387,3387,3497,-110,3387,3387,3387,3340,47,3340
9909,10506,9362,9001,361,9001,9001,9359,8693,666,8693
9910,22723,20969,20269,700,20269,20269,20957,19744,1213,19744
9911,99595,71011,71189,-178,71011,71011,71068,69913,1155,69913
9912,39321,35098,34181,917,34181,34181,35095,33878,1217,33878
9913,16789,3212,3316,-104,3212,3212,3213,2969,244,2969
9914,61032,63761,61028,2733,61028,61028,63766,60718,3048,60718
9915,28759,27610,26534,1076,26534,26534,27605,25731,1874,25731
9916,1287,1053,1309,-256,1053,1053,1052,1087,-35,1087
9917,7396069,6907989,6650493,257496,6650493,6650493,6906868,6610294,296574,6610294
9918,46689,46672,44474,2198,44474,44474,46689,44289,2400,44289
9919,93631,96699,90453,6246,90453,90453,96730,86997,9733,86997
9920,15024,14432,14368,64,14368,14368,14434,14192,242,14192
9921,1342226,1406302,1342226,64076,1342226,1342226,1406708,1328101,78607,1328101
9922,38360,38291,37903,388,37903,37903,38308,37738,570,37738
9923,64417,64111,64417,-306,64111,64111,64152,63588,564,63588
9924,202560,141986,133955,8031,133955,133955,141986,128724,13262,128724
9925,3755,3446,3693,-247,3446,3446,3446,3382,64,3382
9926,44584,45638,44749,889,44749,44584,45634,44584,1050,44584
9927,161964,158762,153363,5399,153363,153363,158802,150798,8004,150798
9928,56143,57605,55365,2240,55365,55365,57621,55078,2543,55078
9929,30435,29197,29269,-72,29197,29197,29219,28761,458,28761
9930,6565,6139,6097,42,6097,6097,6143,5997,146,5997
9931,15566,15505,15308,197,15308,15308,15514,15148,366,15148
9932,3680,3340,3427,-87,3340,3340,3341,3306,35,3306
9933,19474,19350,19109,241,19109,19109,19361,18852,509,18852
9934,28244,22545,21728,817,21728,21728,22553,21438,1115,21438
9935,20962,21704,20894,810,20894,20894,21704,20753,951,20753
9936,171085,123270,117934,5336,117934,117934,123256,117014,6242,117014
9937,37246,36668,34598,2070,34598,34598,36692,34545,2147,34545
9938,18609,17947,17733,214,17733,17733,17960,17484,476,17484
9939,37959,27158,25534,1624,25534,25534,27174,24131,3043,24131
9940,23369,23363,21795,1568,21795,21795,23369,21049,2320,21049
9941,129897,143676,147530,-3854,143676,129897,143676,131134,12542,129897
9942,13029,12472,12525,-53,12472,12472,12475,12215,260,12215
9943,19051,19065,18636,429,18636,18636,19070,18526,544,18526
9944,167184,145535,139245,6290,139245,139245,145506,138318,7188,138318
9945,3182,2441,2630,-189,2441,2441,2442,2495,-53,2495
9946,10892,9602,9106,496,9106,9106,9594,8593,1001,8593
9947,396355,382351,360753,21598,360753,360753,382390,357599,24791,357599
9948,12580,12583,12115,468,12115,12115,12580,12007,573,12007
9949,27908,26937,26575,362,26575,26575,26931,26347,584,26347
9950,96111,95617,92561,3056,92561,92561,95637,91958,3679,91958
9951,15031,14518,14556,-38,14518,14518,14517,14249,268,14249
9952,84812,83493,80724,2769,80724,80724,83486,79910,3576,79910
9953,53228,33960,33033,927,33033,33033,33962,32780,1182,32780
9954,5699,5092,5115,-23,5092,5092,5091,4872,219,4872
9955,12743,12660,12743,-83,12660,12660,12660,12524,136,12524
9956,71683,57708,57352,356,57352,57352,57696,57035,661,57035
9957,60963,60599,58681,1918,58681,58681,60597,58402,2195,58402
9958,20361,19808,19412,396,19412,19412,19807,19050,757,19050
9959,11381,10904,10794,110,10794,10794,10907,10759,148,10759
9960,74280,46618,44877,1741,44877,44877,46633,44847,1786,44847
9961,13051,12415,12119,296,12119,12119,12423,11879,544,11879
9962,28669,28656,29383,-727,28656,28656,28669,27326,1343,27326
9963,43752,43666,43972,-306,43666,43666,43691,43250,441,43250
9964,114928,112092,109168,2924,109168,109168,112119,107479,4640,107479
9965,26955,27020,28277,-1257,27020,26955,27021,27206,-185,26955
9966,64341,56071,54099,1972,54099,54099,56088,51422,4666,51422
9967,15525,14179,14034,145,14034,14034,14173,14017,156,14017
9968,125407,130704,129618,1086,129618,125407,130727,126452,4275,125407
9969,46475,45277,44881,396,44881,44881,45293,44253,1040,44253
9970,1672,1011,1278,-267,1011,1011,1011,1050,-39,1050
9971,214467,204822,190142,14680,190142,190142,204825,186417,18408,186417
9972,6048,6050,6007,43,6007,6007,6048,5694,354,5694
9973,127476,127408,124877,2531,124877,124877,127407,124028,3379,124028
9974,171235,167925,164415,3510,164415,164415,168006,162656,5350,162656
9975,49391,49783,51055,-1272,49783,49391,49790,49625,165,49391
9976,41159,36271,35531,740,35531,35531,36290,34267,2023,34267
9977,313305,321665,303687,17978,303687,303687,321652,290724,30928,290724
9978,79061,78986,79156,-170,78986,78986,79011,77225,1786,77225
9979,12048,12078,12203,-125,12078,12048,12075,12050,25,12048
9980,692291,691184,658374,32810,658374,658374,691382,655581,35801,655581
9981,157284,157215,157361,-146,157215,157215,157263,150426,6837,150426
9982,3982,4032,4327,-295,4032,3982,4033,3982,51,3982
9983,31500,30132,30041,91,30041,30041,30156,29477,679,29477
9984,44265,44241,44304,-63,44241,44241,44265,43639,626,43639
9985,19280,18186,17615,571,17615,17615,18191,17349,842,17349
9986,62683,50653,49113,1540,49113,49113,50623,48752,1871,48752
9987,10139,9309,9089,220,9089,9089,9312,8766,546,8766
9988,110390,106989,101464,5525,101464,101464,106929,101305,5624,101305
9989,132574,131474,129921,1553,129921,129921,131543,128840,2703,128840
9990,5398,5276,5429,-153,5276,5276,5277,5268,9,5268
9991,16025,15325,14900,425,14900,14900,15327,14749,578,14749
9992,5318,5332,5521,-189,5332,5318,5334,5352,-18,5318
9993,94623,64232,62993,1239,62993,62993,64246,62524,1722,62524
9994,5920,5469,5624,-155,5469,5469,5469,5434,35,5434
9995,8336,8340,8452,-112,8340,8336,8344,8232,112,8232
9996,9214,9872,9147,725,9147,9147,9874,8437,1437,8437
9997,528506,499195,474690,24505,474690,474690,499351,473455,25896,473455
9998,36804,33609,32078,1531,32078,32078,33642,31359,2283,31359
9999,7536,6225,6313,-88,6225,6225,6224,6124,100,6124
10000,238026,205008,195693,9315,195693,195693,205094,192259,12835,192259
10001,5617,5444,5615,-171,5444,5444,5444,5373,71,5373
10002,334011,315762,308863,6899,308863,308863,315947,302841,13106,302841
10003,2710,2711,2872,-161,2711,2710,2710,2712,-2,2710
10004,205416,201054,196477,4577,196477,196477,201115,195037,6078,195037
10005,44327,31161,29603,1558,29603,29603,31165,29498,1667,29498
10006,10782,9120,8807,313,8807,8807,9117,8654,463,8654
10007,12563,13512,12863,649,12863,12563,13508,12563,945,12563
10008,69450,68166,65464,2702,65464,65464,68193,65305,2888,65305
10009,75749,63231,63699,-468,63231,63231,63223,61962,1261,61962
10010,98959,97962,92356,5606,92356,92356,98014,89155,8859,89155
10011,20075,19466,19088,378,19088,19088,19469,18946,523,18946
10012,478827,491707,480814,10893,480814,478827,491803,478205,13598,478205
10013,10490,9826,9544,282,9544,9544,9834,9387,447,9387
10014,1137802,1068649,1044068,24581,1044068,1044068,1068223,1038548,29675,1038548
10015,6001,5812,5895,-83,5812,5812,5811,5776,35,5776
10016,224449,102784,100677,2107,100677,100677,102801,99834,2967,99834
10017,54789,29690,28989,701,28989,28989,29693,28355,1338,28355
10018,17933,14764,14994,-230,14764,14764,14771,14715,56,14715
10019,52250,50751,49481,1270,49481,49481,50761,49088,1673,49088
10020,47134,47119,46109,1010,46109,46109,47134,45754,1380,45754
10021,5003,5003,5042,-39,5003,5003,5003,4915,88,4915
10022,19206,19201,19611,-410,19201,19201,19206,19138,68,19138
10023,21743,20750,20726,24,20726,20726,20759,20164,595,20164
10024,62705,64893,62624,2269,62624,62624,64895,61658,3237,61658
10025,2932,2529,2702,-173,2529,2529,2532,2548,-16,2548
10026,31674,34970,33249,1721,33249,31674,34956,31052,3904,31052
10027,29293,15125,14862,263,14862,14862,15127,13239,1888,13239
10028,33773,32793,31971,822,31971,31971,32805,31795,1010,31795
10029,9702,8856,8709,147,8709,8709,8855,8376,479,8376
10030,54699,56466,55004,1462,55004,54699,56451,54699,1752,54699
10031,27731,27940,27726,214,27726,27726,27959,27314,645,27314
10032,52429,52441,50976,1465,50976,50976,52429,50676,1753,50676
10033,19269,13009,12895,114,12895,12895,13016,12665,351,12665
10034,52304,51381,49893,1488,49893,49893,51357,48723,2634,48723
10035,40073,40063,39780,283,39780,39780,40073,38755,1318,38755
10036,43286,25468,24910,558,24910,24910,25472,24219,1253,24219
10037,304903,283902,264831,19071,264831,264831,284015,261010,23005,261010
10038,52672,28684,28593,91,28593,28593,28691,28043,648,28043
10039,79270,67129,61082,6047,61082,61082,67150,59194,7956,59194
10040,38251,38233,36298,1935,36298,36298,38228,35886,2342,35886
10041,52158,48846,46430,2416,46430,46430,48878,46226,2652,46226
10042,46680,19590,18766,824,18766,18766,19592,17839,1753,17839
10043,728289,658122,630307,27815,630307,630307,658147,618647,39500,618647
10044,32386,32379,31828,551,31828,31828,32386,31337,1049,31337
10045,116481,120080,116385,3695,116385,116385,120105,115859,4246,115859
10046,29015,29964,28938,1026,28938,28938,29960,28671,1289,28671
10047,79208,79017,75554,3463,75554,75554,79016,74688,4328,74688
10048,97402,97369,93283,4086,93283,93283,97402,92714,4688,92714
10049,61055,62644,61056,1588,61056,61055,62651,60164,2487,60164
10050,2035,1067,1299,-232,1067,1067,1067,1123,-56,1123
10051,103819,108176,102850,5326,102850,102850,108169,101444,6725,101444
10052,66214,65248,62497,2751,62497,62497,65291,60968,4323,60968
10053,8628,8147,8256,-109,8147,8147,8138,8085,53,8085
10054,10602,10070,9984,86,9984,9984,10076,9846,230,9846
10055,30527,9467,9583,-116,9467,9467,9469,9145,324,9145
10056,3273,3255,3475,-220,3255,3255,3255,3305,-50,3273
10057,66132,67830,66249,1581,66249,66132,67859,65510,2349,65510
10058,286554,303186,279404,23782,279404,279404,303211,274993,28218,274993
10059,55081,56526,55020,1506,55020,55020,56535,54544,1991,54544
10060,17171,17646,17099,547,17099,17099,17648,16765,883,16765
10061,9857,9418,9343,75,9343,9343,9422,9228,194,9228
10062,43909,43900,43618,282,43618,43618,43909,43050,859,43050
10063,750395,772303,750198,22105,750198,750198,772501,745506,26995,745506
10064,145430,139386,130732,8654,130732,130732,139344,129891,9453,129891
10065,699193,654263,621667,32596,621667,621667,654222,618917,35305,618917
10066,31708,30564,29468,1096,29468,29468,30558,28913,1645,28913
10067,217416,217462,198431,19031,198431,198431,217416,193099,24317,193099
10068,6916,6511,6556,-45,6511,6511,6511,6294,217,6294
10069,16907,14718,14684,34,14684,14684,14724,14571,153,14571
10070,7604,7571,7397,174,7397,7397,7568,7277,291,7277
10071,380393,380368,361880,18488,361880,361880,380393,360784,19609,360784
10072,15600,15537,15016,521,15016,15016,15539,14859,680,14859
10073,56892,54890,53643,1247,53643,53643,54903,53210,1693,53210
10074,125266,116785,114158,2627,114158,114158,116849,109000,7849,109000
10075,10145,9725,9590,135,9590,9590,9725,9470,255,9470
10076,25135,25678,25123,555,25123,25123,25685,25091,594,25091
10077,12331,12298,12055,243,12055,12055,12305,11837,468,11837
10078,73263,61523,61682,-159,61523,61523,61526,59833,1693,59833
10079,4876,4876,4949,-73,4876,4876,4878,4826,52,4826
10080,56295,55746,54859,887,54859,54859,55755,54322,1433,54322
10081,12914,12353,12191,162,12191,12191,12360,11876,484,11876
10082,160235,140264,135759,4505,135759,135759,140289,134641,5648,134641
10083,15385,14685,14658,27,14658,14658,14714,14078,636,14078
10084,2523,2032,2275,-243,2032,2032,2031,2065,-34,2065
10085,44610,20163,19322,841,19322,19322,20160,19182,978,19182
10086,2339,1441,1625,-184,1441,1441,1441,1475,-34,1475
10087,65168,53572,52443,1129,52443,52443,53549,51738,1811,51738
10088,44517,46295,46132,163,46132,44517,46300,44509,1791,44509
10089,628716,627850,607103,20747,607103,607103,627574,602743,24831,602743
10090,1541,1443,1682,-239,1443,1443,1442,1497,-55,1497
10091,4496739,129400,121002,8398,121002,121002,129380,116056,13324,116056
10092,11514,10674,10574,100,10574,10574,10671,10464,207,10464
10093,1814,1464,1630,-166,1464,1464,1465,1480,-15,1480
10094,7313,6796,7162,-366,6796,6796,6802,6906,-104,6906
10095,33824,32893,32233,660,32233,32233,32892,32013,879,32013
10096,1178,854,1118,-264,854,854,852,871,-19,871
10097,25223,22770,21027,1743,21027,21027,22769,19898,2871,19898
10098,27666,27662,27215,447,27215,27215,27666,26933,733,26933
10099,44009,25212,24152,1060,24152,24152,25232,22852,2380,22852
10100,78544,64041,62201,1840,62201,62201,64052,61864,2188,61864
10101,87275,84020,84377,-357,84020,84020,84043,83430,613,83430
10102,64356,66725,64808,1917,64808,64356,66748,64348,2400,64348
10103,82279,82281,79402,2879,79402,79402,82330,79006,3324,79006
10104,427013,381551,364192,17359,364192,364192,381695,358265,23430,358265
10105,538112,537091,511506,25585,511506,511506,537028,507323,29705,507323
10106,10372,9359,9621,-262,9359,9359,9362,9213,149,9213
10107,27306,27318,26319,999,26319,26319,27306,26164,1142,26164
10108,32301,32146,32768,-622,32146,32146,32159,31893,266,31893
10109,56835,55772,54946,826,54946,54946,55797,54205,1592,54205
10110,2587,1450,1723,-273,1450,1450,1451,1517,-66,1517
10111,22693,22121,22171,-50,22121,22121,22134,21833,301,21833
10112,29048,29042,28019,1023,28019,28019,29048,27945,1103,27945
10113,9232,9441,9227,214,9227,9227,9442,9123,319,9123
10114,56994,58462,58224,238,58224,56994,58472,56986,1486,56986
10115,2212,2213,2444,-231,2213,2212,2212,2277,-65,2212
10116,8580,8035,8220,-185,8035,8035,8038,8039,-1,8039
10117,29202,28271,28101,170,28101,28101,28279,27905,374,27905
10118,13611,12739,12640,99,12640,12640,12738,12282,456,12282
10119,142100,123523,120453,3070,120453,120453,123578,119895,3683,119895
10120,16970,14464,14753,-289,14464,14464,14472,14240,232,14240
10121,32873,32034,30390,1644,30390,30390,32048,30222,1826,30222
10122,26438,22502,21381,1121,21381,21381,22509,21338,1171,21338
10123,126804,126665,123281,3384,123281,123281,126756,123011,3745,123011
10124,180405,171829,160540,11289,160540,160540,171891,159969,11922,159969
10125,4199,1764,2002,-238,1764,1764,1766,1824,-58,1824
10126,14523,15861,14520,1341,14520,14520,15865,13664,2201,13664
10127,16459,15025,14993,32,14993,14993,15029,14505,524,14505
10128,1028,588,817,-229,588,588,586,634,-48,634
10129,13651,13074,13165,-91,13074,13074,13074,12939,135,12939
10130,88703,87713,82927,4786,82927,82927,87735,80392,7343,80392
10131,19963,7089,6929,160,6929,6929,7084,6790,294,6790
10132,45988,45212,43829,1383,43829,43829,45209,43540,1669,43540
10133,61351,67055,69370,-2315,67055,61351,67070,61302,5768,61302
10134,44529,45979,45112,867,45112,44529,45994,43907,2087,43907
10135,57082,55100,53340,1760,53340,53340,55125,52683,2442,52683
10136,12396,10729,11322,-593,10729,10729,10731,10719,12,10719
10137,53695,56351,53233,3118,53233,53233,56347,53046,3301,53046
10138,13715,13163,12879,284,12879,12879,13161,12758,403,12758
10139,51938,49041,45966,3075,45966,45966,49046,45876,3170,45876
10140,387928,387912,382057,5855,382057,382057,387928,377845,10083,377845
10141,150888,145284,136931,8353,136931,136931,145270,136262,9008,136262
10142,19068,19578,19011,567,19011,19011,19591,18903,688,18903
10143,2355,1955,2178,-223,1955,1955,1955,1996,-41,1996
10144,106460,106402,100357,6045,100357,100357,106460,97366,9094,97366
10145,5016,4326,4571,-245,4326,4326,4328,4394,-66,4394
10146,133490,90765,92088,-1323,90765,90765,90786,90517,269,90517
10147,1003,782,1040,-258,782,782,783,826,-43,826
10148,14354,14355,13926,429,13926,13926,14354,13717,637,13717
10149,65251,62688,61547,1141,61547,61547,62685,61421,1264,61421
10150,4423680,3866506,3751901,114605,3751901,3751901,3868190,3731974,136216,3731974
10151,121125,120197,116049,4148,116049,116049,120251,104770,15481,104770
10152,134194,139005,134172,4833,134172,134172,138992,123861,15131,123861
10153,23459,22319,21083,1236,21083,21083,22317,20800,1517,20800
10154,78531,56701,54708,1993,54708,54708,56712,54640,2072,54640
10155,59375,55460,53604,1856,53604,53604,55477,50257,5220,50257
10156,80305,87896,79744,8152,79744,79744,87891,77183,10708,77183
10157,20504,20484,20149,335,20149,20149,20490,19893,597,19893
10158,15124,15328,15128,200,15128,15124,15331,14982,349,14982
10159,42302,9837,9821,16,9821,9821,9836,9633,203,9633
10160,39979,40030,37500,2530,37500,37500,40050,36022,4028,36022
10161,45324,42321,40436,1885,40436,40436,42322,40233,2089,40233
10162,92499,86526,77562,8964,77562,77562,86513,75314,11199,75314
10163,12465,11609,11973,-364,11609,11609,11616,11643,-27,11643
10164,56402,39614,38188,1426,38188,38188,39635,32841,6794,32841
10165,17906,16998,16171,827,16171,16171,17013,15054,1959,15054
10166,420,373,610,-237,373,373,373,420,-47,420
10167,71465,73535,71462,2073,71462,71462,73511,71218,2293,71218
10168,22288,22272,21629,643,21629,21629,22311,20910,1401,20910
10169,518617,509606,475500,34106,475500,475500,509281,475194,34087,475194
10170,14114,14709,14048,661,14048,14048,14707,13965,742,13965
10171,22210,22519,22203,316,22203,22203,22519,21793,726,21793
10172,3134,3102,3341,-239,3102,3102,3100,3112,-12,3112
10173,1334098,1298636,1276820,21816,1276820,1276820,1298416,1250415,48001,1250415
10174,339387,314784,308157,6627,308157,308157,314815,304679,10136,304679
10175,46427,11381,11661,-280,11381,11381,11376,10993,383,10993
10176,15373,15253,15103,150,15103,15103,15239,14899,340,14899
10177,240004,218262,205747,12515,205747,205747,218234,203029,15205,203029
10178,29068,29051,29023,28,29023,29023,29068,28539,529,28539
10179,2646,2542,2646,-104,2542,2542,2546,2355,191,2355
10180,37057,25815,25192,623,25192,25192,25825,23045,2780,23045
10181,28653,26551,25408,1143,25408,25408,26558,25297,1261,25297
10182,3127,3128,3249,-121,3128,3127,3127,3098,29,3098
10183,22391,22741,22397,344,22397,22391,22744,22121,623,22121
10184,36948,34269,34297,-28,34269,34269,34290,33855,435,33855
10185,24714,25778,24850,928,24850,24714,25770,24756,1014,24714
10186,27982,27076,25307,1769,25307,25307,27061,25129,1932,25129
10187,79200,79177,76632,2545,76632,76632,79200,75685,3515,75685
10188,16934,17324,17155,169,17155,16934,17318,16884,434,16884
10189,15296,15295,15531,-236,15295,15295,15300,14807,493,14807
10190,20859,20850,20362,488,20362,20362,20860,20247,613,20247
10191,9180,8258,7963,295,7963,7963,8255,7337,918,7337
10192,18025,17353,16866,487,16866,16866,17356,16690,666,16690
10193,46923,38688,37437,1251,37437,37437,38711,37074,1637,37074
10194,66910,66350,64050,2300,64050,64050,66356,63182,3174,63182
10195,26648,29264,26571,2693,26571,26571,29249,26198,3051,26198
10196,4868,4847,4986,-139,4847,4847,4845,4851,-6,4851
10197,208382,173973,169567,4406,169567,169567,173998,168114,5884,168114
10198,188157,188080,175144,12936,175144,175144,188157,174102,14055,174102
10199,2633,2306,2543,-237,2306,2306,2308,2339,-31,2339
10200,240831,248401,242942,5459,242942,240831,248553,240776,7777,240776
10201,4209883,3973647,3963395,10252,3963395,3963395,3975193,3892938,82255,3892938
10202,98851,98013,96047,1966,96047,96047,97995,94531,3464,94531
10203,15842,21808,22791,-983,21808,15842,21814,16168,5646,15842
10204,51892,51766,53619,-1853,51766,51766,51780,51892,-112,51892
10205,38272,39113,38656,457,38656,38272,39112,38220,892,38220
10206,10210,9802,9798,4,9798,9798,9796,9641,155,9641
10207,812,434,670,-236,434,434,434,479,-45,479
10208,71322,67588,63660,3928,63660,63660,67593,63347,4246,63347
10209,262638,230452,218802,11650,218802,218802,230384,218027,12357,218027
10210,23100,22022,21253,769,21253,21253,22022,21147,875,21147
10211,23546,23543,22751,792,22751,22751,23546,22655,891,22655
10212,63320,63298,63679,-381,63298,63298,63320,62594,726,62594
10213,37581,36671,35089,1582,35089,35089,36662,34887,1775,34887
10214,15491,14636,14794,-158,14636,14636,14643,14508,135,14508
10215,14077,13514,13437,77,13437,13437,13515,13183,332,13183
10216,1093469,1120699,1097802,22897,1097802,1093469,1120965,1095862,25103,1093469
10217,7092,6002,6089,-87,6002,6002,6005,5828,177,5828
10218,124879,123585,116440,7145,116440,116440,123579,116119,7460,116119
10219,9182,9181,9207,-26,9181,9181,9182,8582,600,8582
10220,84979,82648,78908,3740,78908,78908,82668,78676,3992,78676
10221,291809,282472,276447,6025,276447,276447,282608,272968,9640,272968
10222,3342,3109,3343,-234,3109,3109,3110,3099,11,3099
10223,50335,52180,49797,2383,49797,49797,52178,49638,2540,49638
10224,13787,15472,16918,-1446,15472,13787,15471,14309,1162,13787
10225,57092,56155,54052,2103,54052,54052,56171,53167,3004,53167
10226,319715,298814,280904,17910,280904,280904,298808,278927,19881,278927
10227,39150,36981,34668,2313,34668,34668,36981,34526,2455,34526
10228,63603,64876,63686,1190,63686,63603,64898,63603,1295,63603
10229,42322,41345,40249,1096,40249,40249,41385,40044,1341,40044
10230,15645,15129,14669,460,14669,14669,15130,14516,614,14516
10231,95626,71403,66908,4495,66908,66908,71441,66676,4765,66676
10232,145282,144396,145247,-851,144396,144396,144389,143664,725,143664
10233,13590,13588,13554,34,13554,13554,13590,13288,302,13288
10234,311439,294344,293694,650,293694,293694,294359,289962,4397,289962
10235,12040,12037,12066,-29,12037,12037,12040,11695,345,11695
10236,210916,218593,214812,3781,214812,210916,218611,210916,7695,210916
10237,343886,340824,329045,11779,329045,329045,340724,324746,15978,324746
10238,76981,76979,75909,1070,75909,75909,76981,74547,2434,74547
10239,20884,21425,21343,82,21343,20884,21439,20975,464,20884
10240,114747,110081,103743,6338,103743,103743,110082,103114,6968,103114
10241,72237,71725,68881,2844,68881,68881,71683,66320,5363,66320
10242,178198,177960,180882,-2922,177960,177960,178041,174927,3114,174927
10243,28135,27608,26472,1136,26472,26472,27607,26382,1225,26382
10244,110077,116528,110424,6104,110424,110077,116556,110069,6487,110069
10245,10327,10328,10224,104,10224,10224,10327,10100,227,10100
10246,34773,34949,35258,-309,34949,34773,34965,34798,167,34773
10247,96427,89325,84331,4994,84331,84331,89307,83532,5775,83532
10248,2312,1912,2107,-195,1912,1912,1913,1966,-53,1966
10249,24738,21980,22221,-241,21980,21980,21982,21556,426,21556
10250,5620,5622,5875,-253,5622,5620,5620,5608,12,5608
10251,165490,164891,157272,7619,157272,157272,164936,155749,9187,155749
10252,14758,5433,5642,-209,5433,5433,5433,3987,1446,3987
10253,1731,1731,1951,-220,1731,1731,1731,1798,-67,1731
10254,3433,3292,3367,-75,3292,3292,3295,3234,61,3234
10255,1722,1350,1541,-191,1350,1350,1350,1383,-33,1383
10256,51379,53793,51364,2429,51364,51364,53803,51135,2668,51135
10257,25791,24609,23397,1212,23397,23397,24615,23233,1382,23233
10258,26350,25644,25431,213,25431,25431,25645,25204,441,25204
10259,14544,14560,14405,155,14405,14405,14562,14236,326,14236
10260,285108,255736,242920,12816,242920,242920,255732,242253,13479,242253
10261,57428,57432,54490,2942,54490,54490,57428,54281,3147,54281
10262,61620,56999,54399,2600,54399,54399,57023,53961,3062,53961
10263,4405,4403,4735,-332,4403,4403,4405,4342,63,4342
10264,333252,313985,296727,17258,296727,296727,313971,294791,19180,294791
10265,3512677,2860911,2742743,118168,2742743,2742743,2861172,2723746,137426,2723746
10266,10136,9582,9521,61,9521,9521,9589,9289,300,9289
10267,572553,585583,569690,15893,569690,569690,585446,566842,18604,566842
10268,341147,340261,325434,14827,325434,325434,340182,324052,16130,324052
10269,5683,4738,4873,-135,4738,4738,4739,4794,-55,4794
10270,138618,134801,127727,7074,127727,127727,134764,127230,7534,127230
10271,3322,3611,3816,-205,3611,3322,3610,3322,288,3322
10272,4078,3645,3782,-137,3645,3645,3644,3638,6,3638
10273,60252,52240,50845,1395,50845,50845,52237,49927,2310,49927
10274,26925,28312,26855,1457,26855,26855,28312,26760,1552,26760
10275,9662,9899,9601,298,9601,9601,9908,9303,605,9303
10276,15834,15857,15724,133,15724,15724,15852,15577,275,15577
10277,60220,64301,60202,4099,60202,60202,64275,60137,4138,60137
10278,530246,529270,513576,15694,513576,513576,529345,507856,21489,507856
10279,37120,37214,36735,479,36735,36735,37227,36498,729,36498
10280,8362,7600,7517,83,7517,7517,7595,7457,138,7457
10281,16910,15636,14990,646,14990,14990,15631,14915,716,14915
10282,44948,25767,24971,796,24971,24971,25766,24874,892,24874
10283,700614,593052,557858,35194,557858,557858,593100,550241,42859,550241
10284,13357,13357,12968,389,12968,12968,13357,12882,475,12882
10285,2449,2074,2271,-197,2074,2074,2076,2115,-39,2115
10286,581214,580097,558717,21380,558717,558717,580356,555565,24791,555565
10287,8350,7895,7909,-14,7895,7895,7896,7657,239,7657
10288,28165,13676,13434,242,13434,13434,13677,13341,336,13341
10289,23396,22300,21299,1001,21299,21299,22293,21087,1206,21087
10290,3393,3354,3509,-155,3354,3354,3350,3370,-20,3370
10291,52182,49409,46910,2499,46910,46910,49435,46848,2587,46848
10292,43265,38532,37026,1506,37026,37026,38537,35552,2985,35552
10293,855,567,794,-227,567,567,567,614,-47,614
10294,53421,27690,25818,1872,25818,25818,27705,25254,2451,25254
10295,56680,56512,54415,2097,54415,54415,56488,54146,2342,54146
10296,707,707,940,-233,707,707,707,750,-43,707
10297,81114,99219,105804,-6585,99219,81114,99220,84062,15158,81114
10298,68833,42158,41862,296,41862,41862,42161,34506,7655,34506
10299,4093,4074,4307,-233,4074,4074,4076,4142,-66,4093
10300,13996,13437,13300,137,13300,13300,13442,13082,360,13082
10301,31107,31096,30065,1031,30065,30065,31113,29463,1650,29463
10302,714242,676773,640340,36433,640340,640340,677031,631758,45273,631758
10303,558213,468486,443343,25143,443343,443343,468510,431302,37208,431302
10304,83467,82528,77311,5217,77311,77311,82506,75968,6538,75968
10305,23933,23469,22724,745,22724,22724,23460,22623,837,22623
10306,14813,14059,13441,618,13441,13441,14055,13376,679,13376
10307,2858357,2304066,2097427,206639,2097427,2097427,2303499,2036624,266875,2036624
10308,16618,16299,16668,-369,16299,16299,16310,16294,16,16294
10309,487236,483027,472241,10786,472241,472241,483042,469626,13416,469626
10310,5645,5226,5381,-155,5226,5226,5226,5147,79,5147
10311,3607844,3315726,3207349,108377,3207349,3207349,3316932,3176360,140572,3176360
10312,189498,194112,191418,2694,191418,189498,194113,188876,5237,188876
10313,16778,14265,13736,529,13736,13736,14259,13368,891,13368
10314,33084,31815,30643,1172,30643,30643,31824,30282,1542,30282
10315,34226,34250,33045,1205,33045,33045,34244,32985,1259,32985
10316,156667,156662,152392,4270,152392,152392,156667,150435,6232,150435
10317,70515,25584,25522,62,25522,25522,25596,25154,442,25154
10318,67793,66856,62218,4638,62218,62218,66879,60858,6021,60858
10319,8629,7882,7896,-14,7882,7882,7887,7572,315,7572
10320,101890,100963,97765,3198,97765,97765,100949,94690,6259,94690
10321,155591,144476,136498,7978,136498,136498,144478,135300,9178,135300
10322,29162,28641,28197,444,28197,28197,28634,28008,626,28008
10323,872602,823978,772250,51728,772250,772250,824144,767021,57123,767021
10324,33007,33018,33234,-216,33018,33007,33025,31151,1874,31151
10325,210192,224957,212373,12584,212373,210192,224982,210170,14812,210170
10326,9456,9404,9394,10,9394,9394,9409,9219,190,9219
10327,121551,120707,119774,933,119774,119774,120722,119104,1618,119104
10328,21425,4440,4546,-106,4440,4440,4443,4397,46,4397
10329,79399,66994,66093,901,66093,66093,66989,66607,382,66607
10330,23022,17974,18074,-100,17974,17974,17971,17737,234,17737
10331,13679,13091,12951,140,12951,12951,13089,12823,266,12823
10332,64332,62681,60836,1845,60836,60836,62684,60556,2128,60556
10333,5918,5918,6170,-252,5918,5918,5915,5929,-14,5918
10334,50823,50753,49795,958,49795,49795,50754,49317,1437,49317
10335,36498,35801,34702,1099,34702,34702,35809,34638,1171,34638
10336,10447,9845,9708,137,9708,9708,9843,9640,203,9640
10337,12010,11289,11047,242,11047,11047,11288,10924,364,10924
10338,92921,97430,92921,4509,92921,92921,97432,91364,6068,91364
10339,1706,1824,2023,-199,1824,1706,1825,1706,119,1706
10340,43667,40065,37655,2410,37655,37655,40061,37389,2672,37389
10341,52106,54379,54554,-175,54379,52106,54386,51997,2389,51997
10342,167292,166393,165079,1314,165079,165079,166362,160022,6340,160022
10343,23538,22041,20958,1083,20958,20958,22043,20291,1752,20291
10344,8005,8043,8004,39,8004,8004,8043,7846,197,7846
10345,489173,515400,489088,26312,489088,489088,515499,487116,28383,487116
10346,11186,11160,11185,-25,11160,11160,11161,10359,802,10359
10347,27885,18412,21071,-2659,18412,18412,18412,14973,3439,14973
10348,13804,13757,13804,-47,13757,13757,13754,13417,337,13417
10349,136101,129102,119636,9466,119636,119636,129087,119106,9981,119106
10350,80566,79300,73882,5418,73882,73882,79309,73796,5513,73796
10351,2513,2186,2421,-235,2186,2186,2188,2239,-51,2239
10352,135189,145564,135162,10402,135162,135162,145546,134153,11393,134153
10353,160445,160445,157029,3416,157029,157029,160445,155032,5413,155032
10354,43203,42172,40444,1728,40444,40444,42160,40292,1868,40292
10355,5744,5195,5250,-55,5195,5195,5192,4986,206,4986
10356,139245,139235,136449,2786,136449,136449,139230,133660,5570,133660
10357,3258,3261,3461,-200,3261,3258,3265,3258,7,3258
10358,318040,317312,309997,7315,309997,309997,317470,303526,13944,303526
10359,5974,5637,5774,-137,5637,5637,5642,5589,53,5589
10360,597207,630576,600790,29786,600790,597207,630559,597199,33360,597199
10361,188059,188098,179729,8369,179729,179729,188059,177328,10731,177328
10362,27339,23736,23901,-165,23736,23736,23737,22593,1144,22593
10363,345962,350112,345902,4210,345902,345902,350185,339872,10313,339872
10364,3535,3532,3734,-202,3532,3532,3533,3421,112,3421
10365,10255,9694,9552,142,9552,9552,9695,9399,296,9399
10366,51251,50467,49116,1351,49116,49116,50456,48998,1458,48998
10367,3122,2987,3122,-135,2987,2987,2986,3005,-19,3005
10368,49167,30888,31206,-318,30888,30888,30901,30456,445,30456
10369,174561,182761,175641,7120,175641,174561,182715,174758,7957,174561
10370,67595,70534,67593,2941,67593,67593,70520,66794,3726,66794
10371,13654,14007,13652,355,13652,13652,14012,13507,505,13507
10372,147169,150714,141103,9611,141103,141103,150677,140883,9794,140883
10373,56988,56977,55780,1197,55780,55780,56988,55387,1601,55387
10374,26767,27078,26872,206,26872,26767,27074,26717,357,26717
10375,81119,80315,77610,2705,77610,77610,80320,77385,2935,77385
10376,31517,32023,30967,1056,30967,30967,32030,30886,1144,30886
10377,3454,2684,2986,-302,2684,2684,2685,2614,71,2614
10378,48658,27200,26596,604,26596,26596,27210,26129,1081,26129
10379,7232,7232,7567,-335,7232,7232,7232,7219,13,7219
10380,91612,76245,72472,3773,72472,72472,76263,72101,4162,72101
10381,2759,2661,2759,-98,2661,2661,2660,2644,16,2644
10382,224028,237696,228071,9625,228071,224028,237742,224020,13722,224020
10383,5189,5420,5189,231,5189,5189,5421,4916,505,4916
10384,269019,238140,231099,7041,231099,231099,238207,229782,8425,229782
10385,42138,42646,42924,-278,42646,42138,42652,42281,371,42138
10386,4858,4769,4797,-28,4769,4769,4774,4647,127,4647
10387,156163,139431,132036,7395,132036,132036,139470,129689,9781,129689
10388,5769,5382,5370,12,5370,5370,5382,5256,126,5256
10389,15560,15088,14761,327,14761,14761,15080,14636,444,14636
10390,22907,24135,22910,1225,22910,22907,24130,22770,1360,22770
10391,90572,97819,92358,5461,92358,90572,97895,90539,7356,90539
10392,5683,5211,5349,-138,5211,5211,5209,5150,59,5150
10393,459890,482515,463259,19256,463259,459890,482677,459900,22777,459890
10394,47048,12692,12371,321,12371,12371,12695,12184,511,12184
10395,86616,90735,86969,3766,86969,86616,90688,86594,4094,86594
10396,48956,44447,43201,1246,43201,43201,44456,43027,1429,43027
10397,4780,3940,4132,-192,3940,3940,3942,3992,-50,3992
10398,97858,93680,89042,4638,89042,89042,93733,88165,5568,88165
10399,16962,16405,16053,352,16053,16053,16408,15915,493,15915
10400,23170,18165,18127,38,18127,18127,18175,17925,250,17925
10401,2614,1678,1970,-292,1678,1678,1678,1353,325,1353
10402,7756,7774,7936,-162,7774,7756,7772,7678,94,7678
10403,80102,81086,80102,984,80102,80102,81129,77496,3633,77496
10404,21295,20642,20279,363,20279,20279,20652,20078,574,20078
10405,26145,27033,26074,959,26074,26074,27026,25704,1322,25704
10406,5605,4409,4617,-208,4409,4409,4408,4440,-32,4440
10407,10078,10077,10032,45,10032,10032,10078,9760,318,9760
10408,13698,13545,13632,-87,13545,13545,13536,13402,134,13402
10409,4745,3905,4161,-256,3905,3905,3906,3973,-67,3973
10410,55304,54590,51954,2636,51954,51954,54561,51849,2712,51849
10411,35343,34749,33762,987,33762,33762,34743,33602,1141,33602
10412,24803,24685,24315,370,24315,24315,24686,24181,505,24181
10413,17727,17165,16357,808,16357,16357,17173,13504,3669,13504
10414,61455,63369,64232,-863,63369,61455,63411,59972,3439,59972
10415,18123,18121,17676,445,17676,17676,18123,17577,546,17577
10416,89609,93011,88488,4523,88488,88488,93026,86761,6265,86761
10417,14203,13054,12567,487,12567,12567,13052,12497,555,12497
10418,43749,12515,12365,150,12365,12365,12515,12096,419,12096
10419,38178,37143,36225,918,36225,36225,37151,36017,1134,36017
10420,2949,2615,2790,-175,2615,2615,2613,2593,20,2593
10421,11193,11191,11152,39,11152,11152,11193,10960,233,10960
10422,5044,4052,4193,-141,4052,4052,4052,3793,259,3793
10423,79739,74518,73536,982,73536,73536,74531,73009,1522,73009
10424,31103,31317,31317,0,31317,31103,31323,31126,197,31103
10425,11180,10085,9846,239,9846,9846,10082,9524,558,9524
10426,2339,1370,1607,-237,1370,1370,1368,1426,-58,1426
10427,24893,6544,6955,-411,6544,6544,6546,6469,77,6469
10428,1711,1714,1927,-213,1714,1711,1711,1756,-45,1711
10429,36879,36896,35380,1516,35380,35380,36874,34986,1888,34986
10430,50885,48321,48559,-238,48321,48321,48360,48032,328,48032
10431,12435,13028,12779,249,12779,12435,13025,12435,590,12435
10432,208111,206263,198547,7716,198547,198547,206252,197350,8902,197350
10433,19073,18609,18452,157,18452,18452,18613,18237,376,18237
10434,6330,5685,5804,-119,5685,5685,5681,5708,-27,5708
10435,17645,16071,15547,524,15547,15547,16074,15314,760,15314
10436,335122,282877,278053,4824,278053,278053,282851,277472,5379,277472
10437,24693,7790,7790,0,7790,7790,7791,7523,268,7523
10438,58139,60426,58143,2283,58143,58139,60415,57924,2491,57924
10439,58013,63731,59963,3768,59963,58013,63745,57991,5754,57991
10440,55561,54275,53387,888,53387,53387,54341,52395,1946,52395
10441,3950,3635,3816,-181,3635,3635,3638,3661,-23,3661
10442,62020,61092,58038,3054,58038,58038,61100,57609,3491,57609
10443,26347,24911,23410,1501,23410,23410,24916,23143,1773,23143
10444,355524,353245,337692,15553,337692,337692,353193,335722,17471,335722
10445,121734,120996,114290,6706,114290,114290,121058,113569,7489,113569
10446,55767,49358,46686,2672,46686,46686,49387,46467,2920,46467
10447,2314,1999,2220,-221,1999,1999,1998,2054,-56,2054
10448,10607,10611,10429,182,10429,10429,10607,10388,219,10388
10449,74499,4492,4684,-192,4492,4492,4495,4522,-27,4522
10450,282578,264865,255196,9669,255196,255196,264876,252462,12414,252462
10451,389500,389471,367500,21971,367500,367500,389500,362674,26826,362674
10452,35153,36093,35277,816,35277,35153,36087,34639,1448,34639
10453,27267,28346,27198,1148,27198,27198,28355,27065,1290,27065
10454,12293,12458,12225,233,12225,12225,12453,12014,439,12014
10455,37105,37066,35627,1439,35627,35627,37064,35257,1807,35257
10456,24795,24243,23387,856,23387,23387,24241,22891,1350,22891
10457,326032,327354,316877,10477,316877,316877,327426,313607,13819,313607
10458,71200,73168,71187,1981,71187,71187,73152,70501,2651,70501
10459,51070,37576,36193,1383,36193,36193,37596,35737,1859,35737
10460,41768,40744,39140,1604,39140,39140,40750,39030,1720,39030
10461,162759,166276,162724,3552,162724,162724,166295,162604,3691,162604
10462,34256,34260,32386,1874,32386,32386,34256,32125,2131,32125
10463,13314,13634,13308,326,13308,13308,13623,13113,510,13113
10464,65866,65834,62923,2911,62923,62923,65834,62419,3415,62419
10465,31227,31556,31218,338,31218,31218,31568,30977,591,30977
10466,61742,40124,38076,2048,38076,38076,40123,37878,2245,37878
10467,3595,3595,3668,-73,3595,3595,3595,3487,108,3487
10468,73785,73715,73609,106,73609,73609,73726,72544,1182,72544
10469,21064,2510,2737,-227,2510,2510,2511,2544,-33,2544
10470,11246,11433,11246,187,11246,11246,11436,11221,215,11221
10471,3666,3290,3427,-137,3290,3290,3289,3273,16,3273
10472,1338,502,736,-234,502,502,502,529,-27,529
10473,1507,1506,1763,-257,1506,1506,1507,1557,-50,1507
10474,3682,3747,3946,-199,3747,3682,3748,3682,66,3682
10475,248384,247284,240621,6663,240621,240621,247404,236918,10486,236918
10476,66615,6644,7017,-373,6644,6644,6645,6221,424,6221
10477,45009,45810,44684,1126,44684,44684,45827,44387,1440,44387
10478,433244,417280,395658,21622,395658,395658,417160,393477,23683,393477
10479,715205,695393,656303,39090,656303,656303,695512,624174,71338,624174
10480,10825,499,629,-130,499,499,499,509,-10,509
10481,34456,32319,30624,1695,30624,30624,32316,30525,1791,30525
10482,67918,60242,59580,662,59580,59580,60266,58661,1605,58661
10483,8128,7781,7715,66,7715,7715,7771,7579,192,7579
10484,110915,110937,106578,4359,106578,106578,110933,100821,10112,100821
10485,113005,105834,105259,575,105259,105259,105860,103183,2677,103183
10486,9815,9815,9681,134,9681,9681,9815,9458,357,9458
10487,605,621,876,-255,621,605,621,649,-28,605
10488,118364,123216,118364,4852,118364,118364,123197,115562,7635,115562
10489,395175,394169,379246,14923,379246,379246,394150,376348,17802,376348
10490,15421,14602,13961,641,13961,13961,14604,13618,986,13618
10491,10787,10210,10385,-175,10210,10210,10213,10115,98,10115
10492,68598,62071,59304,2767,59304,59304,62087,58925,3162,58925
10493,13494,14279,13897,382,13897,13494,14287,13461,826,13461
10494,151704,148440,145878,2562,145878,145878,148446,144750,3696,144750
10495,98505,96060,91301,4759,91301,91301,96027,88405,7622,88405
10496,4278,3625,3734,-109,3625,3625,3626,3463,163,3463
10497,48885,47957,46839,1118,46839,46839,47956,46497,1459,46497
10498,901503,871323,819677,51646,819677,819677,870978,809011,61967,809011
10499,5594,5594,5759,-165,5594,5594,5594,5471,123,5471
10500,8748,8755,8895,-140,8755,8748,8759,8583,176,8583
10501,22498,21853,20748,1105,20748,20748,21864,20671,1193,20671
10502,29330,30965,29263,1702,29263,29263,30970,28940,2030,28940
10503,10931,10397,10372,25,10372,10372,10398,10280,118,10280
10504,2086,2066,2229,-163,2066,2066,2067,1943,124,1943
10505,2640,2264,2470,-206,2264,2264,2268,2328,-60,2328
10506,11418,11414,11189,225,11189,11189,11418,10617,801,10617
10507,66370,71072,66277,4795,66277,66277,71091,64926,6165,64926
10508,5569,5616,5514,102,5514,5514,5620,5128,492,5128
10509,35431,35661,34143,1518,34143,34143,35666,33476,2190,33476
10510,201060,199217,193212,6005,193212,193212,199217,191378,7839,191378
10511,9086,8535,8387,148,8387,8387,8532,8155,377,8155
10512,48417,47380,45071,2309,45071,45071,47372,44921,2451,44921
10513,5356,4999,5047,-48,4999,4999,5002,4916,86,4916
10514,2089,1788,2029,-241,1788,1788,1786,1845,-59,1845
10515,100321,99460,94373,5087,94373,94373,99492,91573,7919,91573
10516,100062,96359,93032,3327,93032,93032,96368,92210,4158,92210
10517,26003,21652,20649,1003,20649,20649,21662,20436,1226,20436
10518,264762,264697,261926,2771,261926,261926,264762,257788,6974,257788
10519,177300,169695,158267,11428,158267,158267,169687,157231,12456,157231
10520,22567,23450,22491,959,22491,22491,23455,22256,1199,22256
10521,26942,13396,13483,-87,13396,13396,13403,13226,177,13226
10522,5762,5363,5409,-46,5363,5363,5366,5271,95,5271
10523,157786,157808,148091,9717,148091,148091,157786,147870,9916,147870
10524,32486,32483,31154,1329,31154,31154,32486,30926,1560,30926
10525,21299,21918,22307,-389,21918,21299,21929,21291,638,21291
10526,9047,9045,8754,291,8754,8754,9047,8344,703,8344
10527,6215,5365,5349,16,5349,5349,5370,4994,376,4994
10528,2567,1692,1893,-201,1692,1692,1693,1747,-54,1747
10529,32610,32947,31906,1041,31906,31906,32930,31649,1281,31649
10530,33746,32865,31408,1457,31408,31408,32873,31251,1622,31251
10531,56419,55377,54187,1190,54187,54187,55387,53822,1565,53822
10532,79060,79069,77935,1134,77935,77935,79060,77143,1917,77143
10533,3143,2972,3218,-246,2972,2972,2971,3040,-69,3040
10534,131772,144177,134848,9329,134848,131772,144256,131699,12557,131699
10535,110096,110090,108054,2036,108054,108054,110096,104445,5651,104445
10536,201163,200191,199859,332,199859,199859,200285,196375,3910,196375
10537,9145,8580,8529,51,8529,8529,8582,8361,221,8361
10538,196925,206730,196894,9836,196894,196894,206770,195813,10957,195813
10539,532992,520242,510163,10079,510163,510163,520190,506322,13868,506322
10540,41829,40791,38435,2356,38435,38435,40788,37707,3081,37707
10541,6462,6462,6774,-312,6462,6462,6464,6544,-80,6462
10542,20335,4532,4610,-78,4532,4532,4533,4501,32,4501
10543,12265,10605,9736,869,9736,9736,10606,8997,1609,8997
10544,37114,40414,38116,2298,38116,37114,40418,36492,3926,36492
10545,19944,19216,19251,-35,19216,19216,19216,18963,253,18963
10546,119160,125663,119120,6543,119120,119120,125612,118467,7145,118467
10547,7840,7431,7608,-177,7431,7431,7433,7409,24,7409
10548,12863,12309,11943,366,11943,11943,12309,11757,552,11757
10549,111228,105373,99627,5746,99627,99627,105326,98186,7140,98186
10550,4069,1603,1808,-205,1603,1603,1605,1605,0,1605
10551,32201,33026,32391,635,32391,32201,33028,32278,750,32201
10552,1015091,1013977,960617,53360,960617,960617,1014805,952911,61894,952911
10553,300971,237653,224913,12740,224913,224913,237596,223732,13864,223732
10554,49260,37138,36530,608,36530,36530,37142,32967,4175,32967
10555,20354,20244,19807,437,19807,19807,20243,19516,727,19516
10556,90851,86902,81714,5188,81714,81714,86913,80120,6793,80120
10557,14976,13804,13439,365,13439,13439,13804,13040,764,13040
10558,31571,30640,29746,894,29746,29746,30635,29619,1016,29619
10559,88135,91259,89402,1857,89402,88135,91267,88545,2722,88135
10560,6680,6243,6281,-38,6243,6243,6245,6160,85,6160
10561,52985,30419,29211,1208,29211,29211,30431,29044,1387,29044
10562,16744,16185,16168,17,16168,16168,16190,13842,2348,13842
10563,120602,120563,115746,4817,115746,115746,120583,113834,6749,113834
10564,92270,89449,85346,4103,85346,85346,89467,83334,6133,83334
10565,36635,35771,34916,855,34916,34916,35781,34618,1163,34618
10566,36786,37006,36321,685,36321,36321,37002,36164,838,36164
10567,156589,157317,156522,795,156522,156522,157353,153367,3986,153367
10568,21036,21443,21178,265,21178,21036,21447,21036,411,21036
10569,32135,31581,31243,338,31243,31243,31581,30932,649,30932
10570,344,326,563,-237,326,326,326,370,-44,344
10571,53941,53024,52032,992,52032,52032,53032,50979,2053,50979
10572,3361,3379,3380,-1,3379,3361,3379,3207,172,3207
10573,27673,2395,2602,-207,2395,2395,2398,2446,-48,2446
10574,329397,328698,316379,12319,316379,316379,328843,314407,14436,314407
10575,116878,100563,94153,6410,94153,94153,100546,93416,7130,93416
10576,4368,3521,3792,-271,3521,3521,3523,3594,-71,3594
10577,29247,30134,30594,-460,30134,29247,30142,28625,1517,28625
10578,174997,174974,170434,4540,170434,170434,174997,169670,5327,169670
10579,235520,235475,233266,2209,233266,233266,235578,231195,4383,231195
10580,4904,4843,4842,1,4842,4842,4842,4738,104,4738
10581,73751,71340,67643,3697,67643,67643,71387,67293,4094,67293
10582,12056,12380,11996,384,11996,11996,12371,11819,552,11819
10583,3624,3068,3229,-161,3068,3068,3068,3082,-14,3082
10584,3733,3260,3319,-59,3260,3260,3259,3233,26,3233
10585,315195,314208,307302,6906,307302,307302,314243,305636,8607,305636
10586,75175,78099,75150,2949,75150,75150,78138,74366,3772,74366
10587,46735,46709,45904,805,45904,45904,46735,45474,1261,45474
10588,107056,103105,98010,5095,98010,98010,103110,97681,5429,97681
10589,10529,9934,9961,-27,9934,9934,9935,9907,28,9907
10590,58014,60297,57997,2300,57997,57997,60290,57208,3082,57208
10591,61290,69274,67537,1737,67537,61290,69297,61462,7835,61290
10592,34700,22016,21872,144,21872,21872,22005,21479,526,21479
10593,117843,117049,111406,5643,111406,111406,117098,110353,6745,110353
10594,315209,294313,277684,16629,277684,277684,294439,274843,19596,274843
10595,158150,150050,143947,6103,143947,143947,150140,143491,6649,143491
10596,11018,11238,10957,281,10957,10957,11235,10723,512,10723
10597,54003,56996,54081,2915,54081,54003,57007,54017,2990,54003
10598,15213,15218,14788,430,14788,14788,15213,14606,607,14606
10599,15059,16979,16461,518,16461,15059,16974,15059,1915,15059
10600,24907,13573,12831,742,12831,12831,13580,11816,1764,11816
10601,4445,3988,4063,-75,3988,3988,3986,3965,21,3965
10602,2321,1839,2096,-257,1839,1839,1839,1884,-45,1884
10603,12033,12085,12032,53,12032,12032,12087,11893,194,11893
10604,245808,197053,197582,-529,197053,197053,197142,187941,9201,187941
10605,19854,3586,3799,-213,3586,3586,3586,3531,55,3531
10606,27765,26929,26964,-35,26929,26929,26926,26294,632,26294
10607,12221,12218,11744,474,11744,11744,12221,11269,952,11269
10608,5323,4914,5016,-102,4914,4914,4912,4839,73,4839
10609,15421,9822,9916,-94,9822,9822,9838,9382,456,9382
10610,1880361,1831454,1765682,65772,1765682,1765682,1831568,1750328,81240,1750328
10611,52106,51920,49452,2468,49452,49452,51934,48498,3436,48498
10612,39391,39291,38428,863,38428,38428,39298,37795,1503,37795
10613,197861,186863,175055,11808,175055,175055,186941,171808,15133,171808
10614,112201,99988,95420,4568,95420,95420,99967,94440,5527,94440
10615,12505,12584,12502,82,12502,12502,12587,12201,386,12201
10616,2757,2774,2974,-200,2774,2757,2773,2803,-30,2757
10617,1192,811,1058,-247,811,811,811,873,-62,873
10618,175543,164451,152952,11499,152952,152952,164454,151982,12472,151982
10619,75632,79213,76651,2562,76651,75632,79242,75890,3352,75632
10620,47257,46345,44192,2153,44192,44192,46380,42383,3997,42383
10621,4368,4236,4401,-165,4236,4236,4234,4231,3,4231
10622,11518,8355,8033,322,8033,8033,8356,7932,424,7932
10623,163824,158884,150809,8075,150809,150809,158930,150479,8451,150479
10624,22314,21668,20793,875,20793,20793,21677,20740,937,20740
10625,1437470,1492472,1418713,73759,1418713,1418713,1492682,1402556,90126,1402556
10626,45005,20497,19793,704,19793,19793,20499,19332,1167,19332
10627,111576,113448,116907,-3459,113448,111576,113445,108018,5427,108018
10628,15180,14388,14332,56,14332,14332,14392,13863,529,13863
10629,49500,26836,26635,201,26635,26635,26839,26235,604,26235
10630,85389,84278,83463,815,83463,83463,84314,81935,2379,81935
10631,8509,8748,8509,239,8509,8509,8752,8409,343,8409
10632,22671,24877,24619,258,24619,22671,24887,22924,1963,22671
10633,2894685,2519543,2422682,96861,2422682,2422682,2519387,2408370,111017,2408370
10634,57147,53014,49693,3321,49693,49693,53050,49223,3827,49223
10635,166420,172207,167309,4898,167309,166420,172227,167012,5215,166420
10636,16003,16003,15589,414,15589,15589,16003,15015,988,15015
10637,37450,37470,36003,1467,36003,36003,37450,35678,1772,35678
10638,747526,689955,656066,33889,656066,656066,689864,644016,45848,644016
10639,63111,66040,62395,3645,62395,62395,66060,61395,4665,61395
10640,37824,31690,30302,1388,30302,30302,31705,29986,1719,29986
10641,229718,232765,232359,406,232359,229718,232816,229710,3106,229710
10642,22892,22779,23268,-489,22779,22779,22789,22841,-52,22841
10643,28570,28001,27398,603,27398,27398,28016,27031,985,27031
10644,25741,25163,25333,-170,25163,25163,25175,24859,316,24859
10645,279583,276408,263854,12554,263854,263854,276421,262687,13734,262687
10646,38291,37418,37217,201,37217,37217,37429,36769,660,36769
10647,42161,43370,42832,538,42832,42161,43379,42161,1218,42161
10648,51142,52350,53692,-1342,52350,51142,52386,52012,374,51142
10649,598573,613987,599525,14462,599525,598573,614021,598588,15433,598573
10650,36428,36394,35216,1178,35216,35216,36428,34823,1605,34823
10651,56671,54563,52877,1686,52877,52877,54579,52541,2038,52541
10652,4714,4730,4928,-198,4730,4714,4732,4630,102,4630
10653,109006,108433,101852,6581,101852,101852,108452,100687,7765,100687
10654,7246,7248,7204,44,7204,7204,7247,7020,227,7020
10655,125293,125291,123336,1955,123336,123336,125316,122025,3291,122025
10656,21044,7578,7621,-43,7578,7578,7580,7494,86,7494
10657,505260,505204,477648,27556,477648,477648,505278,475683,29595,475683
10658,1359,979,1219,-240,979,979,979,1019,-40,1019
10659,19531,19961,19531,430,19531,19531,19957,19393,564,19393
10660,2947,2564,2736,-172,2564,2564,2565,2596,-31,2596
10661,43268,37926,36395,1531,36395,36395,37921,35633,2288,35633
10662,28182,27582,26353,1229,26353,26353,27594,26163,1431,26163
10663,466533,465469,443969,21500,443969,443969,465383,441571,23812,441571
10664,1121456,1059971,1001630,58341,1001630,1001630,1059840,985407,74433,985407
10665,7491,8019,7488,531,7488,7488,8023,7313,710,7313
10666,293210,311109,299057,12052,299057,293210,311243,292588,18655,292588
10667,17429,17384,17253,131,17253,17253,17377,17097,280,17097
10668,4867,4810,5155,-345,4810,4810,4813,4867,-54,4867
10669,27574,29117,27565,1552,27565,27565,29112,27134,1978,27134
10670,17904,16861,16602,259,16602,16602,16865,16345,520,16345
10671,53283,52712,49584,3128,49584,49584,52729,49296,3433,49296
10672,296399,296517,280917,15600,280917,280917,296399,279208,17191,279208
10673,77786,72478,73568,-1090,72478,72478,72487,64813,7674,64813
10674,2259,1888,2067,-179,1888,1888,1887,1924,-37,1924
10675,94275,96303,94250,2053,94250,94250,96319,93327,2992,93327
10676,984538,974908,947063,27845,947063,947063,974906,941871,33035,941871
10677,6327,6363,6262,101,6262,6262,6368,6016,352,6016
10678,8142,7302,7231,71,7231,7231,7302,6470,832,6470
10679,97570,96619,94889,1730,94889,94889,96650,94414,2236,94414
10680,12866,11841,12154,-313,11841,11841,11842,11724,118,11724
10681,1302,912,1178,-266,912,912,912,957,-45,957
10682,926674,926240,923595,2645,923595,923595,926674,899697,26977,899697
10683,110511,114269,115448,-1179,114269,110511,114274,110503,3771,110503
10684,19375,18462,18267,195,18267,18267,18453,17967,486,17967
10685,262445,259381,263267,-3886,259381,259381,259283,242745,16538,242745
10686,1672,1672,1891,-219,1672,1672,1677,1718,-41,1672
10687,13026,13025,12782,243,12782,12782,13026,12642,384,12642
10688,23457,23659,23335,324,23335,23335,23671,22835,836,22835
10689,91629,88215,82039,6176,82039,82039,88232,81506,6726,81506
10690,212473,203639,195413,8226,195413,195413,203679,194607,9072,194607
10691,18100,16113,16342,-229,16113,16113,16110,15306,804,15306
10692,1816,871,1229,-358,871,871,871,823,48,823
10693,47691,46765,44447,2318,44447,44447,46761,44303,2458,44303
10694,61838,60923,60469,454,60469,60469,60931,59722,1209,59722
10695,77484,77505,75686,1819,75686,75686,77484,75194,2290,75194
10696,24901,4127,4233,-106,4127,4127,4124,3578,546,3578
10697,44402,44388,43385,1003,43385,43385,44402,43060,1342,43060
10698,18397,10366,10864,-498,10366,10366,10370,10099,271,10099
10699,59669,55889,53386,2503,53386,53386,55879,53110,2769,53110
10700,1064,757,993,-236,757,757,756,805,-49,805
10701,122546,106455,100999,5456,100999,100999,106432,100967,5465,100967
10702,289755,289454,279334,10120,279334,279334,289565,276329,13236,276329
10703,8052,7495,7357,138,7357,7357,7498,7021,477,7021
10704,250797,208652,198763,9889,198763,198763,208793,198091,10702,198091
10705,29602,29602,30119,-517,29602,29602,29602,29555,47,29555
10706,24176,24890,24103,787,24103,24103,24894,23946,948,23946
10707,29189,19827,19090,737,19090,19090,19814,19022,792,19022
10708,39268,6607,6676,-69,6607,6607,6608,6489,119,6489
10709,1553958,1491696,1483187,8509,1483187,1483187,1491739,1469609,22130,1469609
10710,13922,13759,14127,-368,13759,13759,13762,13745,17,13745
10711,5648,5271,5315,-44,5271,5271,5272,5026,246,5026
10712,68130,67324,65187,2137,65187,65187,67351,64607,2744,64607
10713,41383,41396,40478,918,40478,40478,41383,40131,1252,40131
10714,2584,2602,2835,-233,2602,2584,2602,2669,-67,2584
10715,8380,7596,7704,-108,7596,7596,7590,7469,121,7469
10716,1277,903,1155,-252,903,903,903,945,-42,945
10717,388399,388348,382243,6105,382243,382243,388380,380617,7763,380617
10718,67661,67624,67654,-30,67624,67624,67648,62446,5202,62446
10719,52706,51258,49760,1498,49760,49760,51220,49057,2163,49057
10720,696117,695224,666320,28904,666320,666320,694995,657985,37010,657985
10721,68647,70099,68637,1462,68637,68637,70110,67848,2262,67848
10722,1244,821,1072,-251,821,821,821,871,-50,871
10723,8013,8308,8014,294,8014,8013,8300,7930,370,7930
10724,201457,200867,196650,4217,196650,196650,200903,197033,3870,197033
10725,6061,5674,5761,-87,5674,5674,5676,5602,74,5602
10726,12423,11486,11246,240,11246,11246,11483,10864,619,10864
10727,10832,9395,9165,230,9165,9165,9391,9044,347,9044
10728,7868,6996,7123,-127,6996,6996,7000,6963,37,6963
10729,34229,31439,30027,1412,30027,30027,31448,29626,1822,29626
10730,342,321,555,-234,321,321,321,358,-37,342
10731,56636,53646,54330,-684,53646,53646,53675,53133,542,53133
10732,162706,149107,134767,14340,134767,134767,149063,134161,14902,134161
10733,54112,55501,56153,-652,55501,54112,55530,54104,1426,54104
10734,28221,28217,26685,1532,26685,26685,28221,23353,4868,23353
10735,271913,270940,261468,9472,261468,261468,270952,259522,11430,259522
10736,6090,6090,5968,122,5968,5968,6088,5912,176,5912
10737,7296,7357,7314,43,7314,7296,7362,7144,218,7144
10738,3306,2830,2988,-158,2830,2830,2831,2754,77,2754
10739,23640,22810,22616,194,22616,22616,22810,21629,1181,21629
10740,12622,12618,12488,130,12488,12488,12622,12361,261,12361
10741,14939,14345,14276,69,14276,14276,14346,14057,289,14057
10742,49439,10183,10027,156,10027,10027,10186,9872,314,9872
10743,167197,163797,159851,3946,159851,159851,163862,158948,4914,158948
10744,16746,16769,16729,40,16729,16729,16774,16213,561,16213
10745,9332,8836,8789,47,8789,8789,8840,8678,162,8678
10746,827562,720497,723029,-2532,720497,720497,720720,692895,27825,692895
10747,2897,2475,2648,-173,2475,2475,2474,2467,7,2467
10748,9984,9358,9117,241,9117,9117,9363,8984,379,8984
10749,146027,118958,120497,-1539,118958,118958,118957,108322,10635,108322
10750,49477,54703,51933,2770,51933,49477,54715,50646,4069,49477
10751,13244,13247,12822,425,12822,12822,13244,12608,636,12608
10752,11692,11691,11719,-28,11691,11691,11692,11539,153,11539
10753,532501,568191,538607,29584,538607,532501,568031,532493,35538,532493
10754,102122,107229,102103,5126,102103,102103,107223,101243,5980,101243
10755,7954105,7673974,7306097,367877,7306097,7306097,7674206,7239113,435093,7239113
10756,55096,55126,52716,2410,52716,52716,55096,52558,2538,52558
10757,11368,7389,7461,-72,7389,7389,7389,7334,55,7334
10758,21161,20553,19740,813,19740,19740,20541,19684,857,19684
10759,37537,37510,36220,1290,36220,36220,37537,35987,1550,35987
10760,8884,8862,8770,92,8770,8770,8864,8646,218,8646
10761,15411,14323,14039,284,14039,14039,14323,13716,607,13716
10762,34647,35634,34777,857,34777,34647,35624,34647,977,34647
10763,28254,27326,26693,633,26693,26693,27330,26568,762,26568
10764,7775,7682,7412,270,7412,7412,7687,6884,803,6884
10765,18169,18405,18090,315,18090,18090,18399,17889,510,17889
10766,3721,3330,3456,-126,3330,3330,3331,3299,32,3299
10767,89784,85239,81810,3429,81810,81810,85272,80854,4418,80854
10768,4260,3848,3992,-144,3848,3848,3846,3793,53,3793
10769,79530,83999,80208,3791,80208,79530,84015,79522,4493,79522
10770,9326,9374,9262,112,9262,9262,9378,9013,365,9013
10771,122694,118751,115477,3274,115477,115477,118775,114936,3839,114936
10772,41842,37141,36393,748,36393,36393,37134,36258,876,36258
10773,444758,380697,363406,17291,363406,363406,380782,360983,19799,360983
10774,3386,3386,3461,-75,3386,3386,3386,3337,49,3337
10775,28362,28344,26698,1646,26698,26698,28355,25978,2377,25978
10776,1415,1044,1295,-251,1044,1044,1044,1096,-52,1096
10777,7262,7079,7281,-202,7079,7079,7082,7072,10,7072
10778,24113,15005,14574,431,14574,14574,15000,14124,876,14124
10779,216709,216754,213147,3607,213147,213147,216709,188680,28029,188680
10780,52158,46812,44033,2779,44033,44033,46825,41584,5241,41584
10781,1507,1509,1724,-215,1509,1507,1507,1513,-6,1507
10782,14884,13772,14164,-392,13772,13772,13780,13695,85,13695
10783,53720,53143,50761,2382,50761,50761,53142,49906,3236,49906
10784,30547,29334,29060,274,29060,29060,29332,28661,671,28661
10785,199935,121500,120821,679,120821,120821,121545,118405,3140,118405
10786,4932,3848,3937,-89,3848,3848,3844,3586,258,3586
10787,39635,40619,39567,1052,39567,39567,40616,39204,1412,39204
10788,4991,5008,4957,51,4957,4957,5009,4414,595,4414
10789,22359,22333,20655,1678,20655,20655,22338,16998,5340,16998
10790,6077,5441,5433,8,5433,5433,5442,5161,281,5161
10791,13585,13097,12634,463,12634,12634,13086,12547,539,12547
10792,50275,32759,31822,937,31822,31822,32760,30699,2061,30699
10793,6838,6404,6547,-143,6404,6404,6403,6309,94,6309
10794,25750,11392,11256,136,11256,11256,11390,10904,486,10904
10795,14768,14762,14773,-11,14762,14762,14768,14324,444,14324
10796,3720,3333,3561,-228,3333,3333,3334,3386,-52,3386
10797,44356,53680,60100,-6420,53680,44356,53682,44356,9326,44356
10798,272715,271746,256406,15340,256406,256406,271804,245355,26449,245355
10799,3382,3255,3354,-99,3255,3255,3257,3246,11,3246
10800,285933,284914,271462,13452,271462,271462,285063,268295,16768,268295
10801,8670,8109,8330,-221,8109,8109,8116,7984,132,7984
10802,1445,305,539,-234,305,305,305,351,-46,351
10803,38771,38590,37931,659,37931,37931,38578,36756,1822,36756
10804,2855,2429,2609,-180,2429,2429,2431,2457,-26,2457
10805,58152,43922,42219,1703,42219,42219,43900,42075,1825,42075
10806,38867,37936,37792,144,37792,37792,37954,37273,681,37273
10807,97637,97622,94365,3257,94365,94365,97625,92900,4725,92900
10808,4732,4733,4811,-78,4733,4732,4732,4663,69,4663
10809,49640,48627,47578,1049,47578,47578,48628,46941,1687,46941
10810,120799,112448,109266,3182,109266,109266,112422,109041,3381,109041
10811,38821,35742,35717,25,35717,35717,35769,34822,947,34822
10812,55590,55781,54251,1530,54251,54251,55793,53769,2024,53769
10813,35975,38372,36451,1921,36451,35975,38369,35583,2786,35583
10814,30287,29694,29038,656,29038,29038,29703,28894,809,28894
10815,74889,74908,71439,3469,71439,71439,74889,71156,3733,71156
10816,16420,7990,7858,132,7858,7858,7986,7805,181,7805
10817,120374,101274,99723,1551,99723,99723,101313,98778,2535,98778
10818,8540,8066,8152,-86,8066,8066,8071,7926,145,7926
10819,385239,384288,375985,8303,375985,375985,384258,372659,11599,372659
10820,10820,10822,10987,-165,10822,10820,10820,10805,15,10805
10821,6468,5619,5514,105,5514,5514,5622,5337,285,5337
10822,188762,188672,184039,4633,184039,184039,188670,182834,5836,182834
10823,172993,158982,156129,2853,156129,156129,159040,155156,3884,155156
10824,56051,56808,56478,330,56478,56051,56809,56043,766,56043
10825,181168,165083,155801,9282,155801,155801,165196,152535,12661,152535
10826,29279,28721,27784,937,27784,27784,28725,27566,1159,27566
10827,21256,19802,18206,1596,18206,18206,19801,17490,2311,17490
10828,2438,2201,2377,-176,2201,2201,2202,2178,24,2178
10829,12619,11768,11157,611,11157,11157,11770,10759,1011,10759
10830,50952,54615,52530,2085,52530,50952,54637,51399,3238,50952
10831,147668,141896,142191,-295,141896,141896,141911,140302,1609,140302
10832,219185,218160,214420,3740,214420,214420,218204,212597,5607,212597
10833,7361,7306,7211,95,7211,7211,7300,7092,208,7092
10834,12506,12730,12449,281,12449,12449,12725,11886,839,11886
10835,199940,205677,197563,8114,197563,197563,205769,196934,8835,196934
10836,285611,285610,273152,12458,273152,273152,285611,271579,14032,271579
10837,84662,42113,40242,1871,40242,40242,42096,40110,1986,40110
10838,504705,471976,449250,22726,449250,449250,472007,446554,25453,446554
10839,131615,115702,118250,-2548,115702,115702,115721,113547,2174,113547
10840,7080,7045,6954,91,6954,6954,7044,6621,423,6621
10841,28301,27482,27035,447,27035,27035,27483,26880,603,26880
10842,333040,307382,300037,7345,300037,300037,307513,298997,8516,298997
10843,297947,297926,282179,15747,282179,282179,298027,277949,20078,277949
10844,24800,24238,23228,1010,23228,23228,24233,23162,1071,23162
10845,188529,172062,172160,-98,172062,172062,172139,169877,2262,169877
10846,175788,174895,169722,5173,169722,169722,174880,166436,8444,166436
10847,37644,38439,37640,799,37640,37640,38446,37326,1120,37326
10848,13423,13899,13891,8,13891,13423,13902,13423,479,13423
10849,55515,55509,54189,1320,54189,54189,55515,53179,2336,53179
10850,13198,13197,13261,-64,13197,13197,13198,12933,265,12933
10851,113670,85019,79690,5329,79690,79690,85011,77134,7877,77134
10852,111196,85218,80738,4480,80738,80738,85244,80338,4906,80338
10853,45750,45586,45507,79,45507,45507,45602,44834,768,44834
10854,105376,85897,85106,791,85106,85106,85894,83090,2804,83090
10855,102511,95262,91498,3764,91498,91498,95281,90949,4332,90949
10856,54113,51164,48989,2175,48989,48989,51166,48752,2414,48752
10857,3124,2775,2971,-196,2775,2775,2779,2763,16,2763
10858,34046,34237,34932,-695,34237,34046,34242,34038,204,34038
10859,28491,21888,20048,1840,20048,20048,21882,18315,3567,18315
10860,73011,64816,64414,402,64414,64414,64856,63377,1479,63377
10861,58638,52688,49505,3183,49505,49505,52720,46161,6559,46161
10862,43421,40243,38994,1249,38994,38994,40259,38956,1303,38956
10863,16224,20096,20223,-127,20096,16224,20097,16200,3897,16200
10864,15222,14776,14723,53,14723,14723,14774,14603,171,14603
10865,18157,18450,18157,293,18157,18157,18445,17941,504,17941
10866,45161,36328,34457,1871,34457,34457,36356,31410,4946,31410
10867,49123,47871,48414,-543,47871,47871,47891,47683,208,47683
10868,4256,3351,3620,-269,3351,3351,3352,3335,17,3335
10869,92339,99882,92315,7567,92315,92315,99883,91633,8250,91633
10870,4588,4160,4143,17,4143,4143,4163,3966,197,3966
10871,203960,185684,176137,9547,176137,176137,185670,174527,11143,174527
10872,26107,25658,26108,-450,25658,25658,25658,21735,3923,21735
10873,140275,125128,120222,4906,120222,120222,125187,119589,5598,119589
10874,15708,12894,12846,48,12846,12846,12894,12684,210,12684
10875,18822,18248,17801,447,17801,17801,18268,17621,647,17621
10876,13837,13792,13539,253,13539,13539,13793,13433,360,13433
10877,48092,48108,47681,427,47681,47681,48092,47133,959,47133
10878,5942,4961,5088,-127,4961,4961,4962,4934,28,4934
10879,6992,7216,7264,-48,7216,6992,7217,6992,225,6992
10880,1197401,1196255,1131990,64265,1131990,1131990,1196280,1119778,76502,1119778
10881,119715,125205,119672,5533,119672,119672,125165,119284,5881,119284
10882,960409,949430,896364,53066,896364,896364,949624,890112,59512,890112
10883,41974,41029,39894,1135,39894,39894,41034,39611,1423,39611
10884,59759,61563,59035,2528,59035,59035,61548,57400,4148,57400
10885,714329,28911,28355,556,28355,28355,28912,27991,921,27991
10886,93744,93690,91839,1851,91839,91839,93744,90091,3653,90091
10887,1446,1008,1214,-206,1008,1008,1008,990,18,990
10888,6329,5471,5599,-128,5471,5471,5473,5429,44,5429
10889,85064,88387,86364,2023,86364,85064,88416,85346,3070,85064
10890,2389,2027,2284,-257,2027,2027,2027,2090,-63,2090
10891,13408,12515,12159,356,12159,12159,12517,11773,744,11773
10892,1338,316,553,-237,316,316,316,362,-46,362
10893,1854,1475,1678,-203,1475,1475,1477,1536,-59,1536
10894,18650,19473,18635,838,18635,18635,19481,18486,995,18486
10895,17668,17111,17330,-219,17111,17111,17114,16552,562,16552
10896,13174,13018,13106,-88,13018,13018,13015,12923,92,12923
10897,2214,1873,2054,-181,1873,1873,1873,1908,-35,1908
10898,11599,11555,11290,265,11290,11290,11560,10977,583,10977
10899,29225,28549,28864,-315,28549,28549,28555,28180,375,28180
10900,190095,188850,180434,8416,180434,180434,188786,179577,9209,179577
10901,47787,48382,47787,595,47787,47787,48381,47503,878,47503
10902,27945,21754,21064,690,21064,21064,21753,20946,807,20946
10903,564420,564230,538375,25855,538375,538375,564420,534747,29673,534747
10904,132399,106943,102888,4055,102888,102888,106979,101802,5177,101802
10905,67292,53175,51068,2107,51068,51068,53173,50427,2746,50427
10906,5093,4772,5092,-320,4772,4772,4768,4776,-8,4776
10907,21524,21517,21480,37,21480,21480,21524,21197,327,21197
10908,3020,2529,2666,-137,2529,2529,2531,2418,113,2418
10909,22036,22039,21010,1029,21010,21010,22036,20882,1154,20882
10910,5677,5197,5339,-142,5197,5197,5195,5099,96,5099
10911,24532,26008,26404,-396,26008,24532,26003,24882,1121,24532
10912,16980,1165,1404,-239,1165,1165,1164,1218,-54,1218
10913,8985,8990,8874,116,8874,8874,8996,8622,374,8622
10914,25083,25669,25078,591,25078,25078,25668,24918,750,24918
10915,36277,36244,35451,793,35451,35451,36259,35145,1114,35145
10916,408,389,629,-240,389,389,389,428,-39,408
10917,43545,42580,40870,1710,40870,40870,42602,40601,2001,40601
10918,187608,164340,160409,3931,160409,160409,164370,159165,5205,159165
10919,4774,4701,4772,-71,4701,4701,4708,4596,112,4596
10920,13745,13762,13430,332,13430,13430,13763,13146,617,13146
10921,300799,285315,270336,14979,270336,270336,285321,267618,17703,267618
10922,59600,50574,50127,447,50127,50127,50595,49544,1051,49544
10923,27343,26140,25676,464,25676,25676,26127,25261,866,25261
10924,16844,16269,15951,318,15951,15951,16268,15860,408,15860
10925,241118,241206,233143,8063,233143,233143,241118,231471,9647,231471
10926,12479,12667,12414,253,12414,12414,12664,12081,583,12081
10927,35633,34788,35975,-1187,34788,34788,34788,29994,4794,29994
10928,223470,197679,186564,11115,186564,186564,197611,184420,13191,184420
10929,15265,14821,14354,467,14354,14354,14824,14238,586,14238
10930,47999,46960,45533,1427,45533,45533,46972,45417,1555,45417
10931,37680,14522,14330,192,14330,14330,14517,14021,496,14021
10932,46112,45466,44164,1302,44164,44164,45449,43978,1471,43978
10933,143933,143042,137856,5186,137856,137856,143104,135422,7682,135422
10934,77990,72905,71363,1542,71363,71363,72974,71067,1907,71067
10935,1085,713,949,-236,713,713,713,767,-54,767
10936,16337,16329,16289,40,16289,16289,16337,15007,1330,15007
10937,6836,6840,6732,108,6732,6732,6836,6630,206,6630
10938,108928,108924,104626,4298,104626,104626,108928,103383,5545,103383
10939,3904,3645,3903,-258,3645,3645,3645,3597,48,3597
10940,8869,8331,8315,16,8315,8315,8328,8094,234,8094
10941,107741,100384,96459,3925,96459,96459,100329,95883,4446,95883
10942,16120,16104,15939,165,15939,15939,16111,15745,366,15745
10943,87284,87262,84263,2999,84263,84263,87284,83472,3812,83472
10944,78426,78412,77611,801,77611,77611,78426,76121,2305,76121
10945,43925,43882,42081,1801,42081,42081,43864,41938,1926,41938
10946,157727,165377,157666,7711,157666,157666,165393,157098,8295,157098
10947,28772,27831,26962,869,26962,26962,27830,26781,1049,26781
10948,3604,3568,3724,-156,3568,3568,3568,3580,-12,3580
10949,41299,40702,39939,763,39939,39939,40709,39376,1333,39376
10950,47451,47422,44033,3389,44033,44033,47451,43731,3720,43731
10951,141908,148806,143482,5324,143482,141908,148853,141908,6945,141908
10952,1211,1004,1211,-207,1004,1004,1004,1043,-39,1043
10953,7015,6561,6593,-32,6561,6561,6562,6393,169,6393
10954,23780,23782,23346,436,23346,23346,23780,22652,1128,22652
10955,10451,10445,10446,-1,10445,10445,10451,10215,236,10215
10956,43030,42301,40732,1569,40732,40732,42315,40303,2012,40303
10957,51235,55933,51149,4784,51149,51149,55947,50103,5844,50103
10958,107641,106739,102752,3987,102752,102752,106708,102620,4088,102620
10959,17587,16676,16758,-82,16676,16676,16671,16421,250,16421
10960,1489242,1488836,1405103,83733,1405103,1405103,1488782,1390668,98114,1390668
10961,2601,2380,2602,-222,2380,2380,2381,2446,-65,2446
10962,11752,11743,11491,252,11491,11491,11752,11398,354,11398
10963,10818,11088,10757,331,10757,10757,11086,10393,693,10393
10964,4506,4165,4346,-181,4165,4165,4166,3884,282,3884
10965,11428,11428,11400,28,11400,11400,11428,11114,314,11114
10966,10784,10782,10906,-124,10782,10782,10784,10287,497,10287
10967,128363,132666,125297,7369,125297,125297,132750,120572,12178,120572
10968,10179,3675,3914,-239,3675,3675,3661,3257,404,3257
10969,75448,77178,75384,1794,75384,75384,77174,75132,2042,75132
10970,78153,75096,76428,-1332,75096,75096,75130,73780,1350,73780
10971,682792,680767,660556,20211,660556,660556,680726,654747,25979,654747
10972,73688,71998,67389,4609,67389,67389,71995,65887,6108,65887
10973,15126,13449,13113,336,13113,13113,13459,12330,1129,12330
10974,10641,10639,10468,171,10468,10468,10641,10314,327,10314
10975,1740,1055,1338,-283,1055,1055,1057,1118,-61,1118
10976,3319,3282,3459,-177,3282,3282,3283,3305,-22,3305
10977,3371,3374,3687,-313,3374,3371,3376,3327,49,3327
10978,6360,5672,5807,-135,5672,5672,5672,5438,234,5438
10979,338027,337095,318401,18694,318401,318401,337125,313797,23328,313797
10980,14029,14050,14026,24,14026,14026,14054,13842,212,13842
10981,433896,417871,404549,13322,404549,404549,418186,399679,18507,399679
10982,3777,3796,4066,-270,3796,3777,3793,3836,-43,3777
10983,1960241,1849379,1787128,62251,1787128,1787128,1849392,1771619,77773,1771619
10984,138847,137903,134770,3133,134770,134770,137893,133427,4466,133427
10985,20838,19996,19766,230,19766,19766,19992,19599,393,19599
10986,8435,8242,8688,-446,8242,8242,8245,8325,-80,8325
10987,11052,9973,9410,563,9410,9410,9973,8989,984,8989
10988,56584,56974,56573,401,56573,56573,57002,54671,2331,54671
10989,47851,50906,47783,3123,47783,47783,50922,47397,3525,47397
10990,18508,19602,18508,1094,18508,18508,19602,17129,2473,17129
10991,266319,249851,250643,-792,249851,249851,249904,246780,3124,246780
10992,4064,3693,3882,-189,3693,3693,3693,3687,6,3687
10993,1020,992,1280,-288,992,992,994,1020,-26,1020
10994,5528,5140,5296,-156,5140,5140,5141,5125,16,5125
10995,54142,54148,52148,2000,52148,52148,54142,49199,4943,49199
10996,72356,71377,68347,3030,68347,68347,71401,65090,6311,65090
10997,1859,1860,2122,-262,1860,1859,1859,1893,-34,1859
10998,20972,21529,20919,610,20919,20919,21543,20350,1193,20350
10999,13437,11341,11240,101,11240,11240,11343,11177,166,11177
11000,137345,140846,137345,3501,137345,137345,140856,136744,4112,136744
11001,396072,392852,380204,12648,380204,380204,392910,379611,13299,379611
11002,10605,10167,10191,-24,10167,10167,10168,9974,194,9974
11003,5974,5697,5974,-277,5697,5697,5696,5507,189,5507
11004,36789,38093,36837,1256,36837,36789,38105,36576,1529,36576
11005,503,503,749,-246,503,503,503,554,-51,503
11006,63250,60733,59888,845,59888,59888,60738,58888,1850,58888
11007,74620,72501,71480,1021,71480,71480,72513,70842,1671,70842
11008,1345329,1317656,1235840,81816,1235840,1235840,1317922,1233145,84777,1233145
11009,31217,31205,29964,1241,29964,29964,31223,29605,1618,29605
11010,5727,5722,5666,56,5666,5666,5718,5578,140,5578
11011,16762,17193,16761,432,16761,16761,17201,16651,550,16651
11012,248879,247948,239441,8507,239441,239441,248022,237198,10824,237198
11013,159780,158852,147758,11094,147758,147758,158855,145792,13063,145792
11014,134329,138256,134779,3477,134779,134329,138248,134321,3927,134321
11015,381922,365108,347855,17253,347855,347855,365129,346075,19054,346075
11016,159,159,280,-121,159,159,159,170,-11,159
11017,56978,56144,54354,1790,54354,54354,56145,54153,1992,54153
11018,66510,67264,66719,545,66719,66510,67284,66502,782,66502
11019,49033,46559,43192,3367,43192,43192,46544,42903,3641,42903
11020,822463,787572,775730,11842,775730,775730,787526,756036,31490,756036
11021,13467,12574,12239,335,12239,12239,12570,12110,460,12110
11022,59471,58518,56278,2240,56278,56278,58520,55682,2838,55682
11023,196551,194174,192694,1480,192694,192694,194190,190052,4138,190052
11024,28332,28361,27669,692,27669,27669,28332,27513,819,27513
11025,2522653,2595178,2554127,41051,2554127,2522653,2594987,2522478,72509,2522478
11026,31639,30910,30520,390,30520,30520,30915,30290,625,30290
11027,78236,51634,50060,1574,50060,50060,51645,49439,2206,49439
11028,21492,21452,21480,-28,21452,21452,21463,21095,368,21095
11029,76582,78915,75422,3493,75422,75422,78937,75159,3778,75159
11030,6204,6723,6960,-237,6723,6204,6725,6171,554,6171
11031,16665,16664,16226,438,16226,16226,16667,15995,672,15995
11032,24264,24493,24195,298,24195,24195,24522,23430,1092,23430
11033,16033,15972,15661,311,15661,15661,15972,15531,441,15531
11034,8424,8391,8308,83,8308,8308,8391,8143,248,8143
11035,38744,36859,35452,1407,35452,35452,36870,35168,1702,35168
11036,15574,16071,15677,394,15677,15574,16070,15566,504,15566
11037,30585,31110,30516,594,30516,30516,31103,30388,715,30388
11038,100382,75879,73240,2639,73240,73240,75868,71815,4053,71815
11039,2206,2003,2206,-203,2003,2003,2005,2010,-5,2010
11040,28467,27915,27198,717,27198,27198,27913,26981,932,26981
11041,15229,14676,14366,310,14366,14366,14675,14115,560,14115
11042,34789,37627,35567,2060,35567,34789,37625,34167,3458,34167
11043,172795,172674,162037,10637,162037,162037,172734,161037,11697,161037
11044,9876,9881,9624,257,9624,9624,9876,9442,434,9442
11045,284084,274791,263175,11616,263175,263175,274935,262453,12482,262453
11046,158753,145798,141784,4014,141784,141784,145830,141106,4724,141106
11047,23485,22275,22372,-97,22275,22275,22281,21679,602,21679
11048,313268,292354,279465,12889,279465,279465,292405,277881,14524,277881
11049,46826,22791,22311,480,22311,22311,22799,22108,691,22108
11050,124971,122496,118268,4228,118268,118268,122532,117262,5270,117262
11051,2035,1135,1342,-207,1135,1135,1136,1185,-49,1185
11052,12332,11826,12003,-177,11826,11826,11822,11676,146,11676
11053,37010,36167,35115,1052,35115,35115,36179,34749,1430,34749
11054,459899,433269,411262,22007,411262,411262,433272,409249,24023,409249
11055,139305,133450,127690,5760,127690,127690,133513,125808,7705,125808
11056,106936,106075,101002,5073,101002,101002,106100,100578,5522,100578
11057,17543,15501,15319,182,15319,15319,15501,14867,634,14867
11058,3970,4125,4199,-74,4125,3970,4126,3942,184,3942
11059,75505,79167,74944,4223,74944,74944,79172,73945,5227,73945
11060,7162,6897,7101,-204,6897,6897,6900,6644,256,6644
11061,33422,35856,33359,2497,33359,33359,35863,33044,2819,33044
11062,3038,2613,2769,-156,2613,2613,2614,2569,45,2569
11063,307779,306661,297731,8930,297731,297731,306757,294767,11990,294767
11064,5539,5558,5359,199,5359,5359,5557,4735,822,4735
11065,20171,19394,19402,-8,19394,19394,19394,19030,364,19030
11066,32921,33841,32849,992,32849,32849,33848,32239,1609,32239
11067,14019,14158,14003,155,14003,14003,14167,13595,572,13595
11068,14588,13713,12817,896,12817,12817,13720,12557,1163,12557
11069,264493,260894,247431,13463,247431,247431,260829,243932,16897,243932
11070,40433,39734,39185,549,39185,39185,39755,38743,1012,38743
11071,86850,84431,79053,5378,79053,79053,84455,78945,5510,78945
11072,92093,91112,83539,7573,83539,83539,91181,78809,12372,78809
11073,18219,18464,18454,10,18454,18219,18461,18236,225,18219
11074,220644,220591,209444,11147,209444,209444,220644,205099,15545,205099
11075,123843,119891,115644,4247,115644,115644,119875,114868,5007,114868
11076,18478,18487,18472,15,18472,18472,18496,17796,700,17796
11077,18391,17562,17066,496,17066,17066,17573,16701,872,16701
11078,214996,192576,192638,-62,192576,192576,192682,187504,5178,187504
11079,2165,2165,2354,-189,2165,2165,2165,2221,-56,2165
11080,27614,22220,21353,867,21353,21353,22230,19806,2424,19806
11081,73055,72191,71584,607,71584,71584,72210,69199,3011,69199
11082,136174,101640,96372,5268,96372,96372,101699,94183,7516,94183
11083,9498,9065,8987,78,8987,8987,9070,8797,273,8797
11084,4577,4081,4154,-73,4081,4081,4083,3939,144,3939
11085,2529,2139,2342,-203,2139,2139,2140,2189,-49,2189
11086,183927,179412,174988,4424,174988,174988,179340,173424,5916,173424
11087,25753,25711,25100,611,25100,25100,25704,24875,829,24875
11088,23236,22641,22141,500,22141,22141,22670,21148,1522,21148
11089,10462,10724,10462,262,10462,10462,10730,10406,324,10406
11090,303080,315434,306802,8632,306802,303080,315443,303072,12371,303072
11091,99013,102611,98994,3617,98994,98994,102645,97617,5028,97617
11092,21609,19463,19122,341,19122,19122,19475,18147,1328,18147
11093,49698,27862,26837,1025,26837,26837,27864,26913,951,26913
11094,12468,1756,2034,-278,1756,1756,1757,1800,-43,1800
11095,952,284,518,-234,284,284,284,330,-46,330
11096,35560,16084,15535,549,15535,15535,16078,14614,1464,14614
11097,70999,70347,65479,4868,65479,65479,70337,65376,4961,65376
11098,74552,77850,74536,3314,74536,74536,77860,74079,3781,74079
11099,32379,31735,30794,941,30794,30794,31759,30455,1304,30455
11100,172420,171436,162598,8838,162598,162598,171436,161641,9795,161641
11101,33665,8265,8015,250,8015,8015,8266,7884,382,7884
11102,195468,182856,177478,5378,177478,177478,182921,175575,7346,175575
11103,24318,24819,24245,574,24245,24245,24811,24054,757,24054
11104,19778,19957,19188,769,19188,19188,19944,19139,805,19139
11105,63128,62324,60324,2000,60324,60324,62306,60187,2119,60187
11106,52378,53325,52370,955,52370,52370,53332,52363,969,52363
11107,174658,173249,170266,2983,170266,170266,173180,169028,4152,169028
11108,44903,42198,42848,-650,42198,42198,42196,41994,202,41994
11109,34147,32495,31115,1380,31115,31115,32495,30682,1813,30682
11110,58944,62099,58936,3163,58936,58936,62151,58617,3534,58617
11111,4975,4420,4621,-201,4420,4420,4421,4432,-11,4432
11112,32619,28587,27505,1082,27505,27505,28587,27095,1492,27095
11113,78273,34760,33616,1144,33616,33616,34761,31997,2764,31997
11114,12053,12384,12162,222,12162,12053,12386,11861,525,11861
11115,91352,56701,54491,2210,54491,54491,56697,53953,2744,53953
11116,5043,4099,4215,-116,4099,4099,4098,4041,57,4041
11117,387870,412354,387750,24604,387750,387750,412204,385261,26943,385261
11118,55745,28189,27389,800,27389,27389,28198,27132,1066,27132
11119,4822,4759,4819,-60,4759,4759,4761,4704,57,4704
11120,129353,136914,136408,506,136408,129353,136914,129345,7569,129345
11121,129086,117566,114589,2977,114589,114589,117594,112836,4758,112836
11122,39362,16646,16535,111,16535,16535,16656,16465,191,16465
11123,12156,11609,11469,140,11469,11469,11619,11311,308,11311
11124,104510,107599,106129,1470,106129,104510,107640,104510,3130,104510
11125,69485,68639,65982,2657,65982,65982,68645,65578,3067,65578
11126,179401,176011,170710,5301,170710,170710,176043,169740,6303,169740
11127,14300,13755,13463,292,13463,13463,13753,13282,471,13282
11128,6935,6933,6804,129,6804,6804,6935,6391,544,6391
11129,75512,75325,73185,2140,73185,73185,75324,72728,2596,72728
11130,13097,13092,13014,78,13014,13014,13099,12744,355,12744
11131,59663,45228,42337,2891,42337,42337,45230,41507,3723,41507
11132,9987,9342,9280,62,9280,9280,9339,9085,254,9085
11133,84975,83277,82178,1099,82178,82178,83290,81656,1634,81656
11134,8938,8932,9071,-139,8932,8932,8938,8780,158,8780
11135,244581,244022,230645,13377,230645,230645,244027,230102,13925,230102
11136,43865,4375,4667,-292,4375,4375,4378,4209,169,4209
11137,21714,20712,19933,779,19933,19933,20723,19881,842,19881
11138,93879,93581,91112,2469,91112,91112,93573,91056,2517,91056
11139,12127,11134,11096,38,11096,11096,11135,10889,246,10889
11140,36782,35862,34435,1427,34435,34435,35878,32339,3539,32339
11141,3225,2549,2782,-233,2549,2549,2546,2603,-57,2603
11142,149869,155944,150326,5618,150326,149869,155966,149869,6097,149869
11143,148495,151916,151322,594,151322,148495,152022,149457,2565,148495
11144,2763,2763,2944,-181,2763,2763,2763,2785,-22,2763
11145,12237,12229,12246,-17,12229,12229,12237,11970,267,11970
11146,14453,14874,14452,422,14452,14452,14877,14389,488,14389
11147,144653,144055,142197,1858,142197,142197,144076,140920,3156,140920
11148,19701,19701,19507,194,19507,19507,19701,19147,554,19147
11149,31645,33723,31658,2065,31658,31645,33742,31023,2719,31023
11150,18738,18726,18639,87,18639,18639,18738,18481,257,18481
11151,42149,41330,40258,1072,40258,40258,41318,40071,1247,40071
11152,497,478,722,-244,478,478,478,523,-45,497
11153,59884,53594,50531,3063,50531,50531,53609,49542,4067,49542
11154,101294,106079,100683,5396,100683,100683,106136,100361,5775,100361
11155,31369,31366,30511,855,30511,30511,31387,29875,1512,29875
11156,62252,63065,63591,-526,63065,62252,63089,62244,845,62244
11157,14009,14020,13936,84,13936,13936,14009,13466,543,13466
11158,6117,5208,5301,-93,5208,5208,5210,4793,417,4793
11159,11320,10747,10821,-74,10747,10747,10754,10612,142,10612
11160,1973,1845,2043,-198,1845,1845,1848,1871,-23,1871
11161,6220,5598,5718,-120,5598,5598,5600,5415,185,5415
11162,17211,17156,16416,740,16416,16416,17156,16208,948,16208
11163,144432,142250,134705,7545,134705,134705,142273,134403,7870,134403
11164,28702,29048,29033,15,29033,28702,29053,28702,351,28702
11165,253993,231207,223791,7416,223791,223791,231344,223180,8164,223180
11166,55472,43136,42680,456,42680,42680,43156,41945,1211,41945
11167,37502,38040,37502,538,37502,37502,38038,36343,1695,36343
11168,27167,26634,25340,1294,25340,25340,26638,25201,1437,25201
11169,10191,10490,10558,-68,10490,10191,10497,10191,306,10191
11170,44577,43736,42425,1311,42425,42425,43734,41906,1828,41906
11171,349,349,590,-241,349,349,349,397,-48,349
11172,13538,14209,13991,218,13991,13538,14217,13538,679,13538
11173,4505,4519,4830,-311,4519,4505,4521,4558,-37,4505
11174,34994,34079,33049,1030,33049,33049,34070,32833,1237,32833
11175,696026,672238,640551,31687,640551,640551,672392,630866,41526,630866
11176,83034,35440,33800,1640,33800,33800,35445,33703,1742,33703
11177,227738,222095,210893,11202,210893,210893,222009,210143,11866,210143
11178,59338,58520,57885,635,57885,57885,58495,57168,1327,57168
11179,143224,113605,109773,3832,109773,109773,113675,108794,4881,108794
11180,89623,70449,69098,1351,69098,69098,70429,68164,2265,68164
11181,18389,5235,5394,-159,5235,5235,5234,5246,-12,5246
11182,19796,19695,19297,398,19297,19297,19703,19174,529,19174
11183,7363,7381,7326,55,7326,7326,7381,7131,250,7131
11184,386106,342229,325114,17115,325114,325114,342462,314170,28292,314170
11185,153368,159210,149996,9214,149996,149996,159181,148183,10998,148183
11186,76201,56344,55132,1212,55132,55132,56342,55062,1280,55062
11187,1899788,22996,22366,630,22366,22366,22997,22041,956,22041
11188,40720,36036,35131,905,35131,35131,36039,34941,1098,34941
11189,9296,9271,9358,-87,9271,9271,9278,9192,86,9192
11190,945417,940515,888512,52003,888512,888512,940220,885875,54345,885875
11191,2187,1239,1448,-209,1239,1239,1241,1294,-53,1294
11192,8328,7672,7651,21,7651,7651,7677,7421,256,7421
11193,87378,87400,86099,1301,86099,86099,87378,85069,2309,85069
11194,16674,16493,16043,450,16043,16043,16495,15933,562,15933
11195,124244,121265,118066,3199,118066,118066,121237,117412,3825,117412
11196,284137,256829,256026,803,256026,256026,257056,252227,4829,252227
11197,544234,501373,474583,26790,474583,474583,501452,472076,29376,472076
11198,2275,2274,2457,-183,2274,2274,2275,2337,-62,2275
11199,2121,2122,2298,-176,2122,2121,2121,2152,-31,2121
11200,1418,1418,1602,-184,1418,1418,1418,1451,-33,1418
11201,160725,130467,129972,495,129972,129972,130460,129812,648,129812
11202,1496,1499,1733,-234,1499,1496,1496,1551,-55,1496
11203,100043,92252,88409,3843,88409,88409,92277,88047,4230,88047
11204,43378,46053,43164,2889,43164,43164,46052,42323,3729,42323
11205,8351,8314,8295,19,8295,8295,8313,8174,139,8174
11206,28670,27749,26263,1486,26263,26263,27752,25994,1758,25994
11207,22388,21755,20866,889,20866,20866,21767,20743,1024,20743
11208,1832,1832,2038,-206,1832,1832,1832,1878,-46,1832
11209,5303,5147,5242,-95,5147,5147,5145,5074,71,5074
11210,4910,4911,4988,-77,4911,4910,4910,4921,-11,4910
11211,21641,9982,9917,65,9917,9917,9976,9546,430,9546
11212,1208,1208,1463,-255,1208,1208,1208,1259,-51,1208
11213,3106,2682,2842,-160,2682,2682,2685,2637,48,2637
11214,1865340,1826991,1740922,86069,1740922,1740922,1826745,1720271,106474,1720271
11215,5633,5293,5573,-280,5293,5293,5289,5228,61,5228
11216,18911,18812,19100,-288,18812,18812,18807,18578,229,18578
11217,60546,55616,54682,934,54682,54682,55659,53277,2382,53277
11218,10625,10593,10338,255,10338,10338,10601,9830,771,9830
11219,3978,3580,3701,-121,3580,3580,3583,3581,2,3581
11220,62048,61143,60592,551,60592,60592,61126,57792,3334,57792
11221,49137,46574,42801,3773,42801,42801,46578,42077,4501,42077
11222,9407,8431,8272,159,8272,8272,8430,8219,211,8219
11223,10450,9487,8897,590,8897,8897,9496,8272,1224,8272
11224,19627,18850,18293,557,18293,18293,18856,18084,772,18084
11225,82897,80160,75615,4545,75615,75615,80148,74493,5655,74493
11226,2672,2429,2611,-182,2429,2429,2431,2470,-39,2470
11227,42360,42251,41596,655,41596,41596,42279,40822,1457,40822
11228,36343,37787,36342,1445,36342,36342,37805,36188,1617,36188
11229,214311,216235,210803,5432,210803,210803,216273,207390,8883,207390
11230,63484,63788,63482,306,63482,63482,63771,61224,2547,61224
11231,1419,1419,1612,-193,1419,1419,1419,1456,-37,1419
11232,31384,30267,28961,1306,28961,28961,30254,28897,1357,28897
11233,18752,7719,7697,22,7697,7697,7719,7269,450,7269
11234,8189,8420,8652,-232,8420,8189,8423,8174,249,8174
11235,2155,1314,1556,-242,1314,1314,1314,1356,-42,1356
11236,96506,99120,95700,3420,95700,95700,99096,95286,3810,95286
11237,3556,3407,3555,-148,3407,3407,3413,3314,99,3314
11238,4519,4438,4520,-82,4438,4438,4438,4310,128,4310
11239,15615,14704,14466,238,14466,14466,14705,14427,278,14427
11240,13742,13307,13430,-123,13307,13307,13312,13172,140,13172
11241,5681,4841,4965,-124,4841,4841,4849,4816,33,4816
11242,12488,12074,11948,126,11948,11948,12085,11757,328,11757
11243,227995,227884,219314,8570,219314,219314,227790,217718,10072,217718
11244,24433,24432,24064,368,24064,24064,24433,23819,614,23819
11245,8481,8072,7901,171,7901,7901,8081,7799,282,7799
11246,26460,19297,18911,386,18911,18911,19303,18748,555,18748
11247,34443,29640,28073,1567,28073,28073,29638,27514,2124,27514
11248,95420,98584,95510,3074,95510,95420,98613,94798,3815,94798
11249,5916,5374,5453,-79,5374,5374,5375,5292,83,5292
11250,96906,85558,80877,4681,80877,80877,85562,79974,5588,79974
11251,25538,24315,23331,984,23331,23331,24315,23227,1088,23227
11252,126792,127299,128797,-1498,127299,126792,127347,126784,563,126784
11253,1429,1429,1651,-222,1429,1429,1429,1475,-46,1429
11254,99156,81554,79997,1557,79997,79997,81590,78469,3121,78469
11255,2248,2130,2404,-274,2130,2130,2130,2201,-71,2201
11256,82385,59973,57038,2935,57038,57038,60003,55822,4181,55822
11257,34428,35652,34434,1218,34434,34428,35639,34197,1442,34197
11258,17233,16149,16080,69,16080,16080,16156,15476,680,15476
11259,434298,470488,441907,28581,441907,434298,470753,434308,36445,434298
11260,13402,13401,13286,115,13286,13286,13402,13073,329,13073
11261,396473,395492,382900,12592,382900,382900,395505,380828,14677,380828
11262,5478,5198,5424,-226,5198,5198,5198,5198,0,5198
11263,33956,32696,31443,1253,31443,31443,32714,30667,2047,30667
11264,58459,58471,55665,2806,55665,55665,58459,55591,2868,55591
11265,725,725,978,-253,725,725,725,783,-58,725
11266,167926,166931,161729,5202,161729,161729,166955,158777,8178,158777
11267,19153,19706,19173,533,19173,19153,19721,19032,689,19032
11268,25579,24758,23788,970,23788,23788,24758,23534,1224,23534
11269,142328,141025,135244,5781,135244,135244,141005,134898,6107,134898
11270,80830,78723,78134,589,78134,78134,78753,77335,1418,77335
11271,928,689,928,-239,689,689,689,742,-53,742
11272,13041,12730,12580,150,12580,12580,12733,12334,399,12334
11273,8178,7791,7759,32,7759,7759,7790,7605,185,7605
11274,30007,29961,29154,807,29154,29154,29967,28361,1606,28361
11275,204476,199896,191342,8554,191342,191342,199901,189653,10248,189653
11276,36955,36131,34964,1167,34964,34964,36130,34715,1415,34715
11277,3322,3321,3528,-207,3321,3321,3322,3331,-9,3322
11278,118769,115268,108879,6389,108879,108879,115286,107994,7292,107994
11279,1807,880,1129,-249,880,880,880,931,-51,931
11280,147315,145808,138505,7303,138505,138505,145798,138353,7445,138353
11281,375540,361766,351898,9868,351898,351898,361739,347635,14104,347635
11282,17815,18843,17813,1030,17813,17813,18844,17231,1613,17231
11283,38368,38355,37988,367,37988,37988,38368,37530,838,37530
11284,72164,47907,47047,860,47047,47047,47907,44097,3810,44097
11285,1176,1175,1387,-212,1175,1175,1176,1218,-42,1176
11286,27776,27774,27771,3,27771,27771,27780,27291,489,27291
11287,14522,13581,13590,-9,13581,13581,13581,12673,908,12673
11288,1545,1544,1762,-218,1544,1544,1545,1607,-62,1545
11289,50896,17734,17616,118,17616,17616,17736,17462,274,17462
11290,22207,22208,21386,822,21386,21386,22207,20964,1243,20964
11291,506541,506288,485799,20489,485799,485799,506332,483279,23053,483279
11292,80668,63224,59864,3360,59864,59864,63243,59128,4115,59128
11293,2490,2494,2735,-241,2494,2490,2496,2532,-36,2490
11294,27290,27245,27342,-97,27245,27245,27244,26178,1066,26178
11295,1984,1985,2177,-192,1985,1984,1984,2046,-62,1984
11296,14355,14355,14043,312,14043,14043,14355,13992,363,13992
11297,10707,1512,1782,-270,1512,1512,1513,1572,-59,1572
11298,89646,86682,81058,5624,81058,81058,86653,80909,5744,80909
11299,33365,33355,31967,1388,31967,31967,33365,31901,1464,31901
11300,9269,8848,8608,240,8608,8608,8846,8491,355,8491
11301,18184,16973,16533,440,16533,16533,16973,16150,823,16150
11302,118868,96819,91096,5723,91096,91096,96807,90442,6365,90442
11303,37277,36345,37505,-1160,36345,36345,36356,31404,4952,31404
11304,1883,935,1172,-237,935,935,935,985,-50,985
11305,104533,78405,75639,2766,75639,75639,78421,75185,3236,75185
11306,1883,935,1172,-237,935,935,935,985,-50,985
11307,1883,935,1172,-237,935,935,935,985,-50,985
11308,91057,90183,91479,-1296,90183,90183,90279,84299,5980,84299
11309,100967,99585,98666,919,98666,98666,99560,96672,2888,96672
11310,340552,357894,342755,15139,342755,340552,357820,340192,17628,340192
11311,25634,24281,23244,1037,23244,23244,24265,23083,1182,23083
11312,57445,29716,29444,272,29444,29444,29721,28925,796,28925
11313,18290,13734,12917,817,12917,12917,13739,12464,1275,12464
11314,5870,5866,5764,102,5764,5764,5870,5544,326,5544
11315,22982,22991,23022,-31,22991,22982,22982,22523,459,22523
11316,32063,31803,31863,-60,31803,31803,31814,31441,373,31441
11317,10783,10788,10681,107,10681,10681,10783,10549,234,10549
11318,78542,81110,78542,2568,78542,78542,81125,77497,3628,77497
11319,37498,37453,36222,1231,36222,36222,37498,36050,1448,36050
11320,27848,25968,24748,1220,24748,24748,25963,24586,1377,24586
11321,6033,6030,6048,-18,6030,6030,6033,5644,389,5644
11322,376468,340420,323595,16825,323595,323595,340546,318932,21614,318932
11323,113066,112518,105278,7240,105278,105278,112512,104401,8111,104401
11324,256929,239344,227604,11740,227604,227604,239260,224019,15241,224019
11325,953359,940773,887417,53356,887417,887417,940875,881958,58917,881958
11326,108733,71719,68914,2805,68914,68914,71729,68377,3352,68377
11327,67477,64554,61969,2585,61969,61969,64552,61840,2712,61840
11328,536806,507702,486291,21411,486291,486291,507769,469437,38332,469437
11329,89298,88482,86862,1620,86862,86862,88527,85955,2572,85955
11330,3584,3179,3423,-244,3179,3179,3181,3220,-39,3220
11331,40344,39719,38679,1040,38679,38679,39722,38525,1197,38525
11332,63092,51442,50303,1139,50303,50303,51451,49276,2175,49276
11333,342219,338158,320428,17730,320428,320428,338331,319720,18611,319720
11334,27871,26545,26118,427,26118,26118,26528,25897,631,25897
11335,23090,22615,22161,454,22161,22161,22621,22066,555,22066
11336,19551,19650,19543,107,19543,19543,19668,18353,1315,18353
11337,9526,8723,8655,68,8655,8655,8720,8609,111,8609
11338,4366,4210,4366,-156,4210,4210,4210,4123,87,4123
11339,3932,3537,3757,-220,3537,3537,3538,3504,34,3504
11340,1661,1661,1887,-226,1661,1661,1661,1725,-64,1661
11341,233743,230589,218253,12336,218253,218253,230581,216006,14575,216006
11342,143643,141893,143733,-1840,141893,141893,141913,141344,569,141344
11343,117478,100497,96235,4262,96235,96235,100493,95454,5039,95454
11344,528,528,653,-125,528,528,528,539,-11,528
11345,2625,2178,2429,-251,2178,2178,2179,2199,-20,2199
11346,143856,143782,138931,4851,138931,138931,143772,138207,5565,138207
11347,6696,3631,3740,-109,3631,3631,3630,3588,42,3588
11348,3803,3515,3740,-225,3515,3515,3520,3382,138,3382
11349,176127,180023,175962,4061,175962,175962,180032,175505,4527,175505
11350,110946,110980,103412,7568,103412,103412,110946,102852,8094,102852
11351,8579,7965,8143,-178,7965,7965,7967,7769,198,7769
11352,1326,1519,1501,18,1501,1326,1520,1326,194,1326
11353,42331,41227,39733,1494,39733,39733,41223,39538,1685,39538
11354,22375,22382,21518,864,21518,21518,22375,21372,1003,21372
11355,13468,12919,12757,162,12757,12757,12914,12382,532,12382
11356,78715,66414,64571,1843,64571,64571,66412,63686,2726,63686
11357,45847,45283,44572,711,44572,44572,45293,44321,972,44321
11358,1929,1552,1767,-215,1552,1552,1552,1607,-55,1607
11359,259062,257126,250225,6901,250225,250225,257074,249236,7838,249236
11360,65428,65458,66815,-1357,65458,65428,65453,64433,1020,64433
11361,44156,42169,39962,2207,39962,39962,42141,39858,2283,39858
11362,140385,146215,140781,5434,140781,140385,146200,140352,5848,140352
11363,59303,62975,59272,3703,59272,59272,62970,57363,5607,57363
11364,13750,4355,4433,-78,4355,4355,4356,3997,359,3997
11365,36612,35759,35328,431,35328,35328,35761,35160,601,35160
11366,32471,31701,30291,1410,30291,30291,31708,30222,1486,30222
11367,410,410,652,-242,410,410,410,460,-50,410
11368,3959,3158,3376,-218,3158,3158,3154,3198,-44,3198
11369,2045,2043,2235,-192,2043,2043,2045,2087,-42,2045
11370,8799,8801,8931,-130,8801,8799,8799,8476,323,8476
11371,35769,35165,33764,1401,33764,33764,35198,33624,1574,33624
11372,2014,1597,1839,-242,1597,1597,1596,1657,-61,1657
11373,15615,14774,14726,48,14726,14726,14772,14493,279,14493
11374,134886,122566,116613,5953,116613,116613,122630,114964,7666,114964
11375,70066,48646,46692,1954,46692,46692,48661,46456,2205,46456
11376,21797,21795,20906,889,20906,20906,21797,20490,1307,20490
11377,5602,5047,5091,-44,5047,5047,5048,4806,242,4806
11378,50050,51927,50302,1625,50302,50050,51934,50119,1815,50050
11379,10472,10472,10441,31,10441,10441,10472,10336,136,10336
11380,34929,35389,35122,267,35122,34929,35385,34921,464,34921
11381,2590,2593,2803,-210,2593,2590,2590,2430,160,2430
11382,1639,1603,1816,-213,1603,1603,1602,1662,-60,1639
11383,28255,28234,27399,835,27399,27399,28255,27134,1121,27134
11384,8515,7954,8113,-159,7954,7954,7961,7874,87,7874
11385,30771,28410,27468,942,27468,27468,28406,27249,1157,27249
11386,244868,193347,188740,4607,188740,188740,193422,186483,6939,186483
11387,60939,60932,57743,3189,57743,57743,60939,57564,3375,57564
11388,20585,17954,16936,1018,16936,16936,17959,16755,1204,16755
11389,32225,29952,28382,1570,28382,28382,29956,28259,1697,28259
11390,7044,6423,6648,-225,6423,6423,6423,6415,8,6415
11391,122603,122497,121651,846,121651,121651,122603,120163,2440,120163
11392,52858,51302,52590,-1288,51302,51302,51340,51388,-48,51388
11393,14212,14220,13798,422,13798,13798,14222,13707,515,13707
11394,110328,103626,101345,2281,101345,101345,103680,99710,3970,99710
11395,673507,652030,617563,34467,617563,617563,651939,615320,36619,615320
11396,80286,41546,39643,1903,39643,39643,41544,39318,2226,39318
11397,72830,72789,71153,1636,71153,71153,72830,70417,2413,70417
11398,44779,40256,39328,928,39328,39328,40260,38954,1306,38954
11399,35264,35174,34526,648,34526,34526,35160,32970,2190,32970
11400,311219,308085,290007,18078,290007,290007,308057,288552,19505,288552
11401,68806,70747,68200,2547,68200,68200,70757,67883,2874,67883
11402,11925,11124,10502,622,10502,10502,11119,10113,1006,10113
11403,87114,91602,87019,4583,87019,87019,91576,86426,5150,86426
11404,88699,88156,85001,3155,85001,85001,88157,84532,3625,84532
11405,18139,18309,17622,687,17622,17622,18306,17517,789,17517
11406,65298,53835,51042,2793,51042,51042,53862,48669,5193,48669
11407,55797,54962,55293,-331,54962,54962,54977,52443,2534,52443
11408,14171,14287,14381,-94,14287,14171,14289,14172,117,14171
11409,11762,11359,11218,141,11218,11218,11353,11066,287,11066
11410,2635,2635,2853,-218,2635,2635,2635,2651,-16,2635
11411,18972,18118,18061,57,18061,18061,18125,17797,328,17797
11412,145360,145371,139033,6338,139033,139033,145360,138100,7260,138100
11413,66088,59525,55531,3994,55531,55531,59510,54919,4591,54919
11414,65639,68659,65568,3091,65568,65568,68670,64584,4086,64584
11415,549,463,698,-235,463,463,463,511,-48,511
11416,32070,32023,31698,325,31698,31698,32028,31179,849,31179
11417,13176,13825,13174,651,13174,13174,13832,12939,893,12939
11418,466390,415123,400658,14465,400658,400658,415257,397781,17476,397781
11419,302521,291902,280877,11025,280877,280877,292145,277250,14895,277250
11420,18463,18893,18457,436,18457,18457,18897,18158,739,18158
11421,27352,26941,27349,-408,26941,26941,26940,26765,175,26765
11422,10180,10214,10231,-17,10214,10180,10221,9971,250,9971
11423,573588,523316,495335,27981,495335,495335,523550,490468,33082,490468
11424,4252,4252,4461,-209,4252,4252,4252,4266,-14,4252
11425,35326,35279,34908,371,34908,34908,35281,34501,780,34501
11426,35700,30978,29560,1418,29560,29560,30986,29079,1907,29079
11427,4425,1263,1508,-245,1263,1263,1263,1317,-54,1317
11428,160198,160102,154579,5523,154579,154579,160198,152760,7438,152760
11429,103624,101047,94155,6892,94155,94155,101079,93645,7434,93645
11430,64889,64069,62000,2069,62000,62000,64103,61819,2284,61819
11431,27475,28644,28334,310,28334,27475,28649,27429,1220,27429
11432,4135,3728,3990,-262,3728,3728,3732,3793,-61,3793
11433,3909,3913,3892,21,3892,3892,3909,3681,228,3681
11434,17086,16223,15200,1023,15200,15200,16231,14486,1745,14486
11435,15083,14226,13966,260,13966,13966,14232,13832,400,13832
11436,356456,337803,319997,17806,319997,319997,337917,318093,19824,318093
11437,9940,9943,9557,386,9557,9557,9940,9460,480,9460
11438,11827,12005,11828,177,11828,11827,12009,11682,327,11682
11439,6318,6005,6062,-57,6005,6005,6000,5905,95,5905
11440,28334,29225,28336,889,28336,28334,29218,28237,981,28237
11441,8026,7223,7155,68,7155,7155,7222,6768,454,6768
11442,142181,138155,137026,1129,137026,137026,138238,128655,9583,128655
11443,165675,164627,159926,4701,159926,159926,164743,158748,5995,158748
11444,3142,3142,3360,-218,3142,3142,3142,3129,13,3129
11445,25776,18785,18373,412,18373,18373,18781,18100,681,18100
11446,4725,4209,4267,-58,4209,4209,4211,4068,143,4068
11447,55249,43162,42257,905,42257,42257,43174,38766,4408,38766
11448,1097728,1097321,1063031,34290,1063031,1063031,1097981,1054754,43227,1054754
11449,5619,4990,5196,-206,4990,4990,4992,4997,-5,4997
11450,43771,42398,40679,1719,40679,40679,42386,40330,2056,40330
11451,4392,846,1080,-234,846,846,846,905,-59,905
11452,7006,6763,6953,-190,6763,6763,6764,6746,18,6746
11453,9781,9783,9427,356,9427,9427,9781,9342,439,9342
11454,76966,76100,76075,25,76075,76075,76124,74322,1802,74322
11455,16411,15853,15566,287,15566,15566,15857,15304,553,15304
11456,29740,23551,22352,1199,22352,22352,23564,22165,1399,22165
11457,157642,122081,116312,5769,116312,116312,122100,114615,7485,114615
11458,13988,13987,14226,-239,13987,13987,13988,13900,88,13900
11459,40508,39843,38347,1496,38347,38347,39840,38207,1633,38207
11460,16942,17471,17412,59,17412,16942,17490,17070,420,16942
11461,10938,9455,9507,-52,9455,9455,9453,9360,93,9360
11462,71258,71050,68892,2158,68892,68892,71074,68608,2466,68608
11463,28280,24287,23720,567,23720,23720,24278,23439,839,23439
11464,34198,33194,33353,-159,33194,33194,33199,32694,505,32694
11465,3293,2455,2630,-175,2455,2455,2458,2475,-17,2475
11466,3026,2629,2765,-136,2629,2629,2629,2534,95,2534
11467,2679,2617,2800,-183,2617,2617,2618,2647,-29,2647
11468,19740,20508,19673,835,19673,19673,20513,19124,1389,19124
11469,27496,28626,27485,1141,27485,27485,28621,27410,1211,27410
11470,15218,15214,14996,218,14996,14996,15218,14804,414,14804
11471,8878,7951,7942,9,7942,7942,7951,7841,110,7841
11472,114645,108048,101222,6826,101222,101222,108086,101037,7049,101037
11473,117624,116734,113611,3123,113611,113611,116717,112522,4195,112522
11474,5003,4486,4678,-192,4486,4486,4488,4454,34,4454
11475,36295,37323,36580,743,36580,36295,37330,36295,1035,36295
11476,11565,11669,11789,-120,11669,11565,11675,11558,117,11558
11477,50898,54407,50908,3499,50908,50898,54437,49726,4711,49726
11478,47885,41434,38992,2442,38992,38992,41440,38821,2619,38821
11479,9130,9429,9132,297,9132,9130,9428,8962,466,8962
11480,63443,61915,60651,1264,60651,60651,61928,60114,1814,60114
11481,5375,5389,5648,-259,5389,5375,5393,5404,-11,5375
11482,108636,113197,107666,5531,107666,107666,113233,98855,14378,98855
11483,3763,3329,3473,-144,3329,3329,3330,3244,86,3244
11484,98527,97583,93426,4157,93426,93426,97625,92845,4780,92845
11485,33090,33028,32187,841,32187,32187,33029,31880,1149,31880
11486,148666,125102,120308,4794,120308,120308,125133,118547,6586,118547
11487,22542,21802,20663,1139,20663,20663,21809,20588,1221,20588
11488,91362,91372,88100,3272,88100,88100,91362,87580,3782,87580
11489,22306,21359,20910,449,20910,20910,21356,20786,570,20786
11490,13570,12667,12365,302,12365,12365,12667,12303,364,12303
11491,346826,360552,349548,11004,349548,346826,360644,347781,12863,346826
11492,13478,14020,13419,601,13419,13419,14021,13197,824,13197
11493,358165,331954,332830,-876,331954,331954,331960,323451,8509,323451
11494,106574,105255,100378,4877,100378,100378,105219,99471,5748,99471
11495,107764,94026,90095,3931,90095,90095,94039,89306,4733,89306
11496,18096,18101,17668,433,17668,17668,18096,17546,550,17546
11497,11262,11487,11199,288,11199,11199,11482,10973,509,10973
11498,28781,16074,15358,716,15358,15358,16070,15185,885,15185
11499,282562,272515,256960,15555,256960,256960,272594,254432,18162,254432
11500,154239,165528,157708,7820,157708,154239,165534,154156,11378,154156
11501,438,287,521,-234,287,287,287,332,-45,332
11502,15800,4667,4846,-179,4667,4667,4666,4693,-27,4693
11503,5483,4933,4990,-57,4933,4933,4929,4578,351,4578
11504,6287,6291,6524,-233,6291,6287,6295,6190,105,6190
11505,2827,2673,2766,-93,2673,2673,2671,2552,119,2552
11506,9210,8761,8815,-54,8761,8761,8761,8630,131,8630
11507,66831,65633,62800,2833,62800,62800,65654,62756,2898,62756
11508,517662,517701,497194,20507,497194,497194,517662,492233,25429,492233
11509,36667,12117,12126,-9,12117,12117,12120,12018,102,12018
11510,15093,15002,15363,-361,15002,15002,15006,14987,19,14987
11511,115508,103454,98841,4613,98841,98841,103453,96293,7160,96293
11512,117827,97491,92554,4937,92554,92554,97471,91116,6355,91116
11513,297514,301851,297495,4356,297495,297495,302007,293241,8766,293241
11514,23493,23506,22367,1139,22367,22367,23493,22201,1292,22201
11515,40866,42336,41338,998,41338,40866,42342,40968,1374,40866
11516,149164,153546,148963,4583,148963,148963,153567,148093,5474,148093
11517,241720,236213,226205,10008,226205,226205,236380,225307,11073,225307
11518,34827,35109,34829,280,34829,34827,35112,34429,683,34429
11519,9838,9761,9987,-226,9761,9761,9765,9394,371,9394
11520,409572,409647,386846,22801,386846,386846,409572,384760,24812,384760
11521,45375,41535,40879,656,40879,40879,41592,39516,2076,39516
11522,12058,11508,10912,596,10912,10912,11504,10592,912,10592
11523,94594,93721,95220,-1499,93721,93721,93767,88192,5575,88192
11524,44653,43017,41867,1150,41867,41867,43049,41332,1717,41332
11525,107918,107834,103595,4239,103595,103595,107814,103129,4685,103129
11526,11282,11319,11282,37,11282,11282,11315,11161,154,11161
11527,7258,6470,6451,19,6451,6451,6472,6354,118,6354
11528,51166,51169,48900,2269,48900,48900,51166,48413,2753,48413
11529,88040,87122,83851,3271,83851,83851,87137,82915,4222,82915
11530,35620,35611,34464,1147,34464,34464,35620,34338,1282,34338
11531,111435,111399,110132,1267,110132,110132,111435,108735,2700,108735
11532,50841,61493,61882,-389,61493,50841,61512,52952,8560,50841
11533,397009,384240,364961,19279,364961,364961,384375,362422,21953,362422
11534,702236,672242,637981,34261,637981,637981,671977,634542,37435,634542
11535,96670,92260,91999,261,91999,91999,92307,89565,2742,89565
11536,143053,131066,128165,2901,128165,128165,131095,125434,5661,125434
11537,70655,62240,60028,2212,60028,60028,62257,59639,2618,59639
11538,8137,7254,7112,142,7112,7112,7252,6716,536,6716
11539,83933,87562,83903,3659,83903,83903,87551,83106,4445,83106
11540,11661,11663,11626,37,11626,11626,11661,11477,184,11477
11541,19919,21228,20492,736,20492,19919,21234,19919,1315,19919
11542,4101,3973,4101,-128,3973,3973,3975,3827,148,3827
11543,117189,97540,91945,5595,91945,91945,97529,91452,6077,91452
11544,43575,44790,43568,1222,43568,43568,44779,43344,1435,43344
11545,1185,812,1085,-273,812,812,812,859,-47,859
11546,9850,9385,9379,6,9379,9379,9387,9150,237,9150
11547,3823,3801,4014,-213,3801,3801,3802,3772,30,3772
11548,104775,104815,98850,5965,98850,98850,104775,97991,6784,97991
11549,28485,29161,28475,686,28475,28475,29172,27863,1309,27863
11550,89301,89281,86762,2519,86762,86762,89301,86006,3295,86006
11551,106042,97895,92476,5419,92476,92476,97915,90571,7344,90571
11552,49570,48034,49510,-1476,48034,48034,48036,48275,-239,48275
11553,8079,7626,7554,72,7554,7554,7631,7429,202,7429
11554,19519,7451,7359,92,7359,7359,7455,7077,378,7077
11555,30835,31340,30868,472,30868,30835,31358,30753,605,30753
11556,65848,21276,20810,466,20810,20810,21284,20521,763,20521
11557,16466,2034,2305,-271,2034,2034,2034,2012,22,2012
11558,5168,4327,4485,-158,4327,4327,4331,4329,2,4329
11559,8498,8437,8569,-132,8437,8437,8439,8403,36,8403
11560,119614,119630,115783,3847,115783,115783,119632,112938,6694,112938
11561,63490,66369,63629,2740,63629,63490,66358,62938,3420,62938
11562,1877422,1869193,1791358,77835,1791358,1791358,1869251,1766238,103013,1766238
11563,1904,1903,2083,-180,1903,1903,1904,1928,-24,1904
11564,119217,112380,108906,3474,108906,108906,112406,108264,4142,108264
11565,100152,103841,99675,4166,99675,99675,103853,98892,4961,98892
11566,83963,82756,80952,1804,80952,80952,82808,80268,2540,80268
11567,80620,79012,76681,2331,76681,76681,79037,75906,3131,75906
11568,8588,8664,8589,75,8589,8588,8656,8214,442,8214
11569,18311,18306,17694,612,17694,17694,18311,17471,840,17471
11570,126369,124150,118520,5630,118520,118520,124192,118189,6003,118189
11571,90082,90106,86819,3287,86819,86819,90082,86432,3650,86432
11572,30515,31295,30514,781,30514,30514,31291,30384,907,30384
11573,83914,56603,57867,-1264,56603,56603,56606,55175,1431,55175
11574,17835,17804,18095,-291,17804,17804,17823,16777,1046,16777
11575,103856,103840,99857,3983,99857,99857,103856,99413,4443,99413
11576,11379,4316,4557,-241,4316,4316,4316,2350,1966,2350
11577,34948,31109,31554,-445,31109,31109,31117,30671,446,30671
11578,15738,15093,14880,213,14880,14880,15090,14602,488,14602
11579,6517,6093,6224,-131,6093,6093,6094,6043,51,6043
11580,179290,178384,174255,4129,174255,174255,178372,171922,6450,171922
11581,81471,80649,78862,1787,78862,78862,80646,77390,3256,77390
11582,1698,1014,1283,-269,1014,1014,1015,1076,-61,1076
11583,256389,239096,227797,11299,227797,227797,239095,225568,13527,225568
11584,192957,197495,196390,1105,196390,192957,197611,193871,3740,192957
11585,108031,114904,113911,993,113911,108031,114937,108165,6772,108031
11586,6321,6321,6241,80,6241,6241,6321,6031,290,6031
11587,23767,22747,22118,629,22118,22118,22767,22025,742,22025
11588,71112,46360,44612,1748,44612,44612,46372,44099,2273,44099
11589,62000,60980,58352,2628,58352,58352,61003,57234,3769,57234
11590,19778,19019,17824,1195,17824,17824,19016,17692,1324,17692
11591,110978,108079,108411,-332,108079,108079,108117,107197,920,107197
11592,87663,86888,83483,3405,83483,83483,86885,83072,3813,83072
11593,19675,19985,19666,319,19666,19666,19994,19402,592,19402
11594,30891,13226,13046,180,13046,13046,13225,12644,581,12644
11595,5412,5029,5084,-55,5029,5029,5031,4903,128,4903
11596,6481,5987,6107,-120,5987,5987,5985,5892,93,5892
11597,10260,7951,7482,469,7482,7482,7950,6640,1310,6640
11598,144347,141201,130257,10944,130257,130257,141185,128829,12356,128829
11599,1584,1584,1773,-189,1584,1584,1584,1599,-15,1584
11600,32712,32103,31489,614,31489,31489,32106,31217,889,31217
11601,18054,18012,17998,14,17998,17998,18015,16406,1609,16406
11602,31525,30937,30366,571,30366,30366,30960,30027,933,30027
11603,2819,2421,2633,-212,2421,2421,2421,2424,-3,2424
11604,21461,21458,21292,166,21292,21292,21459,20668,791,20668
11605,13690,13514,13053,461,13053,13053,13518,12309,1209,12309
11606,360,341,575,-234,341,341,341,359,-18,359
11607,492960,492017,475708,16309,475708,475708,491880,470999,20881,470999
11608,13114,13289,13060,229,13060,13060,13295,12861,434,12861
11609,91759,93191,89100,4091,89100,89100,93206,87862,5344,87862
11610,169311,169263,166632,2631,166632,166632,169329,164660,4669,164660
11611,2729,2544,2668,-124,2544,2544,2545,2487,58,2487
11612,19953,19958,19528,430,19528,19528,19953,19303,650,19303
11613,13815,9459,9697,-238,9459,9459,9459,9442,17,9442
11614,7977,7977,8456,-479,7977,7977,7977,7366,611,7366
11615,402873,450198,413815,36383,413815,402873,450333,402251,48082,402251
11616,68070,61067,59666,1401,59666,59666,61094,57632,3462,57632
11617,51808,45366,42944,2422,42944,42944,45380,42761,2619,42761
11618,7981,8016,7920,96,7920,7920,8018,7653,365,7653
11619,10183,10709,10803,-94,10709,10183,10698,9561,1137,9561
11620,2169,2166,2447,-281,2166,2166,2169,2237,-68,2169
11621,1731,754,1012,-258,754,754,753,806,-53,806
11622,4446,4359,4616,-257,4359,4359,4358,4406,-48,4406
11623,6921,6295,6446,-151,6295,6295,6295,6089,206,6089
11624,149594,143730,138286,5444,138286,138286,143728,137280,6448,137280
11625,13962,13463,13170,293,13170,13170,13471,13090,381,13090
11626,5878,6078,5878,200,5878,5878,6086,5179,907,5179
11627,73903,77492,74412,3080,74412,73903,77459,73903,3556,73903
11628,8425,7598,7370,228,7370,7370,7601,7092,509,7092
11629,8613,8608,8354,254,8354,8354,8613,8002,611,8002
11630,370638,382643,370569,12074,370569,370569,382857,369261,13596,369261
11631,33104,29770,29556,214,29556,29556,29774,29529,245,29529
11632,12389,12388,12328,60,12328,12328,12389,12178,211,12178
11633,92093,92100,89807,2293,89807,89807,92093,89276,2817,89276
11634,14465,14470,14161,309,14161,14161,14465,13983,482,13983
11635,50670,49248,47308,1940,47308,47308,49251,47110,2141,47110
11636,61716,33388,32324,1064,32324,32324,33380,32102,1278,32102
11637,20498,20435,19882,553,19882,19882,20437,19818,619,19818
11638,38920,41884,39923,1961,39923,38920,41904,38298,3606,38298
11639,11847,11822,11362,460,11362,11362,11833,11309,524,11309
11640,14175,14173,14193,-20,14173,14173,14175,14012,163,14012
11641,25617,21672,21181,491,21181,21181,21672,21106,566,21106
11642,16999,16113,15474,639,15474,15474,16117,15407,710,15407
11643,377344,375599,347906,27693,347906,347906,375752,341620,34132,341620
11644,4773,5206,5262,-56,5206,4773,5207,4767,440,4767
11645,14217,14156,13947,209,13947,13947,14156,13773,383,13773
11646,17063,17250,17857,-607,17250,17063,17256,16966,290,16966
11647,14971,15393,14916,477,14916,14916,15389,14362,1027,14362
11648,19015,18106,17202,904,17202,17202,18101,16765,1336,16765
11649,1439,1421,1636,-215,1421,1421,1421,1455,-34,1439
11650,712200,712157,683537,28620,683537,683537,712200,680127,32073,680127
11651,14507,14504,14092,412,14092,14092,14507,13900,607,13900
11652,42791,42801,42220,581,42220,42220,42809,41861,948,41861
11653,28352,28365,27046,1319,27046,27046,28352,26954,1398,26954
11654,10065,10214,10063,151,10063,10063,10220,9968,252,9968
11655,28165,29115,28156,959,28156,28156,29149,27235,1914,27235
11656,5986,5989,6316,-327,5989,5986,5986,5923,63,5923
11657,127073,82854,79383,3471,79383,79383,82846,75826,7020,75826
11658,14423,14767,14668,99,14668,14423,14767,14423,344,14423
11659,1665,1401,1665,-264,1401,1401,1402,1445,-43,1445
11660,30499,31802,30351,1451,30351,30351,31808,29877,1931,29877
11661,72445,42770,40783,1987,40783,40783,42779,40636,2143,40636
11662,4505,4330,4504,-174,4330,4330,4335,4301,34,4301
11663,158525,157036,150563,6473,150563,150563,157085,149123,7962,149123
11664,2388,2369,2600,-231,2369,2369,2368,2434,-66,2388
11665,88915,67067,64755,2312,64755,64755,67080,63616,3464,63616
11666,8977,9054,9168,-114,9054,8977,9051,8969,82,8969
11667,5065,4987,5004,-17,4987,4987,4986,4698,288,4698
11668,37703,38091,38271,-180,38091,37703,38089,37703,386,37703
11669,5549,4852,4930,-78,4852,4852,4851,4643,208,4643
11670,24613,22785,21262,1523,21262,21262,22794,21181,1613,21181
11671,2006566,2005932,1941131,64801,1941131,1941131,2006444,1928130,78314,1928130
11672,37151,37131,35251,1880,35251,35251,37151,34922,2229,34922
11673,89764,85373,81298,4075,81298,81298,85365,80030,5335,80030
11674,37954,36935,35751,1184,35751,35751,36922,35634,1288,35634
11675,48586,46263,43474,2789,43474,43474,46272,42714,3558,42714
11676,15134,13056,13034,22,13034,13034,13054,12024,1030,12024
11677,25878,26690,25851,839,25851,25851,26690,25488,1202,25488
11678,39471,16123,15588,535,15588,15588,16128,15157,971,15157
11679,31205,28485,27519,966,27519,27519,28485,27247,1238,27247
11680,3918,3733,3858,-125,3733,3733,3734,3705,29,3705
11681,10047,8796,8978,-182,8796,8796,8799,8449,350,8449
11682,12037,12037,11700,337,11700,11700,12047,11415,632,11415
11683,9721,8651,8527,124,8527,8527,8645,8328,317,8328
11684,3953,3956,4136,-180,3956,3953,3953,3950,3,3950
11685,83874,82840,81790,1050,81790,81790,82848,80216,2632,80216
11686,2490555,2315801,2275022,40779,2275022,2275022,2316380,2258048,58332,2258048
11687,9900,10163,10281,-118,10163,9900,10169,9900,269,9900
11688,7105,6323,6208,115,6208,6208,6323,6103,220,6103
11689,13328,12800,12750,50,12750,12750,12800,12505,295,12505
11690,165233,131996,126508,5488,126508,126508,131974,124309,7665,124309
11691,233197,194803,180191,14612,180191,180191,194878,175004,19874,175004
11692,2111,1149,1383,-234,1149,1149,1148,1209,-61,1209
11693,43011,29024,28368,656,28368,28368,29031,27056,1975,27056
11694,33241,32349,32747,-398,32349,32349,32363,32015,348,32015
11695,95738,95714,92864,2850,92864,92864,95738,92538,3200,92538
11696,11140,11143,10885,258,10885,10885,11140,10738,402,10738
11697,29215,30265,29204,1061,29204,29204,30281,28984,1297,28984
11698,207456,207258,207141,117,207141,207141,207342,203487,3855,203487
11699,27796,27234,27095,139,27095,27095,27241,26797,444,26797
11700,59210,46394,44065,2329,44065,44065,46407,42821,3586,42821
11701,144922,115422,117337,-1915,115422,115422,115528,114126,1402,114126
11702,16966,16967,16903,64,16903,16903,16966,16715,251,16715
11703,8523,8519,8661,-142,8519,8519,8523,8431,92,8431
11704,150980,150946,146993,3953,146993,146993,150980,146498,4482,146498
11705,26655,25722,25519,203,25519,25519,25710,25146,564,25146
11706,462458,462300,441757,20543,441757,441757,462458,440169,22289,440169
11707,20293,19449,18488,961,18488,18488,19457,18436,1021,18436
11708,144862,150940,144791,6149,144791,144791,150932,143619,7313,143619
11709,21765,21770,21160,610,21160,21160,21765,21020,745,21020
11710,47997,30774,28989,1785,28989,28989,30775,28491,2284,28491
11711,36865,27060,26248,812,26248,26248,27063,26029,1034,26029
11712,27566,25745,25047,698,25047,25047,25749,24291,1458,24291
11713,49697,48716,47700,1016,47700,47700,48720,42608,6112,42608
11714,149872,130560,125065,5495,125065,125065,130580,124427,6153,124427
11715,51471,47869,45775,2094,45775,45775,47874,45538,2336,45538
11716,58627,39811,40556,-745,39811,39811,39836,39264,572,39264
11717,30974,28548,26752,1796,26752,26752,28552,26381,2171,26381
11718,391585,390715,377390,13325,377390,377390,390624,375084,15540,375084
11719,73761,65963,63407,2556,63407,63407,65980,60822,5158,60822
11720,23749,23992,23740,252,23740,23740,24006,23238,768,23238
11721,10195,9523,9244,279,9244,9244,9520,8730,790,8730
11722,229734,195827,189714,6113,189714,189714,195737,188909,6828,188909
11723,77740,79901,77835,2066,77835,77740,79891,77653,2238,77653
11724,631,285,519,-234,285,285,285,331,-46,331
11725,13861,13338,12918,420,12918,12918,13343,12821,522,12821
11726,2493,2449,2735,-286,2449,2449,2451,2519,-68,2493
11727,80691,80727,77194,3533,77194,77194,80691,77187,3504,77187
11728,2263,1339,1513,-174,1339,1339,1337,1386,-49,1386
11729,2448,2449,2646,-197,2449,2448,2448,2456,-8,2448
11730,9542,9622,9542,80,9542,9542,9618,9396,222,9396
11731,56666,55374,54382,992,54382,54382,55400,54159,1241,54159
11732,290239,305858,290665,15193,290665,290239,305908,287955,17953,287955
11733,173382,179603,173341,6262,173341,173341,179627,172608,7019,172608
11734,38178,34779,32376,2403,32376,32376,34796,32043,2753,32043
11735,15460,15680,15451,229,15451,15451,15691,15441,250,15441
11736,177121,185337,176547,8790,176547,176547,185387,174156,11231,174156
11737,43833,44744,43537,1207,43537,43537,44772,43211,1561,43211
11738,30814,26817,27613,-796,26817,26817,26826,26643,183,26643
11739,40260,27431,27020,411,27020,27020,27432,26757,675,26757
11740,2678346,2808200,2697039,111161,2697039,2678346,2808576,2686871,121705,2678346
11741,33881,29986,28798,1188,28798,28798,29975,28653,1322,28653
11742,8673,8673,8482,191,8482,8482,8673,8371,302,8371
11743,5824,5822,6117,-295,5822,5822,5824,5865,-41,5824
11744,4344,3821,3899,-78,3821,3821,3822,3773,49,3773
11745,67642,64519,62548,1971,62548,62548,64532,62130,2402,62130
11746,153742,156175,151100,5075,151100,151100,156162,149391,6771,149391
11747,771,315,549,-234,315,315,315,346,-31,346
11748,2537,1845,2081,-236,1845,1845,1845,1915,-70,1915
11749,125016,96915,94403,2512,94403,94403,96997,93817,3180,93817
11750,1480,1103,1305,-202,1103,1103,1103,1152,-49,1152
11751,36444,35691,35130,561,35130,35130,35715,34746,969,34746
11752,11084,11083,10934,149,10934,10934,11084,10682,402,10682
11753,36661,37733,36603,1130,36603,36603,37730,36119,1611,36119
11754,255447,245529,236000,9529,236000,236000,245571,232669,12902,232669
11755,4204,3766,3912,-146,3766,3766,3766,3747,19,3747
11756,16933,8516,8303,213,8303,8303,8521,7897,624,7897
11757,128983,130110,123290,6820,123290,123290,130159,120300,9859,120300
11758,73345,66577,65755,822,65755,65755,66601,64906,1695,64906
11759,64028,64993,64013,980,64013,64013,65011,63235,1776,63235
11760,4811,4238,4210,28,4210,4210,4237,4000,237,4000
11761,4544,4544,4634,-90,4544,4544,4544,4501,43,4501
11762,127482,100701,96090,4611,96090,96090,100728,94430,6298,94430
11763,6902,6900,7055,-155,6900,6900,6902,6880,22,6880
11764,954124,946824,948983,-2159,946824,946824,946994,924619,22375,924619
11765,2442,2438,2574,-136,2438,2438,2442,2365,77,2365
11766,205553,182059,177562,4497,177562,177562,182082,176663,5419,176663
11767,1383,1400,1672,-272,1400,1383,1399,1426,-27,1383
11768,13914,13531,13856,-325,13531,13531,13530,12741,789,12741
11769,211641,211614,205608,6006,205608,205608,211641,203847,7794,203847
11770,12572,12576,12819,-243,12576,12572,12579,12270,309,12270
11771,467689,481515,469610,11905,469610,467689,481526,467681,13845,467681
11772,163655,163629,156723,6906,156723,156723,163655,155825,7830,155825
11773,13586,13373,13586,-213,13373,13373,13378,13252,126,13252
11774,2440,2302,2439,-137,2302,2302,2302,2218,84,2218
11775,31127,31145,30869,276,30869,30869,31145,30533,612,30533
11776,307745,306936,291794,15142,291794,291794,306911,290404,16507,290404
11777,65326,65351,63417,1934,63417,63417,65326,63199,2127,63199
11778,100106,103923,100504,3419,100504,100106,103911,100054,3857,100054
11779,36784,28313,28581,-268,28313,28313,28302,24445,3857,24445
11780,58016,51770,48954,2816,48954,48954,51766,46875,4891,46875
11781,20764,21338,20783,555,20783,20764,21342,20142,1200,20142
11782,91801,98803,91797,7006,91797,91797,98806,91539,7267,91539
11783,23700,23712,23363,349,23363,23363,23700,23188,512,23188
11784,70657,69377,69026,351,69026,69026,69406,68440,966,68440
11785,7368,7363,7509,-146,7363,7363,7368,7311,57,7311
11786,504759,469436,451667,17769,451667,451667,469427,447567,21860,447567
11787,23576,22975,22157,818,22157,22157,22966,22078,888,22078
11788,29690,28547,27574,973,27574,27574,28565,26305,2260,26305
11789,48091,46889,45580,1309,45580,45580,46882,44767,2115,44767
11790,52447,51628,49409,2219,49409,49409,51623,49143,2480,49143
11791,6584,5706,5854,-148,5706,5706,5705,5461,244,5461
11792,39944,41616,39907,1709,39907,39907,41608,39710,1898,39710
11793,17855,17262,16718,544,16718,16718,17259,16601,658,16601
11794,13185,12235,12069,166,12069,12069,12243,11830,413,11830
11795,3894,4084,4264,-180,4084,3894,4088,3886,202,3886
11796,7596,6617,6614,3,6614,6614,6615,6190,425,6190
11797,14931,14926,14949,-23,14926,14926,14931,14710,221,14710
11798,15225,15682,15166,516,15166,15166,15686,14930,756,14930
11799,337742,337621,323906,13715,323906,323906,337671,320267,17404,320267
11800,15975,15071,14780,291,14780,14780,15068,14408,660,14408
11801,44876,41696,37736,3960,37736,37736,41706,37523,4183,37523
11802,11621,10799,10656,143,10656,10656,10803,10639,164,10639
11803,36586,37195,35987,1208,35987,35987,37204,34266,2938,34266
11804,11001,11000,10995,5,10995,10995,11001,10798,203,10798
11805,19121,19072,18849,223,18849,18849,19069,18531,538,18531
11806,17303,17626,17654,-28,17626,17303,17622,17295,327,17295
11807,3041,3041,3258,-217,3041,3041,3041,3033,8,3033
11808,241987,258929,241994,16935,241994,241987,258972,236306,22666,236306
11809,15332,14737,15330,-593,14737,14737,14741,14499,242,14499
11810,2187,1221,1444,-223,1221,1221,1221,1280,-59,1280
11811,8960,8957,8836,121,8836,8836,8960,8371,589,8371
11812,8226,8077,8066,11,8066,8066,8080,7919,161,7919
11813,115054,88313,88605,-292,88313,88313,88340,87404,936,87404
11814,8968,8523,8656,-133,8523,8523,8522,8346,176,8346
11815,9550,5180,5227,-47,5180,5180,5181,4844,337,4844
11816,913952,245512,235727,9785,235727,235727,245566,235356,10210,235356
11817,102913,85178,80946,4232,80946,80946,85192,79908,5284,79908
11818,132946,132939,124836,8103,124836,124836,132946,124571,8375,124571
11819,328323,295025,283830,11195,283830,283830,295024,282415,12609,282415
11820,8924,8832,8863,-31,8832,8832,8836,8527,309,8527
11821,61086,71682,68413,3269,68413,61086,71663,61078,10585,61078
11822,83233,82333,82147,186,82147,82147,82378,81026,1352,81026
11823,264071,264006,248658,15348,248658,248658,264071,246783,17288,246783
11824,6746,6726,6945,-219,6726,6726,6729,6713,16,6713
11825,51773,56324,53586,2738,53586,51773,56362,51151,5211,51151
11826,1536,1500,1692,-192,1500,1500,1500,1498,2,1498
11827,647864,627542,609661,17881,609661,609661,627494,604908,22586,604908
11828,35262,35247,34989,258,34989,34989,35262,34690,572,34690
11829,745615,741235,694511,46724,694511,694511,741077,693123,47954,693123
11830,83576,64118,63445,673,63445,63445,64122,62592,1530,62592
11831,32730,32731,31228,1503,31228,31228,32730,31213,1517,31213
11832,10612,9904,9966,-62,9904,9904,9894,9679,215,9679
11833,15110,14248,14108,140,14108,14108,14249,13788,461,13788
11834,6797,6201,6106,95,6106,6106,6207,5977,230,5977
11835,153356,153355,145575,7780,145575,145575,153356,145321,8035,145321
11836,7507,4595,4702,-107,4595,4595,4592,4579,13,4579
11837,177175,176309,170745,5564,170745,170745,176444,170802,5642,170802
11838,77065,75925,73102,2823,73102,73102,75933,72927,3006,72927
11839,223539,223417,223559,-142,223417,223417,223557,218850,4707,218850
11840,357312,366471,360026,6445,360026,357312,366698,358916,7782,357312
11841,77110,75883,74881,1002,74881,74881,75898,74061,1837,74061
11842,90992,89710,86733,2977,86733,86733,89675,86316,3359,86316
11843,33869,33131,31724,1407,31724,31724,33137,31668,1469,31668
11844,237057,229529,217368,12161,217368,217368,229537,215556,13981,215556
11845,4286,3803,3943,-140,3803,3803,3801,3796,5,3796
11846,6879,6330,6246,84,6246,6246,6331,6111,220,6111
11847,5646,5610,5710,-100,5610,5610,5608,5525,83,5525
11848,566,567,818,-251,567,566,566,622,-56,566
11849,288300,303378,288311,15067,288311,288300,303316,283669,19647,283669
11850,1244426,1243583,1201753,41830,1201753,1201753,1243790,1195381,48409,1195381
11851,382782,395209,386629,8580,386629,382782,395215,382700,12515,382700
11852,43364,43325,41848,1477,41848,41848,43364,41509,1855,41509
11853,19789,20028,20373,-345,20028,19789,20049,19789,260,19789
11854,2187,1253,1461,-208,1253,1253,1253,1301,-48,1301
11855,1541,696,933,-237,696,696,696,735,-39,735
11856,432460,429477,416278,13199,416278,416278,429350,414093,15257,414093
11857,7850,7703,7791,-88,7703,7703,7702,7509,193,7509
11858,13963,13297,13588,-291,13297,13297,13298,13155,143,13155
11859,3103,3062,3282,-220,3062,3062,3059,3128,-69,3103
11860,260566,212384,206802,5582,206802,206802,212366,196991,15375,196991
11861,304138,247959,236409,11550,236409,236409,248028,231211,16817,231211
11862,88980,88100,84114,3986,84114,84114,88114,83346,4768,83346
11863,22571,22814,22571,243,22571,22571,22818,21433,1385,21433
11864,29826,25838,25035,803,25035,25035,25836,24709,1127,24709
11865,225490,228054,225414,2640,225414,225414,228087,219251,8836,219251
11866,4455,4451,4591,-140,4451,4451,4455,4461,-6,4455
11867,22372,22375,21719,656,21719,21719,22372,21555,817,21555
11868,6894,6303,6295,8,6295,6295,6304,6215,89,6215
11869,91094,77259,75979,1280,75979,75979,77268,72515,4753,72515
11870,763006,730256,689531,40725,689531,689531,730415,688722,41693,688722
11871,30071,27456,26317,1139,26317,26317,27459,26171,1288,26171
11872,203288,196892,188706,8186,188706,188706,196856,187188,9668,187188
11873,37443,37447,36813,634,36813,36813,37443,36449,994,36449
11874,6254,6253,6237,16,6237,6237,6254,6078,176,6078
11875,24904,17186,17289,-103,17186,17186,17193,16925,268,16925
11876,3237,3113,3284,-171,3113,3113,3113,3130,-17,3130
11877,2564,2523,2753,-230,2523,2523,2520,2577,-57,2564
11878,70491,66696,63363,3333,63363,63363,66686,63067,3619,63067
11879,8612,7945,7878,67,7878,7878,7944,7752,192,7752
11880,27216,27922,27150,772,27150,27150,27926,26453,1473,26453
11881,26305,26138,25005,1133,25005,25005,26124,24855,1269,24855
11882,372731,372597,356005,16592,356005,356005,372640,350401,22239,350401
11883,16725,16265,15647,618,15647,15647,16267,15558,709,15558
11884,344482,358582,345491,13091,345491,344482,358514,344474,14040,344474
11885,23564,9730,9701,29,9701,9701,9736,8482,1254,8482
11886,23961,20027,19544,483,19544,19544,20034,19003,1031,19003
11887,194928,172981,163807,9174,163807,163807,172905,162885,10020,162885
11888,15305,15677,15242,435,15242,15242,15678,15067,611,15067
11889,81870,81350,81730,-380,81350,81350,81336,80429,907,80429
11890,19714,19731,19464,267,19464,19464,19714,19235,479,19235
11891,129538,126296,117629,8667,117629,117629,126254,116383,9871,116383
11892,76549,75377,72184,3193,72184,72184,75364,71785,3579,71785
11893,41806,42839,41806,1033,41806,41806,42840,40587,2253,40587
11894,21930,22840,22496,344,22496,21930,22857,21998,859,21930
11895,16005,14896,15054,-158,14896,14896,14908,13082,1826,13082
11896,11266,10252,10261,-9,10252,10252,10262,10005,257,10005
11897,46720,43543,41586,1957,41586,41586,43568,35527,8041,35527
11898,20948,21403,20901,502,20901,20901,21409,20326,1083,20326
11899,3676,3471,3675,-204,3471,3471,3471,3486,-15,3486
11900,8774,8472,8708,-236,8472,8472,8476,8476,0,8476
11901,54919,54895,54622,273,54622,54622,54919,53980,939,53980
11902,111196,85218,80738,4480,80738,80738,85244,80338,4906,80338
11903,44459,44443,43357,1086,43357,43357,44459,42667,1792,42667
11904,106803,91851,91534,317,91534,91534,91874,90300,1574,90300
11905,48581,50736,48558,2178,48558,48558,50745,48480,2265,48480
11906,67629,67619,64691,2928,64691,64691,67629,63854,3775,63854
11907,6704,5936,5990,-54,5936,5936,5938,5843,95,5843
11908,53016,53005,50968,2037,50968,50968,53016,50945,2071,50945
11909,487629,527789,487472,40317,487472,487472,527756,479292,48464,479292
11910,14799,14006,13126,880,13126,13126,14005,12914,1091,12914
11911,8312,8312,8250,62,8250,8250,8312,7932,380,7932
11912,88154,93491,88150,5341,88150,88150,93483,87395,6088,87395
11913,167253,166345,157836,8509,157836,157836,166398,156942,9456,156942
11914,17775,3986,4189,-203,3986,3986,3982,4061,-79,4061
11915,2454,2411,2676,-265,2411,2411,2413,2474,-61,2454
11916,4735,4209,4335,-126,4209,4209,4219,4142,77,4142
11917,172807,172814,169711,3103,169711,169711,172807,168566,4241,168566
11918,2588,2328,2526,-198,2328,2328,2328,2375,-47,2375
11919,23070,23075,22788,287,22788,22788,23070,22682,388,22682
11920,5979,5407,5355,52,5355,5355,5410,5271,139,5271
11921,115872,123614,115851,7763,115851,115851,123632,115320,8312,115320
11922,6816,4981,5145,-164,4981,4981,4980,4290,690,4290
11923,36436,34646,33962,684,33962,33962,34657,33320,1337,33320
11924,108378,106760,104185,2575,104185,104185,106777,103399,3378,103399
11925,39852,39834,38773,1061,38773,38773,39852,38565,1287,38565
11926,129307,136113,129199,6914,129199,129199,136158,128943,7215,128943
11927,22322,22310,22652,-342,22310,22310,22322,21764,558,21764
11928,82408,82390,83946,-1556,82390,82390,82408,81333,1075,81333
11929,80909,84050,81489,2561,81489,80909,84035,81266,2769,80909
11930,11273,11386,11818,-432,11386,11273,11384,11306,78,11273
11931,13299,12819,12861,-42,12819,12819,12831,12666,165,12666
11932,4043,3939,3983,-44,3939,3939,3941,3853,88,3853
11933,4998,4979,5059,-80,4979,4979,4979,4828,151,4828
11934,38855,26045,25461,584,25461,25461,26050,25197,853,25197
11935,271103,261698,239391,22307,239391,239391,261750,237982,23768,237982
11936,4277,4135,4217,-82,4135,4135,4131,4112,19,4112
11937,453248,239851,232096,7755,232096,232096,239950,230180,9770,230180
11938,9660,8411,8377,34,8377,8377,8415,8017,398,8017
11939,5939,5962,6057,-95,5962,5939,5961,5911,50,5911
11940,16280,13109,12897,212,12897,12897,13118,12765,353,12765
11941,48219,48377,48206,171,48206,48206,48411,46884,1527,46884
11942,111604,113808,111575,2233,111575,111575,113806,110931,2875,110931
11943,216720,207701,198770,8931,198770,198770,207783,195058,12725,195058
11944,10348,9799,9753,46,9753,9753,9794,9533,261,9533
11945,36362,35632,34959,673,34959,34959,35644,34711,933,34711
11946,85054,82690,80203,2487,80203,80203,82668,79551,3117,79551
11947,17583,17580,17641,-61,17580,17580,17583,17379,204,17379
11948,208069,207210,200366,6844,200366,200366,207262,199321,7941,199321
11949,5740,5177,5334,-157,5177,5177,5182,5111,71,5111
11950,166364,173119,166337,6782,166337,166337,173076,165126,7950,165126
11951,50606,37967,38345,-378,37967,37967,37976,36898,1078,36898
11952,11591,549,804,-255,549,549,549,517,32,517
11953,6927,6942,7174,-232,6942,6927,6945,6813,132,6813
11954,24772,24946,24821,125,24821,24772,24950,24150,800,24150
11955,46520,42206,40080,2126,40080,40080,42216,39799,2417,39799
11956,640,639,913,-274,639,639,640,696,-56,640
11957,1685393,1616030,1549384,66646,1549384,1549384,1616195,1538991,77204,1538991
11958,210260,204803,191995,12808,191995,191995,204881,189508,15373,189508
11959,83890,82974,80171,2803,80171,80171,82949,79880,3069,79880
11960,125650,122397,117896,4501,117896,117896,122364,117717,4647,117717
11961,32682,31704,30846,858,30846,30846,31711,30468,1243,30468
11962,9204,8760,8628,132,8628,8628,8761,8521,240,8521
11963,19236,18175,17777,398,17777,17777,18182,17304,878,17304
11964,953,284,518,-234,284,284,284,331,-47,331
11965,70748,48073,48111,-38,48073,48073,48079,45737,2342,45737
11966,108041,99108,94842,4266,94842,94842,99112,93504,5608,93504
11967,237910,237979,227220,10759,227220,227220,237910,226641,11269,226641
11968,2647,2449,2589,-140,2449,2449,2448,2230,218,2230
11969,177951,192389,191124,1265,191124,177951,192374,177943,14431,177943
11970,56016,53068,52855,213,52855,52855,53063,51778,1285,51778
11971,15922,5397,5561,-164,5397,5397,5402,5360,42,5360
11972,14694,14130,14168,-38,14130,14130,14140,13937,203,13937
11973,4430,3799,3840,-41,3799,3799,3797,3574,223,3574
11974,9381,9303,9380,-77,9303,9303,9309,9187,122,9187
11975,107898,100686,93580,7106,93580,93580,100632,90742,9890,90742
11976,506381,492833,480319,12514,480319,480319,492928,479821,13107,479821
11977,1959,1050,1276,-226,1050,1050,1050,1102,-52,1102
11978,28306,27508,26492,1016,26492,26492,27493,26279,1214,26279
11979,3917,3447,3587,-140,3447,3447,3449,3407,42,3407
11980,21005,20446,19727,719,19727,19727,20437,19609,828,19609
11981,204339,204029,199379,4650,199379,199379,204139,197400,6739,197400
11982,44599,43736,41938,1798,41938,41938,43752,41362,2390,41362
11983,10595,9766,9695,71,9695,9695,9770,9364,406,9364
11984,40636,40625,40031,594,40031,40031,40636,39449,1187,39449
11985,9893,10091,9891,200,9891,9891,10090,9769,321,9769
11986,32261,32256,32317,-61,32256,32256,32261,31580,681,31580
11987,13022,13022,13021,1,13021,13021,13022,12823,199,12823
11988,1325889,1324311,1268005,56306,1268005,1268005,1324312,1260825,63487,1260825
11989,36421,35477,34287,1190,34287,34287,35505,33943,1562,33943
11990,155887,145746,147606,-1860,145746,145746,145756,135464,10292,135464
11991,12367,12204,12436,-232,12204,12204,12205,12125,80,12125
11992,4828,4434,4519,-85,4434,4434,4432,4365,67,4365
11993,400580,400485,392241,8244,392241,392241,400580,386479,14101,386479
11994,7074,6851,7009,-158,6851,6851,6853,6601,252,6601
11995,4197,4213,4359,-146,4213,4197,4215,4195,20,4195
11996,23966,23783,23353,430,23353,23353,23776,23173,603,23173
11997,103081,105722,104349,1373,104349,103081,105709,103073,2636,103073
11998,6930,6441,6413,28,6413,6413,6440,6276,164,6276
11999,283528,283227,268042,15185,268042,268042,283358,267927,15431,267927
12000,23480,22150,20019,2131,20019,20019,22154,19320,2834,19320
12001,42720,44611,42710,1901,42710,42710,44609,42518,2091,42518
12002,784,765,999,-234,765,765,765,690,75,690
12003,19036,16386,15633,753,15633,15633,16385,14568,1817,14568
12004,48974,48104,47809,295,47809,47809,48129,46985,1144,46985
12005,11706,6510,6506,4,6506,6506,6517,5526,991,5526
12006,8422,8487,8357,130,8357,8357,8492,7746,746,7746
12007,32802,32748,32308,440,32308,32308,32749,32066,683,32066
12008,8003,8006,7869,137,7869,7869,8003,7790,213,7790
12009,31771,5126,5182,-56,5126,5126,5124,5036,88,5036
12010,262705,261705,256565,5140,256565,256565,261634,254870,6764,254870
12011,130344,79615,75282,4333,75282,75282,79614,74717,4897,74717
12012,2671,2285,2483,-198,2285,2285,2284,2315,-31,2315
12013,18387,16939,16598,341,16598,16598,16938,16387,551,16387
12014,55007,34431,34376,55,34376,34376,34429,33128,1301,33128
12015,20199,19675,19136,539,19136,19136,19681,18941,740,18941
12016,47205,46266,44432,1834,44432,44432,46294,44403,1891,44403
12017,752106,751158,736637,14521,736637,736637,751255,733552,17703,733552
12018,22780,22718,22222,496,22222,22222,22726,22158,568,22158
12019,36135,36125,35246,879,35246,35246,36135,33705,2430,33705
12020,102757,79406,77016,2390,77016,77016,79428,75326,4102,75326
12021,120292,119467,116985,2482,116985,116985,119439,116044,3395,116044
12022,33272,32125,31627,498,31627,31627,32149,31220,929,31220
12023,62140,63081,62333,748,62333,62140,63085,62082,1003,62082
12024,2034,2035,2223,-188,2035,2034,2034,1960,74,1960
12025,473506,454189,441782,12407,441782,441782,454131,437628,16503,437628
12026,14009,13252,13253,-1,13252,13252,13263,12786,477,12786
12027,9995,9159,9010,149,9010,9010,9162,8654,508,8654
12028,24647,23273,21692,1581,21692,21692,23274,20838,2436,20838
12029,47369,49192,47354,1838,47354,47354,49151,47191,1960,47191
12030,6063,6346,6492,-146,6346,6063,6349,6042,307,6042
12031,15323,15338,15326,12,15326,15323,15339,15153,186,15153
12032,87849,87834,84576,3258,84576,84576,87835,83794,4041,83794
12033,68141,67305,66540,765,66540,66540,67298,65532,1766,65532
12034,25284,24156,23414,742,23414,23414,24149,23299,850,23299
12035,918484,859423,784157,75266,784157,784157,859814,756137,103677,756137
12036,20288,20288,19460,828,19460,19460,20288,19324,964,19324
12037,74056,70846,66969,3877,66969,66969,70855,66771,4084,66771
12038,1891,1497,1727,-230,1497,1497,1497,1548,-51,1548
12039,1000,610,840,-230,610,610,610,658,-48,658
12040,1164,774,992,-218,774,774,774,818,-44,818
12041,5287,5186,5227,-41,5186,5186,5191,4893,298,4893
12042,14872,14812,15051,-239,14812,14812,14815,14763,52,14763
12043,10592,10037,9767,270,9767,9767,10044,9586,458,9586
12044,14798,14379,13840,539,13840,13840,14392,13747,645,13747
12045,7194,6598,6929,-331,6598,6598,6602,6623,-21,6623
12046,332544,344116,332498,11618,332498,332498,344168,328400,15768,328400
12047,3764,3639,3704,-65,3639,3639,3639,3529,110,3529
12048,436762,436634,428976,7658,428976,428976,436656,423033,13623,423033
12049,97991,97935,100064,-2129,97935,97935,97933,94574,3359,94574
12050,54205,53502,52435,1067,52435,52435,53517,52055,1462,52055
12051,181123,187657,181072,6585,181072,181072,187666,181056,6610,181056
12052,10670,10215,10131,84,10131,10131,10210,9959,251,9959
12053,13661,13111,12884,227,12884,12884,13107,12585,522,12585
12054,38248,38235,38510,-275,38235,38235,38248,38055,193,38055
12055,204045,181802,174775,7027,174775,174775,181841,172717,9124,172717
12056,22312,21458,20385,1073,20385,20385,21464,19575,1889,19575
12057,60348,59489,58182,1307,58182,58182,59508,57049,2459,57049
12058,12828,12275,11995,280,11995,11995,12274,11820,454,11820
12059,209368,208401,214316,-5915,208401,208401,208596,206646,1950,206646
12060,18429,18697,18359,338,18359,18359,18696,18080,616,18080
12061,94093,68248,64359,3889,64359,64359,68286,63206,5080,63206
12062,16091,16463,16091,372,16091,16091,16467,15944,523,15944
12063,954,285,519,-234,285,285,285,332,-47,332
12064,84643,65491,64290,1201,64290,64290,65471,63643,1828,63643
12065,17409,17673,17576,97,17576,17409,17677,17409,268,17409
12066,4031,1494,1707,-213,1494,1494,1493,1553,-60,1553
12067,14585,14585,14643,-58,14585,14585,14585,14333,252,14333
12068,13801,13797,13156,641,13156,13156,13801,12989,812,12989
12069,64426,61917,60124,1793,60124,60124,61914,60042,1872,60042
12070,44369,45263,44361,902,44361,44361,45260,43978,1282,43978
12071,6567,6173,6145,28,6145,6145,6171,5989,182,5989
12072,7603,7208,7233,-25,7208,7208,7209,7101,108,7101
12073,11934,11359,11478,-119,11359,11359,11365,11195,170,11195
12074,6446,6406,6513,-107,6406,6406,6404,6351,53,6351
12075,44858,43682,43130,552,43130,43130,43684,42604,1080,42604
12076,102660,102618,99512,3106,99512,99512,102660,98143,4517,98143
12077,11565,10728,10521,207,10521,10521,10726,8429,2297,8429
12078,22565,2529,2675,-146,2529,2529,2530,2538,-8,2538
12079,14278,14610,14278,332,14278,14278,14609,14180,429,14180
12080,26666,26076,25562,514,25562,25562,26077,25386,691,25386
12081,89647,90919,91018,-99,90919,89647,90963,89639,1324,89639
12082,11853,11852,11635,217,11635,11635,11853,11494,359,11494
12083,1407374,64358,61316,3042,61316,61316,64345,61167,3178,61167
12084,1197,395,638,-243,395,395,394,445,-51,445
12085,48472,50422,48567,1855,48567,48472,50435,47850,2585,47850
12086,5826,5789,5829,-40,5789,5789,5792,5725,67,5725
12087,5232,4700,4902,-202,4700,4700,4701,4598,103,4598
12088,47794,47753,46188,1565,46188,46188,47768,45928,1840,45928
12089,119876,118924,118403,521,118403,118403,118969,113486,5483,113486
12090,19268,19260,18954,306,18954,18954,19268,18731,537,18731
12091,3043,2438,2571,-133,2438,2438,2439,2359,80,2359
12092,36582,35395,35433,-38,35395,35395,35420,34788,632,34788
12093,11685,11685,11614,71,11614,11614,11685,11441,244,11441
12094,179844,169757,165107,4650,165107,165107,169778,163290,6488,163290
12095,10150,9600,9322,278,9322,9322,9596,9012,584,9012
12096,5737,5663,5736,-73,5663,5663,5664,5587,77,5587
12097,10520,10975,10886,89,10886,10520,10978,10520,458,10520
12098,13670,13670,13385,285,13385,13385,13670,13292,378,13292
12099,314321,257062,245214,11848,245214,245214,257146,241707,15439,241707
12100,4972,6265,6492,-227,6265,4972,6265,4964,1301,4964
12101,125845,131719,127917,3802,127917,125845,131713,126204,5509,125845
12102,2736,1552,1781,-229,1552,1552,1552,1594,-42,1594
12103,33447,32576,31385,1191,31385,31385,32569,31065,1504,31065
12104,21303,21285,20588,697,20588,20588,21303,20435,868,20435
12105,6108,6051,6038,13,6038,6038,6047,5909,138,5909
12106,239862,242530,233745,8785,233745,233745,242530,232822,9708,232822
12107,3570,3535,3748,-213,3535,3535,3534,3559,-25,3559
12108,415440,415412,393705,21707,393705,393705,415328,393415,21913,393415
12109,121950,127975,121925,6050,121925,121925,127921,121869,6052,121869
12110,23566,22805,22895,-90,22805,22805,22806,22284,522,22284
12111,2986,2143,2326,-183,2143,2143,2143,2138,5,2138
12112,73076,31674,29766,1908,29766,29766,31668,27577,4091,27577
12113,573275,503403,474632,28771,474632,474632,503496,465464,38032,465464
12114,12375,12531,12373,158,12373,12373,12536,12215,321,12215
12115,33632,32865,31355,1510,31355,31355,32883,31228,1655,31228
12116,14106,13590,13166,424,13166,13166,13590,13055,535,13055
12117,9233,8806,8705,101,8705,8705,8808,8587,221,8587
12118,29681,26878,26289,589,26289,26289,26889,25117,1772,25117
12119,19737,18887,18897,-10,18887,18887,18890,18674,216,18674
12120,18060,18218,17995,223,17995,17995,18223,17762,461,17762
12121,99786,101830,103324,-1494,101830,99786,101873,99778,2095,99778
12122,37409,39273,37249,2024,37249,37249,39284,36943,2341,36943
12123,34603,34583,34854,-271,34583,34583,34603,33481,1122,33481
12124,14804,14808,14892,-84,14808,14804,14804,14488,316,14488
12125,11557,11436,11651,-215,11436,11436,11437,11447,-10,11447
12126,16855,16738,16987,-249,16738,16738,16730,16740,-10,16740
12127,112699,119428,117496,1932,117496,112699,119515,112865,6650,112699
12128,2961,2747,2961,-214,2747,2747,2748,2803,-55,2803
12129,11381,11724,11517,207,11517,11381,11728,10759,969,10759
12130,124094,124085,119253,4832,119253,119253,124094,118553,5541,118553
12131,655679,654602,629372,25230,629372,629372,654595,624903,29692,624903
12132,137542,143742,137998,5744,137998,137542,143744,137534,6210,137534
12133,105869,108741,105841,2900,105841,105841,108732,104833,3899,104833
12134,43922,44482,43902,580,43902,43902,44487,42837,1650,42837
12135,6534,6491,6504,-13,6491,6491,6498,6249,249,6249
12136,17747,15016,14538,478,14538,14538,15021,14439,582,14439
12137,197751,184351,172572,11779,172572,172572,184416,170101,14315,170101
12138,77576,44285,43277,1008,43277,43277,44285,43228,1057,43228
12139,305383,304469,292144,12325,292144,292144,304506,289070,15436,289070
12140,53927,53738,52224,1514,52224,52224,53755,51879,1876,51879
12141,63806,65938,63730,2208,63730,63730,65954,63494,2460,63494
12142,30892,30842,30193,649,30193,30193,30853,29694,1159,29694
12143,38662,37818,36542,1276,36542,36542,37828,36149,1679,36149
12144,264923,260594,251814,8780,251814,251814,260650,250955,9695,250955
12145,20425,20345,19014,1331,19014,19014,20363,18949,1414,18949
12146,2228,1861,2096,-235,1861,1861,1859,1911,-52,1911
12147,4855,4833,5029,-196,4833,4833,4831,4896,-65,4855
12148,1948,1950,2137,-187,1950,1948,1948,2007,-59,1948
12149,11594,10976,11080,-104,10976,10976,10985,10848,137,10848
12150,668309,710429,673747,36682,673747,668309,710466,668309,42157,668309
12151,401,291,525,-234,291,291,291,336,-45,336
12152,83916,83629,78817,4812,78817,78817,83628,77776,5852,77776
12153,6972,6246,6084,162,6084,6084,6248,5706,542,5706
12154,46542,45420,43303,2117,43303,43303,45425,43054,2371,43054
12155,52948,51986,49694,2292,49694,49694,51993,49584,2409,49584
12156,17074,16101,16132,-31,16101,16101,16103,15603,500,15603
12157,7735,7380,7673,-293,7380,7380,7382,7390,-8,7390
12158,4692,4694,4905,-211,4694,4692,4692,4707,-15,4692
12159,10712,10967,10712,255,10712,10712,10975,10278,697,10278
12160,338015,365849,337956,27893,337956,337956,365675,336865,28810,336865
12161,209765,193911,192039,1872,192039,192039,193922,168887,25035,168887
12162,13335,14075,13933,142,13933,13335,14083,12713,1370,12713
12163,7938,6598,6915,-317,6598,6598,6600,6600,0,6600
12164,53214,25989,25713,276,25713,25713,25993,25049,944,25049
12165,4085,4089,4375,-286,4089,4085,4085,3818,267,3818
12166,29428,30379,29421,958,29421,29421,30380,28040,2340,28040
12167,137171,133859,132425,1434,132425,132425,133809,131111,2698,131111
12168,1390585,1206694,1133924,72770,1133924,1133924,1206959,1103609,103350,1103609
12169,10993,11005,11194,-189,11005,10993,11009,10573,436,10573
12170,3213,2795,2939,-144,2795,2795,2795,2803,-8,2803
12171,4878,4571,4871,-300,4571,4571,4571,4154,417,4154
12172,154880,160364,156133,4231,156133,154880,160366,154872,5494,154872
12173,21214,21187,21112,75,21112,21112,21199,20592,607,20592
12174,170351,167778,165500,2278,165500,165500,167789,164551,3238,164551
12175,632003,630772,604299,26473,604299,604299,631035,603955,27080,603955
12176,12151,12151,12094,57,12094,12094,12151,11935,216,11935
12177,149073,152054,148324,3730,148324,148324,152106,148738,3368,148738
12178,401063,365718,353728,11990,353728,353728,365805,347162,18643,347162
12179,16175,16179,16000,179,16000,16000,16175,15818,357,15818
12180,111378,82505,81256,1249,81256,81256,82452,80414,2038,80414
12181,78985,74639,69610,5029,69610,69610,74691,66771,7920,66771
12182,16106,14911,14555,356,14555,14555,14917,13850,1067,13850
12183,931,529,771,-242,529,529,529,563,-34,563
12184,106966,127111,129605,-2494,127111,106966,127113,106958,20155,106958
12185,100993,100917,99456,1461,99456,99456,100950,97795,3155,97795
12186,11677,12147,11680,467,11680,11677,12146,11469,677,11469
12187,2868,2873,2984,-111,2873,2868,2868,2799,69,2799
12188,2703,2504,2703,-199,2504,2504,2505,2555,-50,2555
12189,246820,246771,240287,6484,240287,240287,246717,236689,10028,236689
12190,111721,107423,105662,1761,105662,105662,107480,104253,3227,104253
12191,118701,117491,110643,6848,110643,110643,117516,109746,7770,109746
12192,9130,9131,8952,179,8952,8952,9130,8867,263,8867
12193,45975,45068,42701,2367,42701,42701,45098,42638,2460,42638
12194,20471,20792,20471,321,20471,20471,20795,20131,664,20131
12195,3184,2863,3032,-169,2863,2863,2862,2873,-11,2873
12196,163696,163572,159101,4471,159101,159101,163584,158104,5480,158104
12197,44000,39974,38295,1679,38295,38295,39975,37618,2357,37618
12198,20560,20574,19928,646,19928,19928,20560,19753,807,19753
12199,293477,283711,267947,15764,267947,267947,283882,260128,23754,260128
12200,12540,12071,12100,-29,12071,12071,12070,11815,255,11815
12201,147379,119852,113047,6805,113047,113047,119824,111862,7962,111862
12202,24232,24637,24215,422,24215,24215,24620,23869,751,23869
12203,16311,16967,16314,653,16314,16311,16968,15964,1004,15964
12204,80603,85443,86794,-1351,85443,80603,85453,81902,3551,80603
12205,703278,145956,135322,10634,135322,135322,145930,131416,14514,131416
12206,186166,185296,179187,6109,179187,179187,185300,178438,6862,178438
12207,106500,106501,103991,2510,103991,103991,106500,103321,3179,103321
12208,46363,46360,45613,747,45613,45613,46363,45141,1222,45141
12209,3803,3661,3837,-176,3661,3661,3661,3622,39,3622
12210,4152,4114,4346,-232,4114,4114,4115,4150,-35,4150
12211,58908,41384,40538,846,40538,40538,41386,40257,1129,40257
12212,79118,77685,74603,3082,74603,74603,77704,74419,3285,74419
12213,180878,179928,168065,11863,168065,168065,180020,164776,15244,164776
12214,404558,414052,407228,6824,407228,404558,413942,404550,9392,404550
12215,26514,27066,26494,572,26494,26494,27086,25514,1572,25514
12216,12276,11834,11458,376,11458,11458,11828,11336,492,11336
12217,5034,4152,4267,-115,4152,4152,4149,4162,-13,4162
12218,98414,96141,95017,1124,95017,95017,96194,93414,2780,93414
12219,17802,17792,17546,246,17546,17546,17802,17106,696,17106
12220,29314,31093,29309,1784,29309,29309,31080,29113,1967,29113
12221,105026,105056,100794,4262,100794,100794,105026,100716,4310,100716
12222,8378,7999,8178,-179,7999,7999,7995,7945,50,7945
12223,29914,29913,30158,-245,29913,29913,29932,29265,667,29265
12224,1731,770,1025,-255,770,770,770,824,-54,824
12225,1404,1024,1283,-259,1024,1024,1024,1077,-53,1077
12226,194004,161085,152192,8893,152192,152192,161166,148224,12942,148224
12227,214320,214131,214369,-238,214131,214131,214320,212106,2214,212106
12228,22527,21906,21320,586,21320,21320,21914,20847,1067,20847
12229,34831,34801,34541,260,34541,34541,34831,33602,1229,33602
12230,100878,100856,97689,3167,97689,97689,100878,96895,3983,96895
12231,43058,42129,40495,1634,40495,40495,42124,39859,2265,39859
12232,1270,789,1044,-255,789,789,789,834,-45,834
12233,15960,15291,14826,465,14826,14826,15290,14782,508,14782
12234,73509,74989,73496,1493,73496,73496,75015,73072,1943,73072
12235,56710,53429,50133,3296,50133,50133,53429,49867,3562,49867
12236,1073230,978853,952630,26223,952630,952630,979153,948152,31001,948152
12237,109907,81337,78422,2915,78422,78422,81335,71610,9725,71610
12238,499,342,467,-125,342,342,341,352,-11,352
12239,81407,78147,78222,-75,78147,78147,78206,77120,1086,77120
12240,69413,69401,71435,-2034,69401,69401,69442,68162,1280,68162
12241,264246,261039,246080,14959,246080,246080,260886,244879,16007,244879
12242,2542,2294,2481,-187,2294,2294,2295,2312,-17,2312
12243,3768,3370,3630,-260,3370,3370,3375,3403,-28,3403
12244,13689,13106,13096,10,13096,13096,13108,12795,313,12795
12245,16398,15004,14336,668,14336,14336,15014,14170,844,14170
12246,114515,114347,109181,5166,109181,109181,114360,108376,5984,108376
12247,25028,24775,24567,208,24567,24567,24779,24406,373,24406
12248,67944,65719,62430,3289,62430,62430,65711,62188,3523,62188
12249,34797,34789,34169,620,34169,34169,34797,33478,1319,33478
12250,186636,186554,190636,-4082,186554,186554,186636,182442,4194,182442
12251,16095,16026,16184,-158,16026,16026,16027,15936,91,15936
12252,27362,28976,27299,1677,27299,27299,28975,27032,1943,27032
12253,5612,4956,5190,-234,4956,4956,4958,4883,75,4883
12254,3524,3333,3459,-126,3333,3333,3333,3342,-9,3342
12255,46907,45795,45044,751,45044,45044,45809,44825,984,44825
12256,113752,113642,108279,5363,108279,108279,113681,106343,7338,106343
12257,20699,22923,22387,536,22387,20699,22922,20666,2256,20666
12258,805,708,958,-250,708,708,708,762,-54,762
12259,495960,512594,502906,9688,502906,495960,512802,497817,14985,495960
12260,42400,36900,34996,1904,34996,34996,36915,34625,2290,34625
12261,1731,820,1056,-236,820,820,820,866,-46,866
12262,32409,16599,16175,424,16175,16175,16611,16075,536,16075
12263,20252,20244,20247,-3,20244,20244,20252,19889,363,19889
12264,50325,47999,44189,3810,44189,44189,48006,44093,3913,44093
12265,1148,962,1148,-186,962,962,962,938,24,938
12266,441894,442231,420306,21925,420306,420306,442225,419925,22300,419925
12267,216929,215923,203933,11990,203933,203933,215948,202263,13685,202263
12268,12980,13058,12976,82,12976,12976,13060,12797,263,12797
12269,51743,49635,50586,-951,49635,49635,49639,44364,5275,44364
12270,8459,7517,7415,102,7415,7415,7517,7297,220,7297
12271,105503,105485,104282,1203,104282,104282,105503,103023,2480,103023
12272,17630,14110,14437,-327,14110,14110,14113,14032,81,14032
12273,12096,11163,10924,239,10924,10924,11158,10868,290,10868
12274,2492,2192,2431,-239,2192,2192,2193,2245,-52,2245
12275,75991,72198,69400,2798,69400,69400,72223,67352,4871,67352
12276,42428,42414,41667,747,41667,41667,42428,40470,1958,40470
12277,7479,7479,7403,76,7403,7403,7479,7039,440,7039
12278,3916,3917,4060,-143,3917,3916,3916,3894,22,3894
12279,42188,42161,40332,1829,40332,40332,42188,39504,2684,39504
12280,7920,7366,7553,-187,7366,7366,7366,7243,123,7243
12281,93499,92038,88060,3978,88060,88060,92036,87827,4209,87827
12282,3511,3298,3451,-153,3298,3298,3296,3301,-5,3301
12283,349799,349866,329672,20194,329672,329672,349799,327658,22141,327658
12284,7302,7300,7417,-117,7300,7300,7302,7189,113,7189
12285,18425,18299,18081,218,18081,18081,18305,17609,696,17609
12286,3504,3502,3629,-127,3502,3502,3504,3461,43,3461
12287,371828,381035,380410,625,380410,371828,381030,371820,9210,371820
12288,132603,98380,94287,4093,94287,94287,98392,92387,6005,92387
12289,244462,248134,243683,4451,243683,243683,248228,241856,6372,241856
12290,93268,92287,92049,238,92049,92049,92324,88728,3596,88728
12291,126759,129700,122929,6771,122929,122929,129789,122881,6908,122881
12292,3861,3310,3485,-175,3310,3310,3313,3295,18,3295
12293,5921,6036,5920,116,5920,5920,6038,5798,240,5798
12294,75622,78903,76794,2109,76794,75622,78923,76110,2813,75622
12295,30382,30348,29632,716,29632,29632,30356,29528,828,29528
12296,64307,64249,62802,1447,62802,62802,64284,62099,2185,62099
12297,59952,19190,18627,563,18627,18627,19185,18439,746,18439
12298,5047,4111,4299,-188,4111,4111,4112,3966,146,3966
12299,371269,369387,358469,10918,358469,358469,369395,356351,13044,356351
12300,146591,146516,140762,5754,140762,140762,146558,139880,6678,139880
12301,12513,12463,12132,331,12132,12132,12465,11951,514,11951
12302,11033,10242,10210,32,10210,10210,10240,10027,213,10027
12303,155126,154496,151187,3309,151187,151187,154518,150675,3843,150675
12304,4463,4043,4153,-110,4043,4043,4046,4005,41,4005
12305,6019,6013,6202,-189,6013,6013,6019,5930,89,5930
12306,71200,72996,71751,1245,71751,71200,72994,71348,1646,71200
12307,20852,9845,11011,-1166,9845,9845,9845,7778,2067,7778
12308,24644,25785,24646,1139,24646,24644,25805,24590,1215,24590
12309,17614,17085,16790,295,16790,16790,17088,16624,464,16624
12310,23596,16575,16031,544,16031,16031,16574,15949,625,15949
12311,8497,7906,8220,-314,7906,7906,7910,7941,-31,7941
12312,3380,3380,3504,-124,3380,3380,3380,3358,22,3358
12313,1032,471,712,-241,471,471,471,517,-46,517
12314,1524,1271,1525,-254,1271,1271,1269,1315,-46,1315
12315,30960,30293,29992,301,29992,29992,30308,29766,542,29766
12316,16353,16932,17665,-733,16932,16353,16924,16300,624,16300
12317,579127,14047,14011,36,14011,14011,14042,13450,592,13450
12318,23016,22301,21570,731,21570,21570,22311,21499,812,21499
12319,88106,88132,81810,6322,81810,81810,88106,81218,6888,81218
12320,9579,9581,9865,-284,9581,9579,9579,9549,30,9549
12321,1962,1543,1773,-230,1543,1543,1546,1576,-30,1576
12322,1959,1010,1255,-245,1010,1010,1010,1060,-50,1060
12323,48666,46846,44241,2605,44241,44241,46876,44126,2750,44126
12324,128633,90315,86664,3651,86664,86664,90318,83862,6456,83862
12325,2339,1422,1648,-226,1422,1422,1422,1466,-44,1466
12326,11309,7087,7287,-200,7087,7087,7089,7031,58,7031
12327,85368,85233,80088,5145,80088,80088,85233,78744,6489,78744
12328,1959,1059,1256,-197,1059,1059,1058,1103,-45,1103
12329,21441,21390,20844,546,20844,20844,21390,20670,720,20670
12330,33854,34993,33508,1485,33508,33508,34976,33366,1610,33366
12331,100750,68252,65197,3055,65197,65197,68282,62960,5322,62960
12332,6290,6187,6515,-328,6187,6187,6186,6246,-60,6246
12333,2613,2159,2323,-164,2159,2159,2158,2145,13,2145
12334,98081,88016,82677,5339,82677,82677,88008,81241,6767,81241
12335,63700,63336,65174,-1838,63336,63336,63359,61704,1655,61704
12336,105993,105824,103876,1948,103876,103876,105841,102701,3140,102701
12337,77211,56893,52230,4663,52230,52230,56915,47971,8944,47971
12338,290860,244099,233232,10867,233232,233232,244118,230188,13930,230188
12339,2741,2351,2509,-158,2351,2351,2352,2381,-29,2381
12340,953,284,518,-234,284,284,284,331,-47,331
12341,76559,76530,72279,4251,72279,72279,76507,71973,4534,71973
12342,5849,5008,5205,-197,5008,5008,5006,5012,-6,5012
12343,162468,161470,160021,1449,160021,160021,161526,157938,3588,157938
12344,9320,8396,8566,-170,8396,8396,8399,8215,184,8215
12345,89743,62344,59301,3043,59301,59301,62326,58726,3600,58726
12346,32685,33205,31608,1597,31608,31608,33194,31535,1659,31535
12347,21782,21784,21358,426,21358,21358,21782,21150,632,21150
12348,103552,107638,103958,3680,103958,103552,107661,103519,4142,103519
12349,2592,2224,2398,-174,2224,2224,2224,2235,-11,2235
12350,22696,22169,21604,565,21604,21604,22166,21475,691,21475
12351,7165,6581,6753,-172,6581,6581,6586,6348,238,6348
12352,624977,604478,572264,32214,572264,572264,604551,561890,42661,561890
12353,79162,79078,77943,1135,77943,77943,79101,77050,2051,77050
12354,8530,7686,7578,108,7578,7578,7695,7439,256,7439
12355,133315,105122,100645,4477,100645,100645,105129,99539,5590,99539
12356,21307,21954,21242,712,21242,21242,21953,20816,1137,20816
12357,4258,4098,4197,-99,4098,4098,4094,3878,216,3878
12358,4774,4772,4901,-129,4772,4772,4774,4751,23,4751
12359,88722,78481,75023,3458,75023,75023,78493,74272,4221,74272
12360,31503,30651,30129,522,30129,30129,30660,30039,621,30039
12361,10155,9322,9559,-237,9322,9322,9325,7633,1692,7633
12362,44564,44888,44554,334,44554,44554,44886,42545,2341,42545
12363,54917,53977,52543,1434,52543,52543,53980,51985,1995,51985
12364,59075,59057,56547,2510,56547,56547,59075,55700,3375,55700
12365,15959,15947,16300,-353,15947,15947,15959,15913,46,15913
12366,24458,24450,23821,629,23821,23821,24458,23711,747,23711
12367,38488,40009,38846,1163,38846,38488,40018,38480,1538,38480
12368,58799,61066,59592,1474,59592,58799,61072,58918,2154,58799
12369,8813,8758,8956,-198,8758,8758,8761,8743,18,8743
12370,356533,376658,358887,17771,358887,356533,376583,353113,23470,353113
12371,7009,6825,7007,-182,6825,6825,6825,6806,19,6806
12372,124075,124024,124860,-836,124024,124024,124075,121830,2245,121830
12373,883,708,976,-268,708,708,708,757,-49,757
12374,356015,285410,264693,20717,264693,264693,285517,250839,34678,250839
12375,35362,31341,29360,1981,29360,29360,31353,28568,2785,28568
12376,196162,188499,189843,-1344,188499,188499,188603,187189,1414,187189
12377,18645,18644,18272,372,18272,18272,18645,18037,608,18037
12378,20232,20232,19445,787,19445,19445,20232,19290,942,19290
12379,37791,35335,34081,1254,34081,34081,35336,33911,1425,33911
12380,25999,26251,25998,253,25998,25998,26238,25789,449,25789
12381,355751,347240,344158,3082,344158,344158,347224,336339,10885,336339
12382,168294,171998,170019,1979,170019,168294,172061,168701,3360,168294
12383,12766,9901,9721,180,9721,9721,9910,9619,291,9619
12384,1649,1477,1723,-246,1477,1477,1477,1512,-35,1512
12385,434166,408007,397712,10295,397712,397712,408199,394489,13710,394489
12386,138512,141632,137126,4506,137126,137126,141638,135117,6521,135117
12387,33142,33166,31929,1237,31929,31929,33173,31673,1500,31673
12388,35008,34991,33233,1758,33233,33233,35008,33128,1880,33128
12389,32174,31010,31292,-282,31010,31010,31009,30953,56,30953
12390,17828,8342,8317,25,8317,8317,8338,8199,139,8199
12391,12326,12326,12379,-53,12326,12326,12326,12077,249,12077
12392,24425,24407,23875,532,23875,23875,24425,23713,712,23713
12393,14381,13740,13611,129,13611,13611,13740,13404,336,13404
12394,3404243,104490,100794,3696,100794,100794,104507,99933,4574,99933
12395,2970,2974,3186,-212,2974,2970,2977,2979,-2,2970
12396,6326,6327,6533,-206,6327,6326,6326,6384,-58,6326
12397,1530,1108,1346,-238,1108,1108,1108,1135,-27,1135
12398,22688,21853,22041,-188,21853,21853,21848,21644,204,21644
12399,14681,14680,14641,39,14641,14641,14681,14464,217,14464
12400,25998,23934,22894,1040,22894,22894,23924,22825,1099,22825
12401,476001,477158,457128,20030,457128,457128,477189,450814,26375,450814
12402,43058,43056,43438,-382,43056,43056,43058,39009,4049,39009
12403,334124,334202,334166,36,334166,334124,334124,322683,11441,322683
12404,9282,9094,9218,-124,9094,9094,9099,8489,610,8489
12405,47872,31944,30510,1434,30510,30510,31970,29558,2412,29558
12406,7502,6976,6842,134,6842,6842,6978,6742,236,6742
12407,130139,97977,94713,3264,94713,94713,97998,94199,3799,94199
12408,109926,108868,105836,3032,105836,105836,108856,104971,3885,104971
12409,5435,4970,4987,-17,4970,4970,4972,4872,100,4872
12410,67566,39436,39106,330,39106,39106,39445,38272,1173,38272
12411,388,368,610,-242,368,368,368,415,-47,388
12412,5351,4793,5086,-293,4793,4793,4797,4795,2,4795
12413,38325,43334,40788,2546,40788,38325,43332,38317,5015,38317
12414,21542,22405,21880,525,21880,21542,22399,21534,865,21534
12415,426941,426406,406623,19783,406623,406623,426387,404387,22000,404387
12416,42840,44243,44029,214,44029,42840,44248,42832,1416,42832
12417,46786,49488,46720,2768,46720,46720,49510,46147,3363,46147
12418,6490,5862,6100,-238,5862,5862,5860,5758,102,5758
12419,15136,15538,14979,559,14979,14979,15532,14793,739,14793
12420,52448,51578,49374,2204,49374,49374,51581,48942,2639,48942
12421,11026,10666,11029,-363,10666,10666,10678,10637,41,10637
12422,6395,6903,6975,-72,6903,6395,6905,6360,545,6360
12423,411,411,649,-238,411,411,411,462,-51,411
12424,12448,11996,11832,164,11832,11832,11997,11715,282,11715
12425,9242,9055,9176,-121,9055,9055,9057,8798,259,8798
12426,6350,5948,6018,-70,5948,5948,5945,5803,142,5803
12427,22293,21713,20921,792,20921,20921,21717,20833,884,20833
12428,43656,45226,43654,1572,43654,43654,45230,43508,1722,43508
12429,8478,8494,8267,227,8267,8267,8496,8000,496,8000
12430,13278,13732,13285,447,13285,13278,13734,13139,595,13139
12431,40102,40021,37769,2252,37769,37769,40041,37671,2370,37671
12432,167730,164546,161344,3202,161344,161344,164568,158483,6085,158483
12433,137710,134027,133011,1016,133011,133011,133997,132546,1451,132546
12434,2810,2749,3048,-299,2749,2749,2747,2763,-16,2763
12435,13586,14240,13585,655,13585,13585,14238,13101,1137,13101
12436,35287,16876,16751,125,16751,16751,16876,16588,288,16588
12437,9922,9437,9413,24,9413,9413,9437,9281,156,9281
12438,19760,17912,17276,636,17276,17276,17914,16639,1275,16639
12439,12015,11434,11061,373,11061,11061,11438,11002,436,11002
12440,37930,37913,37368,545,37368,37368,37914,36758,1156,36758
12441,42184,34053,32800,1253,32800,32800,34056,32540,1516,32540
12442,180810,174798,175403,-605,174798,174798,174958,163196,11762,163196
12443,924863,908470,870976,37494,870976,870976,908393,862768,45625,862768
12444,78013,9268,9241,27,9241,9241,9269,9176,93,9176
12445,3365,2934,3042,-108,2934,2934,2935,2878,57,2878
12446,677196,676016,664064,11952,664064,664064,676164,658473,17691,658473
12447,56670,55741,54639,1102,54639,54639,55769,53728,2041,53728
12448,11283,10430,10786,-356,10430,10430,10434,10480,-46,10480
12449,6069,5433,5407,26,5407,5407,5437,5184,253,5184
12450,39386,31479,29023,2456,29023,29023,31473,26665,4808,26665
12451,53202,53484,53068,416,53068,53068,53493,52580,913,52580
12452,2909047,2806160,2633719,172441,2633719,2633719,2805822,2595993,209829,2595993
12453,40884,42309,40818,1491,40818,40818,42308,39767,2541,39767
12454,17273,16401,16444,-43,16401,16401,16426,16244,182,16244
12455,84995,81817,79747,2070,79747,79747,81845,79096,2749,79096
12456,31042,35286,35460,-174,35286,31042,35284,31675,3609,31042
12457,26027,25995,25733,262,25733,25733,26011,23553,2458,23553
12458,78213,76921,73447,3474,73447,73447,76919,73091,3828,73091
12459,64004,55456,51879,3577,51879,51879,55463,51518,3945,51518
12460,188018,188002,180879,7123,180879,180879,187962,179885,8077,179885
12461,5705,4855,5034,-179,4855,4855,4856,4580,276,4580
12462,19719,19721,18880,841,18880,18880,19719,18813,906,18813
12463,96533,86994,82737,4257,82737,82737,87098,82544,4554,82544
12464,4040,3607,3778,-171,3607,3607,3605,3653,-48,3653
12465,89315,85565,83027,2538,83027,83027,85599,81658,3941,81658
12466,9370,9367,9573,-206,9367,9367,9369,9247,122,9247
12467,41976,39960,40929,-969,39960,39960,39973,39084,889,39084
12468,12573,11641,11483,158,11483,11483,11636,11263,373,11263
12469,83805,59857,59786,71,59786,59786,59868,58454,1414,58454
12470,48603,47647,49939,-2292,47647,47647,47674,46982,692,46982
12471,42854,39484,38991,493,38991,38991,39498,38059,1439,38059
12472,17117,894,1123,-229,894,894,894,953,-59,953
12473,25529,24969,25368,-399,24969,24969,24979,24907,72,24907
12474,7959,7529,7878,-349,7529,7529,7533,7558,-25,7558
12475,387063,293310,276536,16774,276536,276536,293264,268121,25143,268121
12476,2941,2666,2879,-213,2666,2666,2667,2716,-49,2716
12477,38581,37313,35669,1644,35669,35669,37324,35364,1960,35364
12478,8815,8271,8443,-172,8271,8271,8268,8228,40,8228
12479,11348,11343,10936,407,10936,10936,11348,10608,740,10608
12480,2836,2440,2657,-217,2440,2440,2442,2472,-30,2472
12481,48453,47311,44613,2698,44613,44613,47313,44448,2865,44448
12482,5665,5679,5675,4,5675,5665,5683,5254,429,5254
12483,23807,22908,22389,519,22389,22389,22910,22114,796,22114
12484,14375,14780,14384,396,14384,14375,14778,14244,534,14244
12485,148567,132470,129541,2929,129541,129541,132477,128065,4412,128065
12486,19236,19752,19548,204,19548,19236,19760,19249,511,19236
12487,6905,5968,5950,18,5950,5950,5968,5816,152,5816
12488,428650,406296,384389,21907,384389,384389,406330,382889,23441,382889
12489,352836,305428,305099,329,305099,305099,305609,298726,6883,298726
12490,31874,34095,31808,2287,31808,31808,34102,31657,2445,31657
12491,61298,61271,61068,203,61068,61068,61298,60472,826,60472
12492,18668,18700,18616,84,18616,18616,18684,18497,187,18497
12493,31542,31649,31542,107,31542,31542,31664,31074,590,31074
12494,8951,8434,8435,-1,8434,8434,8435,8344,91,8344
12495,11720,12234,12145,89,12145,11720,12237,11098,1139,11098
12496,24777,24185,23626,559,23626,23626,24177,23485,692,23485
12497,401147,354552,337097,17455,337097,337097,354354,335937,18417,335937
12498,394130,393174,374270,18904,374270,374270,393139,373023,20116,373023
12499,51158,49770,49478,292,49478,49478,49792,48933,859,48933
12500,1860,1860,2113,-253,1860,1860,1860,1880,-20,1860
12501,70045,69957,66933,3024,66933,66933,69951,65419,4532,65419
12502,26237,26202,26167,35,26167,26167,26215,25812,403,25812
12503,3378,3227,3317,-90,3227,3227,3227,3180,47,3180
12504,499290,498387,486212,12175,486212,486212,498503,475940,22563,475940
12505,72052,72039,70666,1373,70666,70666,72052,69612,2440,69612
12506,469,469,723,-254,469,469,469,523,-54,469
12507,1576,903,1187,-284,903,903,905,954,-49,954
12508,67092,65212,63729,1483,63729,63729,65247,63539,1708,63539
12509,14586,15863,15530,333,15530,14586,15861,14601,1260,14586
12510,236981,223025,215404,7621,215404,215404,223115,214425,8690,214425
12511,786123,698439,674777,23662,674777,674777,698821,666666,32155,666666
12512,38162,25435,26876,-1441,25435,25435,25439,24892,547,24892
12513,195741,195734,185263,10471,185263,185263,195741,183727,12014,183727
12514,20324,19463,18902,561,18902,18902,19473,18601,872,18601
12515,15756,15040,14922,118,14922,14922,15038,14735,303,14735
12516,4790,4802,4952,-150,4802,4790,4808,4503,305,4503
12517,145936,154138,145204,8934,145204,145204,154220,138786,15434,138786
12518,3194,2800,2977,-177,2800,2800,2801,2821,-20,2821
12519,6157,5489,5469,20,5469,5469,5486,5310,176,5310
12520,33771,33771,32724,1047,32724,32724,33775,32536,1239,32536
12521,258053,265018,268418,-3400,265018,258053,265187,258045,7142,258045
12522,657528,657836,621843,35993,621843,621843,657528,616895,40633,616895
12523,42420,43393,42414,979,42414,42414,43381,42175,1206,42175
12524,52327,48827,45058,3769,45058,45058,48810,44921,3889,44921
12525,3582,3576,3768,-192,3576,3576,3574,3595,-21,3582
12526,3135,3135,3342,-207,3135,3135,3135,3175,-40,3135
12527,256612,244289,229941,14348,229941,229941,244327,229277,15050,229277
12528,816,520,755,-235,520,520,520,572,-52,572
12529,10594,14996,14196,800,14196,10594,14997,9972,5025,9972
12530,10336,9743,9580,163,9580,9580,9746,9348,398,9348
12531,13748,12918,12555,363,12555,12555,12919,12229,690,12229
12532,15766,14590,14514,76,14514,14514,14603,14084,519,14084
12533,40281,40271,38050,2221,38050,38050,40281,36190,4091,36190
12534,7186,7156,6896,260,6896,6896,7153,6608,545,6608
12535,203736,167015,158647,8368,158647,158647,167034,157402,9632,157402
12536,77591,79742,78388,1354,78388,77591,79785,77918,1867,77591
12537,2693,2954,3028,-74,2954,2693,2954,2693,261,2693
12538,42888,44615,42877,1738,42877,42877,44622,42689,1933,42689
12539,95901,66277,63301,2976,63301,63301,66283,62501,3782,62501
12540,33439,35044,33270,1774,33270,33270,35057,32817,2240,32817
12541,82410,55971,53916,2055,53916,53916,55955,53777,2178,53777
12542,47632,48454,48634,-180,48454,47632,48461,47817,644,47632
12543,80077,70879,69175,1704,69175,69175,70887,68688,2199,68688
12544,14429,14772,14713,59,14713,14429,14783,14449,334,14429
12545,27230,26378,26477,-99,26378,26378,26365,26102,263,26102
12546,21355,21583,21346,237,21346,21346,21590,21367,223,21355
12547,47617,49262,47535,1727,47535,47535,49252,47406,1846,47406
12548,92882,82623,76616,6007,76616,76616,82636,72508,10128,72508
12549,3963,3592,3773,-181,3592,3592,3593,3592,1,3592
12550,89338,83088,81123,1965,81123,81123,83084,80121,2963,80121
12551,21294,21243,20823,420,20823,20823,21252,20587,665,20587
12552,6002,5553,5456,97,5456,5456,5551,5328,223,5328
12553,1116,1017,1283,-266,1017,1017,1017,1073,-56,1073
12554,254426,195817,190814,5003,190814,190814,195842,189375,6467,189375
12555,129837,118647,115346,3301,115346,115346,118684,114032,4652,114032
12556,535164,508186,483516,24670,483516,483516,508236,475882,32354,475882
12557,3678,3120,3309,-189,3120,3120,3119,3100,19,3100
12558,22148,18164,18642,-478,18164,18164,18165,18015,150,18015
12559,167761,166531,159019,7512,159019,159019,166604,156292,10312,156292
12560,57458,15286,15035,251,15035,15035,15284,14834,450,14834
12561,12451,12384,12125,259,12125,12125,12390,11971,419,11971
12562,4672,4601,4609,-8,4601,4601,4600,4246,354,4246
12563,177444,117920,116635,1285,116635,116635,117935,115451,2484,115451
12564,14011,14177,13951,226,13951,13951,14177,13096,1081,13096
12565,24823,24098,24259,-161,24098,24098,24105,23929,176,23929
12566,417283,357359,345760,11599,345760,345760,357420,344629,12791,344629
12567,2436,2036,2203,-167,2036,2036,2035,2068,-33,2068
12568,25286,25286,25419,-133,25286,25286,25286,25043,243,25043
12569,50943,53333,51071,2262,51071,50943,53338,50897,2441,50897
12570,25172,25216,25164,52,25164,25164,25224,24778,446,24778
12571,41908,43064,41901,1163,41901,41901,43060,41543,1517,41543
12572,98973,98923,97208,1715,97208,97208,98912,96170,2742,96170
12573,45310,49763,50110,-347,49763,45310,49756,44688,5068,44688
12574,43850,45075,44278,797,44278,43850,45087,43842,1245,43842
12575,23767,23766,22790,976,22790,22790,23767,22606,1161,22606
12576,116583,115693,116865,-1172,115693,115693,115720,113442,2278,113442
12577,45372,44417,42354,2063,42354,42354,44433,41870,2563,41870
12578,19365,5897,6071,-174,5897,5897,5900,5924,-24,5924
12579,109070,109583,109046,537,109046,109046,109618,107568,2050,107568
12580,11729,8565,8464,101,8464,8464,8567,8270,297,8270
12581,12234,12234,11969,265,11969,11969,12234,11769,465,11769
12582,54582,56117,59006,-2889,56117,54582,56111,54582,1529,54582
12583,13581,13575,13222,353,13222,13222,13581,13054,527,13054
12584,46371,47556,46321,1235,46321,46321,47552,45968,1584,45968
12585,6764,6763,6809,-46,6763,6763,6764,6636,128,6636
12586,2504,2482,2660,-178,2482,2482,2479,2505,-26,2504
12587,2477,2266,2418,-152,2266,2266,2270,2236,34,2236
12588,31864,31874,30029,1845,30029,30029,31864,29997,1867,29997
12589,33577,14036,13890,146,13890,13890,14037,13761,276,13761
12590,43181,43171,41882,1289,41882,41882,43181,41776,1405,41776
12591,9972,9413,9146,267,9146,9146,9414,9077,337,9077
12592,95490,98448,95941,2507,95941,95490,98464,95864,2600,95490
12593,1185,1123,1377,-254,1123,1123,1124,1149,-25,1149
12594,23446,23412,23519,-107,23412,23412,23412,23276,136,23276
12595,9316,8745,8466,279,8466,8466,8743,8135,608,8135
12596,20097,20091,19999,92,19999,19999,20084,19746,338,19746
12597,186495,199611,186507,13104,186507,186495,199656,184752,14904,184752
12598,1030404,1102570,1030353,72217,1030353,1030353,1101983,1012871,89112,1012871
12599,17929,17098,17454,-356,17098,17098,17106,17097,9,17097
12600,44010,32971,32481,490,32481,32481,32969,32113,856,32113
12601,1591,1208,1457,-249,1208,1208,1207,1254,-47,1254
12602,17096,16244,16678,-434,16244,16244,16248,16179,69,16179
12603,702933,674008,658500,15508,658500,658500,673965,654164,19801,654164
12604,10585,10553,10252,301,10252,10252,10559,10058,501,10058
12605,24295,24301,23839,462,23839,23839,24295,23713,582,23713
12606,36309,36263,35661,602,35661,35661,36273,34785,1488,34785
12607,36296,35035,31925,3110,31925,31925,35035,29775,5260,29775
12608,676,634,885,-251,634,634,634,676,-42,676
12609,78892,77404,77209,195,77209,77209,77420,75962,1458,75962
12610,5793,5251,5311,-60,5251,5251,5248,5006,242,5006
12611,269799,268902,260126,8776,260126,260126,268855,256442,12413,256442
12612,3138,2698,2932,-234,2698,2698,2699,2741,-42,2741
12613,42547,45197,42476,2721,42476,42476,45184,42369,2815,42369
12614,258230,234219,223521,10698,223521,223521,234338,221649,12689,221649
12615,11866,10956,10957,-1,10956,10956,10957,10686,271,10686
12616,6155,5637,5637,0,5637,5637,5634,5501,133,5501
12617,19012,21182,20195,987,20195,19012,21197,18390,2807,18390
12618,187562,192909,188640,4269,188640,187562,192930,186940,5990,186940
12619,142707,142613,140064,2549,140064,140064,142707,137583,5124,137583
12620,78133,82733,83801,-1068,82733,78133,82758,80697,2061,78133
12621,308564,307672,293900,13772,293900,293900,307554,289989,17565,289989
12622,136382,134635,133576,1059,133576,133576,134679,131939,2740,131939
12623,11035,1756,1954,-198,1756,1756,1758,1740,18,1740
12624,30668,29459,29177,282,29177,29177,29474,28693,781,28693
12625,1760,1739,1944,-205,1739,1739,1740,1718,22,1718
12626,16214,14294,14069,225,14069,14069,14294,13685,609,13685
12627,6027,5168,5187,-19,5168,5168,5164,4992,172,4992
12628,17103,17482,17097,385,17097,17097,17483,16672,811,16672
12629,3284,3242,3450,-208,3242,3242,3243,3298,-55,3284
12630,16076,8054,8030,24,8030,8030,8054,7911,143,7911
12631,204448,205848,194015,11833,194015,194015,205916,192752,13164,192752
12632,464779,471903,464784,7119,464784,464779,471949,460157,11792,460157
12633,1731,814,1056,-242,814,814,814,864,-50,864
12634,69773,68875,67263,1612,67263,67263,68885,66659,2226,66659
12635,79454,84053,79454,4599,79454,79454,84040,79314,4726,79314
12636,10743,10356,10411,-55,10356,10356,10358,10243,115,10243
12637,26123,26130,25598,532,25598,25598,26123,25449,674,25449
12638,333336,332238,327655,4583,327655,327655,332373,322520,9853,322520
12639,164084,131874,127938,3936,127938,127938,131891,116523,15368,116523
12640,12271,3448,3578,-130,3448,3448,3447,3142,305,3142
12641,773004,19963,18989,974,18989,18989,19963,18837,1126,18837
12642,595274,594170,559236,34934,559236,559236,593976,552352,41624,552352
12643,56908,56216,54435,1781,54435,54435,56200,54211,1989,54211
12644,625689,603269,586896,16373,586896,586896,603332,574478,28854,574478
12645,9488,8981,8716,265,8716,8716,8977,8656,321,8656
12646,22692,8214,8029,185,8029,8029,8221,7623,598,7623
12647,14519,14016,13802,214,13802,13802,14012,13629,383,13629
12648,32432,32408,31357,1051,31357,31357,32432,31241,1191,31241
12649,153203,148488,144435,4053,144435,144435,148491,141172,7319,141172
12650,22344,22354,21373,981,21373,21373,22344,21293,1051,21293
12651,113126,104712,100724,3988,100724,100724,104728,99158,5570,99158
12652,100143,95394,91626,3768,91626,91626,95436,91555,3881,91555
12653,65907,65841,63345,2496,63345,63345,65863,62286,3577,62286
12654,230258,201413,190968,10445,190968,190968,201347,190060,11287,190060
12655,12776,12778,12751,27,12751,12751,12776,12506,270,12506
12656,6145,6144,6214,-70,6144,6144,6145,5848,297,5848
12657,22859,21267,20660,607,20660,20660,21277,20406,871,20406
12658,52766,51849,50374,1475,50374,50374,51828,48808,3020,48808
12659,8487,8491,8443,48,8443,8443,8487,8295,192,8295
12660,24925,25160,24917,243,24917,24917,25163,24153,1010,24153
12661,44697,33474,32208,1266,32208,32208,33478,32024,1454,32024
12662,12666,12135,12666,-531,12135,12135,12131,9389,2742,9389
12663,56388,14100,13884,216,13884,13884,14106,13792,314,13792
12664,5572,5016,5068,-52,5016,5016,5018,4652,366,4652
12665,12926,12007,11851,156,11851,11851,12014,10764,1250,10764
12666,11169,10746,10841,-95,10746,10746,10741,10606,135,10606
12667,50698,50074,48445,1629,48445,48445,50086,48022,2064,48022
12668,44173,44144,43831,313,43831,43831,44147,43292,855,43292
12669,10153,11595,11794,-199,11595,10153,11592,10329,1263,10153
12670,2537,2411,2475,-64,2411,2411,2414,2295,119,2295
12671,8147,8149,8312,-163,8149,8147,8147,7915,232,7915
12672,40136,42528,41198,1330,41198,40136,42520,40705,1815,40136
12673,174540,180213,176277,3936,176277,174540,180201,173918,6283,173918
12674,18367,17514,17276,238,17276,17276,17528,16825,703,16825
12675,11219,10248,10051,197,10051,10051,10251,9932,319,9932
12676,134444,121582,117871,3711,117871,117871,121654,117156,4498,117156
12677,6958,6173,6077,96,6077,6077,6174,5772,402,5772
12678,20278,20283,20274,9,20274,20274,20278,19992,286,19992
12679,4787,4383,4522,-139,4383,4383,4382,4346,36,4346
12680,287876,287974,281625,6349,281625,281625,287876,278251,9625,278251
12681,6311,6306,6320,-14,6306,6306,6311,6022,289,6022
12682,28834,29737,28819,918,28819,28819,29754,28619,1135,28619
12683,97709,102049,97631,4418,97631,97631,102076,97050,5026,97050
12684,5244,4933,4985,-52,4933,4933,4935,4872,63,4872
12685,87323,86444,82084,4360,82084,82084,86463,80678,5785,80678
12686,399227,399039,381891,17148,381891,381891,399114,376298,22816,376298
12687,6722,6675,6844,-169,6675,6675,6673,6683,-10,6683
12688,5599,5459,5596,-137,5459,5459,5461,5228,233,5228
12689,157156,157104,153984,3120,153984,153984,157085,152368,4717,152368
12690,13890,4482,4646,-164,4482,4482,4478,4353,125,4353
12691,5289,5281,5339,-58,5281,5281,5271,5168,103,5168
12692,239938,180535,171693,8842,171693,171693,180655,168961,11694,168961
12693,23415,25570,23405,2165,23405,23405,25581,22663,2918,22663
12694,26943,16614,15890,724,15890,15890,16616,15799,817,15799
12695,138169,138014,135361,2653,135361,135361,138012,134273,3739,134273
12696,91771,90765,87912,2853,87912,87912,90768,87420,3348,87420
12697,35188,33300,32024,1276,32024,32024,33294,31609,1685,31609
12698,26573,25371,24588,783,24588,24588,25363,24271,1092,24271
12699,40614,14539,14368,171,14368,14368,14544,14164,380,14164
12700,10908,10261,10360,-99,10261,10261,10265,10182,83,10182
12701,453031,430751,414422,16329,414422,414422,430979,412570,18409,412570
12702,111706,88826,85169,3657,85169,85169,88840,82183,6657,82183
12703,14278,14401,14273,128,14273,14273,14399,14019,380,14019
12704,397499,355613,340605,15008,340605,340605,355524,333238,22286,333238
12705,29372,29791,29359,432,29359,29359,29787,28333,1454,28333
12706,1017,768,1017,-249,768,768,768,829,-61,829
12707,1429,1098,1344,-246,1098,1098,1098,1139,-41,1139
12708,113050,49374,48620,754,48620,48620,49405,47764,1641,47764
12709,17677,18108,17665,443,17665,17665,18111,17577,534,17577
12710,258682,258636,246621,12015,246621,246621,258682,244474,14208,244474
12711,128548,127696,121863,5833,121863,121863,127679,119663,8016,119663
12712,118989,123680,118979,4701,118979,118979,123698,118024,5674,118024
12713,48058,52699,51255,1444,51255,48058,52667,49257,3410,48058
12714,144367,122008,118476,3532,118476,118476,122018,117936,4082,117936
12715,262855,278612,262821,15791,262821,262821,278529,261295,17234,261295
12716,160837,160754,154338,6416,154338,154338,160778,152528,8250,152528
12717,1188,967,1188,-221,967,967,967,1000,-33,1000
12718,311675,311576,294988,16588,294988,294988,311553,293620,17933,293620
12719,8110,7648,7845,-197,7648,7648,7652,7575,77,7575
12720,88626,53931,50930,3001,50930,50930,53919,49190,4729,49190
12721,70293,68665,65410,3255,65410,65410,68670,62868,5802,62868
12722,5680,5393,5618,-225,5393,5393,5391,5210,181,5210
12723,10412,9940,9890,50,9890,9890,9935,9737,198,9737
12724,17050,17954,17048,906,17048,17048,17958,16553,1405,16553
12725,43307,43594,42487,1107,42487,42487,43591,42148,1443,42148
12726,144826,144850,138077,6773,138077,138077,144826,136159,8667,136159
12727,3461,3087,3324,-237,3087,3087,3086,3114,-28,3114
12728,1855,1790,1998,-208,1790,1790,1792,1813,-21,1813
12729,371,371,622,-251,371,371,371,419,-48,371
12730,1167043,1094993,1052736,42257,1052736,1052736,1094945,1041604,53341,1041604
12731,38209,40011,38135,1876,38135,38135,40005,37669,2336,37669
12732,9179,9395,9112,283,9112,9112,9394,8919,475,8919
12733,16596,16909,16532,377,16532,16532,16909,16084,825,16084
12734,24505,25383,24499,884,24499,24499,25373,24279,1094,24279
12735,6374,5602,5607,-5,5602,5602,5605,5479,126,5479
12736,33298,33805,33564,241,33564,33298,33790,33290,500,33290
12737,209069,220034,209053,10981,209053,209053,220037,208525,11512,208525
12738,10289,10374,10468,-94,10374,10289,10374,10249,125,10249
12739,31765,33182,32268,914,32268,31765,33177,31693,1484,31693
12740,11889,12068,11989,79,11989,11889,12071,11267,804,11267
12741,965484,922885,888519,34366,888519,888519,922898,882210,40688,882210
12742,36236,35216,34177,1039,34177,34177,35217,33939,1278,33939
12743,47397,47983,49552,-1569,47983,47397,47996,47678,318,47397
12744,19665,19659,19197,462,19197,19197,19665,19080,585,19080
12745,27788,27858,27780,78,27780,27780,27870,27433,437,27433
12746,40837,37800,36436,1364,36436,36436,37814,35638,2176,35638
12747,52042,50259,47422,2837,47422,47422,50275,46490,3785,46490
12748,93601,70962,68218,2744,68218,68218,70984,67969,3015,67969
12749,42623,33298,31915,1383,31915,31915,33318,31798,1520,31798
12750,184892,184899,175600,9299,175600,175600,184892,175171,9721,175171
12751,36797,36844,36355,489,36355,36355,36854,36175,679,36175
12752,191282,191194,179402,11792,179402,179402,191282,177536,13746,177536
12753,88511,85712,85646,66,85646,85646,85755,84759,996,84759
12754,29321,31207,29263,1944,29263,29263,31208,29056,2152,29056
12755,23447,22541,21892,649,21892,21892,22540,21560,980,21560
12756,471838,491259,466867,24392,466867,466867,491391,461254,30137,461254
12757,63357,62417,59573,2844,59573,59573,62424,59468,2956,59468
12758,70024,71964,70299,1665,70299,70024,71983,70211,1772,70024
12759,1507260,1448755,1342731,106024,1342731,1342731,1448777,1339980,108797,1339980
12760,358,304,538,-234,304,304,304,350,-46,350
12761,20962,20967,20822,145,20822,20822,20962,20560,402,20560
12762,2241,1761,2040,-279,1761,1761,1761,1619,142,1619
12763,73142,81156,77118,4038,77118,73142,81189,74304,6885,73142
12764,4290,3960,4182,-222,3960,3960,3957,3997,-40,3997
12765,76319,76322,73667,2655,73667,73667,76319,73397,2922,73397
12766,719,719,931,-212,719,719,719,761,-42,719
12767,57991,56558,52674,3884,52674,52674,56524,52134,4390,52134
12768,20466,20463,20340,123,20340,20340,20466,19946,520,19946
12769,74364,68259,65131,3128,65131,65131,68228,64130,4098,64130
12770,679535,679483,655875,23608,655875,655875,679535,649302,30233,649302
12771,92248,92245,88895,3350,88895,88895,92248,87691,4557,87691
12772,9253,8419,7961,458,7961,7961,8418,7724,694,7724
12773,151104,147910,144902,3008,144902,144902,147865,142533,5332,142533
12774,6943,6538,6687,-149,6538,6538,6538,6490,48,6490
12775,64904,67187,66554,633,66554,64904,67221,65549,1672,64904
12776,101708,63139,61587,1552,61587,61587,63132,61088,2044,61088
12777,74754,58335,55839,2496,55839,55839,58316,55333,2983,55333
12778,3543,2702,2775,-73,2702,2702,2702,2547,155,2547
12779,2540,2540,2728,-188,2540,2540,2540,2577,-37,2540
12780,99824,99825,94464,5361,94464,94464,99824,93873,5951,93873
12781,115853,115903,118293,-2390,115903,115853,115853,114306,1547,114306
12782,33316,33308,32646,662,32646,32646,33316,32514,802,32514
12783,72047,70681,67406,3275,67406,67406,70675,66986,3689,66986
12784,329,329,561,-232,329,329,329,375,-46,329
12785,84784,84747,84041,706,84041,84041,84722,82763,1959,82763
12786,7617,7215,7248,-33,7215,7215,7214,7060,154,7060
12787,14101,14433,14103,330,14103,14101,14433,13984,449,13984
12788,15037,15040,14572,468,14572,14572,15037,14199,838,14199
12789,139871,119139,119476,-337,119139,119139,119192,116728,2464,116728
12790,17699,14613,15050,-437,14613,14613,14628,14557,71,14557
12791,28205,27781,26665,1116,26665,26665,27805,26576,1229,26576
12792,78652,78661,75963,2698,75963,75963,78652,74689,3963,74689
12793,27951,24258,24293,-35,24258,24258,24263,24001,262,24001
12794,480511,448420,448845,-425,448420,448420,448555,441889,6666,441889
12795,541539,541408,527094,14314,527094,527094,541539,524419,17120,524419
12796,217137,216822,211355,5467,211355,211355,216859,209034,7825,209034
12797,10560,10808,10499,309,10499,10499,10814,10431,383,10431
12798,14733,13820,13638,182,13638,13638,13823,13353,470,13353
12799,62719,62678,62568,110,62568,62568,62700,61110,1590,61110
12800,13508,13083,12734,349,12734,12734,13074,12578,496,12578
12801,4476,3820,4096,-276,3820,3820,3820,3800,20,3800
12802,79339,62774,60617,2157,60617,60617,62793,60414,2379,60414
12803,64310,62707,59579,3128,59579,59579,62704,59083,3621,59083
12804,12065,11451,11477,-26,11451,11451,11464,11309,155,11309
12805,23712,23727,23116,611,23116,23116,23712,22550,1162,22550
12806,18056,19860,19514,346,19514,18056,19863,17434,2429,17434
12807,1203,789,1022,-233,789,789,789,837,-48,837
12808,125530,125515,121189,4326,121189,121189,125530,120683,4847,120683
12809,780567,599548,573970,25578,573970,573970,599753,567267,32486,567267
12810,17565,18042,17563,479,17563,17563,18046,17414,632,17414
12811,9483,8570,8380,190,8380,8380,8567,8255,312,8255
12812,13214,13210,13301,-91,13210,13210,13214,13040,174,13040
12813,6665,5824,5837,-13,5824,5824,5826,5637,189,5637
12814,10795,10138,10028,110,10028,10028,10137,9854,283,9854
12815,6886,6776,6823,-47,6776,6776,6781,6628,153,6628
12816,9930,8252,8606,-354,8252,8252,8254,7742,512,7742
12817,8709,8735,8816,-81,8735,8709,8727,8585,142,8585
12818,19668,19188,19005,183,19005,19005,19184,18835,349,18835
12819,3464,3041,3181,-140,3041,3041,3042,3042,0,3042
12820,38145,37314,35539,1775,35539,35539,37338,35023,2315,35023
12821,77575,80131,77497,2634,77497,77497,80131,76834,3297,76834
12822,605415,604485,585263,19222,585263,585263,604626,581598,23028,581598
12823,15889,15834,16035,-201,15834,15834,15837,15638,199,15638
12824,67289,64854,63130,1724,63130,63130,64879,62777,2102,62777
12825,19193,19565,19403,162,19403,19193,19562,19083,479,19083
12826,239133,249282,239296,9986,239296,239133,249110,239133,9977,239133
12827,9874,9033,8995,38,8995,8995,9034,8663,371,8663
12828,6463,6189,6220,-31,6189,6189,6189,5841,348,5841
12829,534686,567690,543070,24620,543070,534686,567811,536385,31426,534686
12830,9667,7724,7291,433,7291,7291,7723,6601,1122,6601
12831,82669,63608,59766,3842,59766,59766,63637,57934,5703,57934
12832,266198,257203,246011,11192,246011,246011,257317,245382,11935,245382
12833,10127,10126,10527,-401,10126,10126,10127,10220,-93,10127
12834,305068,314657,305012,9645,305012,305012,314670,302212,12458,302212
12835,35487,35429,33392,2037,33392,33392,35426,32215,3211,32215
12836,22859,22272,22362,-90,22272,22272,22276,22032,244,22032
12837,10902,10900,10825,75,10825,10825,10902,10660,242,10660
12838,45088,3650,3803,-153,3650,3650,3652,3634,18,3634
12839,61499,63356,61006,2350,61006,61006,63385,60877,2508,60877
12840,3784,3437,3676,-239,3437,3437,3437,3162,275,3162
12841,18365,17408,16826,582,16826,16826,17405,16792,613,16792
12842,387881,379088,367786,11302,367786,367786,379254,366040,13214,366040
12843,7325,6678,6740,-62,6678,6678,6677,6505,172,6505
12844,261870,260869,249053,11816,249053,249053,260881,245344,15537,245344
12845,29020,29387,28165,1222,28165,28165,29389,27836,1553,27836
12846,37665,25725,24803,922,24803,24803,25729,24622,1107,24622
12847,32237,30703,30568,135,30568,30568,30710,29960,750,29960
12848,17410,16524,16221,303,16221,16221,16521,15519,1002,15519
12849,28285,27588,27041,547,27041,27041,27596,26789,807,26789
12850,59233,58474,57781,693,57781,57781,58486,57294,1192,57294
12851,42394,42662,42060,602,42060,42060,42690,41772,918,41772
12852,25600,24741,23543,1198,23543,23543,24738,22972,1766,22972
12853,23165,23715,23163,552,23163,23163,23714,22941,773,22941
12854,38528,38402,38238,164,38238,38238,38397,36168,2229,36168
12855,328541,327640,314633,13007,314633,314633,327619,310283,17336,310283
12856,130358,115708,111707,4001,111707,111707,115737,110917,4820,110917
12857,20353,19063,18194,869,18194,18194,19071,18152,919,18152
12858,1731,797,1039,-242,797,797,797,846,-49,846
12859,11927,11474,11483,-9,11474,11474,11473,11187,286,11187
12860,397785,397628,387819,9809,387819,387819,397803,384604,13199,384604
12861,68284,68262,62770,5492,62770,62770,68278,60403,7875,60403
12862,737,695,944,-249,695,695,695,737,-42,737
12863,12724,12624,12722,-98,12624,12624,12627,12431,196,12431
12864,36925,38355,36854,1501,36854,36854,38351,36348,2003,36348
12865,127537,115881,109577,6304,109577,109577,115811,108263,7548,108263
12866,5300,5300,5436,-136,5300,5300,5300,5266,34,5266
12867,124525,113551,108831,4720,108831,108831,113579,107910,5669,107910
12868,1422730,1342321,1277504,64817,1277504,1277504,1342364,1270343,72021,1270343
12869,228883,211465,202012,9453,202012,202012,211624,200285,11339,200285
12870,10903,10920,10736,184,10736,10736,10921,10579,342,10579
12871,19337,18679,18098,581,18098,18098,18676,18031,645,18031
12872,54069,52449,49517,2932,49517,49517,52452,48954,3498,48954
12873,1470,794,1063,-269,794,794,795,848,-53,848
12874,6769,6016,5955,61,5955,5955,6018,5878,140,5878
12875,14214,14117,13322,795,13322,13322,14126,12757,1369,12757
12876,375241,375087,362370,12717,362370,362370,375279,355633,19646,355633
12877,262860,261770,247432,14338,247432,247432,261849,244849,17000,244849
12878,7748,7171,7468,-297,7171,7171,7179,7075,104,7075
12879,14863,14396,14306,90,14306,14306,14402,14078,324,14078
12880,11192,9909,9619,290,9619,9619,9904,9578,326,9578
12881,24700,23980,23007,973,23007,23007,23985,22940,1045,22940
12882,26438,25603,24936,667,24936,24936,25597,24271,1326,24271
12883,597570,537366,526244,11122,526244,526244,537392,523070,14322,523070
12884,27299,27240,26807,433,26807,26807,27242,26677,565,26677
12885,23715,12164,11744,420,11744,11744,12154,11640,514,11640
12886,115986,115072,115952,-880,115072,115072,115070,113674,1396,113674
12887,8257,7900,8061,-161,7900,7900,7905,7831,74,7831
12888,764,780,1025,-245,780,764,780,832,-52,764
12889,12753,12026,12067,-41,12026,12026,12021,11855,166,11855
12890,261315,274050,263089,10961,263089,261315,274154,261951,12203,261315
12891,132568,132574,128298,4276,128298,128298,132586,127934,4652,127934
12892,9813,9811,9724,87,9724,9724,9813,9498,315,9498
12893,351688,351804,338085,13719,338085,338085,351688,337457,14231,337457
12894,11184,11449,11370,79,11370,11184,11449,11153,296,11153
12895,69411,73379,69394,3985,69394,69394,73394,69052,4342,69052
12896,646712,627759,624992,2767,624992,624992,627954,613649,14305,613649
12897,46415,44786,44301,485,44301,44301,44845,43855,990,43855
12898,2155,1694,1921,-227,1694,1694,1696,1676,20,1676
12899,2614,2614,2809,-195,2614,2614,2614,2645,-31,2614
12900,16154,3178,3332,-154,3178,3178,3181,3191,-10,3191
12901,99746,105502,99736,5766,99736,99736,105573,99685,5888,99685
12902,20807,19952,20013,-61,19952,19952,19955,19777,178,19777
12903,65293,65296,61116,4180,61116,61116,65293,60796,4497,60796
12904,261461,249944,233764,16180,233764,233764,250083,233940,16143,233940
12905,201400,163850,157200,6650,157200,157200,163924,156287,7637,156287
12906,23306,23293,22872,421,22872,22872,23294,22298,996,22298
12907,439955,439963,403814,36149,403814,403814,439955,402889,37066,402889
12908,6276,6215,6429,-214,6215,6215,6215,6219,-4,6219
12909,21426,16372,16050,322,16050,16050,16370,15929,441,15929
12910,102376,90602,86624,3978,86624,86624,90618,86412,4206,86412
12911,10528,7279,7218,61,7218,7218,7278,7114,164,7114
12912,48726,51151,48665,2486,48665,48665,51136,48257,2879,48257
12913,634,634,876,-242,634,634,634,687,-53,634
12914,55131,58488,54905,3583,54905,54905,58491,51849,6642,51849
12915,68228,68175,65843,2332,65843,65843,68180,64773,3407,64773
12916,126945,126039,129100,-3061,126039,126039,126100,123574,2526,123574
12917,802531,758639,757616,1023,757616,757616,758920,723688,35232,723688
12918,108808,107826,107243,583,107243,107243,107885,104336,3549,104336
12919,1724,1338,1591,-253,1338,1338,1336,1389,-53,1389
12920,6093,5581,5663,-82,5581,5581,5586,5325,261,5325
12921,1690,1448,1628,-180,1448,1448,1448,1426,22,1426
12922,18491,4774,4803,-29,4774,4774,4769,4641,128,4641
12923,33174,32328,33046,-718,32328,32328,32327,20780,11547,20780
12924,217856,228796,217797,10999,217797,217797,228760,215913,12847,215913
12925,36160,37716,36579,1137,36579,36160,37732,35538,2194,35538
12926,15389,17926,19182,-1256,17926,15389,17928,15389,2539,15389
12927,30142,31290,30254,1036,30254,30142,31300,30075,1225,30075
12928,174467,168530,160286,8244,160286,160286,168489,160084,8405,160084
12929,60006,31228,30197,1031,30197,30197,31235,30073,1162,30073
12930,20393,19042,18705,337,18705,18705,19045,18175,870,18175
12931,4214,3947,4153,-206,3947,3947,3946,3622,324,3622
12932,283897,261168,248225,12943,248225,248225,261115,246146,14969,246146
12933,11560,11021,10979,42,10979,10979,11031,10732,299,10732
12934,9577,9590,9580,10,9580,9577,9594,9442,152,9442
12935,15140,14237,13882,355,13882,13882,14237,13472,765,13472
12936,20753,20728,20982,-254,20728,20728,20736,20473,263,20473
12937,21517,21054,21011,43,21011,21011,21065,20721,344,20721
12938,543061,542117,520716,21401,520716,520716,542181,517004,25177,517004
12939,235008,233613,225940,7673,225940,225940,233632,222996,10636,222996
12940,7715,7505,7651,-146,7505,7505,7508,7412,96,7412
12941,73183,73689,72263,1426,72263,72263,73711,69242,4469,69242
12942,31621,31631,30536,1095,30536,30536,31621,30358,1263,30358
12943,15230,14375,14058,317,14058,14058,14383,13906,477,13906
12944,953,285,519,-234,285,285,285,331,-46,331
12945,43988,44355,43522,833,43522,43522,44351,43366,985,43366
12946,40230,40233,39120,1113,39120,39120,40230,38650,1580,38650
12947,83918,74439,71242,3197,71242,71242,74463,70671,3792,70671
12948,25419,24565,24124,441,24124,24124,24587,21162,3425,21162
12949,118861,113956,106769,7187,106769,106769,113932,105903,8029,105903
12950,120831,127165,120633,6532,120633,120633,127171,119148,8023,119148
12951,2456808,2284389,2179402,104987,2179402,2179402,2283814,2149086,134728,2149086
12952,18631,18626,18171,455,18171,18171,18631,17973,658,17973
12953,19211,18648,18479,169,18479,18479,18648,17997,651,17997
12954,13443,13439,13505,-66,13439,13439,13443,13277,166,13277
12955,321181,315467,299281,16186,299281,299281,315510,298325,17185,298325
12956,64988,53785,51424,2361,51424,51424,53794,50399,3395,50399
12957,77629,51297,49489,1808,49489,49489,51294,48694,2600,48694
12958,83521,86303,83489,2814,83489,83489,86289,82420,3869,82420
12959,4780,4701,4904,-203,4701,4701,4706,4744,-38,4744
12960,73125,70730,68091,2639,68091,68091,70759,67851,2908,67851
12961,18734,17895,17522,373,17522,17522,17897,17320,577,17320
12962,63490,36399,35457,942,35457,35457,36427,34867,1560,34867
12963,241644,240741,235800,4941,235800,235800,240757,230623,10134,230623
12964,68151,67323,64820,2503,64820,64820,67301,63641,3660,63641
12965,2187,1251,1469,-218,1251,1251,1250,1304,-54,1304
12966,100273,85037,80407,4630,80407,80407,85021,79783,5238,79783
12967,12312,11468,11062,406,11062,11062,11469,10873,596,10873
12968,301773,266148,252489,13659,252489,252489,266129,250223,15906,250223
12969,26159,13767,13338,429,13338,13338,13771,12271,1500,12271
12970,72940,71730,70181,1549,70181,70181,71746,69786,1960,69786
12971,188244,187215,184561,2654,184561,184561,187158,177845,9313,177845
12972,182733,175796,176961,-1165,175796,175796,175829,175073,756,175073
12973,50944,54938,51357,3581,51357,50944,54928,50944,3984,50944
12974,452425,416371,401796,14575,401796,401796,416211,397879,18332,397879
12975,22243,21902,22236,-334,21902,21902,21922,21713,209,21713
12976,31221,30525,29205,1320,29205,29205,30521,29104,1417,29104
12977,37536,39675,37461,2214,37461,37461,39683,37300,2383,37300
12978,33394,33405,32594,811,32594,32594,33394,32465,929,32465
12979,16956,16339,16013,326,16013,16013,16342,15905,437,15905
12980,147959,147945,140649,7296,140649,140649,147959,139270,8689,139270
12981,30244,29743,28907,836,28907,28907,29739,28714,1025,28714
12982,20553,20556,20698,-142,20556,20553,20553,20368,185,20368
12983,141171,140217,142023,-1806,140217,140217,140229,130558,9671,130558
12984,722655,657051,614064,42987,614064,614064,657265,605748,51517,605748
12985,31120,30414,31083,-669,30414,30414,30413,29839,574,29839
12986,5328,4490,4533,-43,4490,4490,4487,4307,180,4307
12987,18658,10860,10650,210,10650,10650,10861,10492,369,10492
12988,67742,55210,54815,395,54815,54815,55232,53699,1533,53699
12989,87534,87403,85973,1430,85973,85973,87436,85146,2290,85146
12990,290833,270166,257634,12532,257634,257634,270176,255774,14402,255774
12991,359783,330351,319313,11038,319313,319313,330428,317585,12843,317585
12992,9140,9042,9131,-89,9042,9042,9048,8512,536,8512
12993,1440,1066,1284,-218,1066,1066,1066,1115,-49,1115
12994,181596,174005,164611,9394,164611,164611,174002,163357,10645,163357
12995,246229,260141,254091,6050,254091,246229,260164,246221,13943,246221
12996,13669,12522,12336,186,12336,12336,12525,12088,437,12088
12997,39640,39655,38142,1513,38142,38142,39669,37547,2122,37547
12998,10312,9180,9038,142,9038,9038,9183,8619,564,8619
12999,9051,9059,9051,8,9051,9051,9053,9046,7,9046
13000,485199,508767,485000,23767,485000,485000,508672,481225,27447,481225
13001,68925,68921,68771,150,68771,68771,68982,67721,1261,67721
13002,192389,190894,186227,4667,186227,186227,190966,182404,8562,182404
13003,629416,389641,377346,12295,377346,377346,389454,366496,22958,366496
13004,13415,13596,13415,181,13415,13415,13600,13192,408,13192
13005,35304,35307,33694,1613,33694,33694,35304,33445,1859,33445
13006,88336,85552,83864,1688,83864,83864,85550,83355,2195,83355
13007,154017,153150,147686,5464,147686,147686,153193,146875,6318,146875
13008,75366,76056,75308,748,75308,75308,76071,74744,1327,74744
13009,12095,11397,11149,248,11149,11149,11406,10786,620,10786
13010,7983,7426,7598,-172,7426,7426,7429,7153,276,7153
13011,41240,38973,38455,518,38455,38455,38965,37883,1082,37883
13012,3868,3311,3681,-370,3311,3311,3314,3368,-54,3368
13013,3461,2786,3034,-248,2786,2786,2786,2657,129,2657
13014,616,598,849,-251,598,598,597,639,-42,616
13015,42916,43598,44248,-650,43598,42916,43627,43227,400,42916
13016,279717,297691,285630,12061,285630,279717,297787,279606,18181,279606
13017,124016,131824,124001,7823,124001,124001,131917,123707,8210,123707
13018,6881,6843,6997,-154,6843,6843,6841,6840,1,6840
13019,9761,9774,9666,108,9666,9666,9779,9360,419,9360
13020,25970,18681,18179,502,18179,18179,18682,16876,1806,16876
13021,424376,424331,408002,16329,408002,408002,424289,406681,17608,406681
13022,113217,113121,108307,4814,108307,108307,113217,108140,5077,108140
13023,186498,148384,141755,6629,141755,141755,148408,139841,8567,139841
13024,96736,95272,93211,2061,93211,93211,95305,92524,2781,92524
13025,16766,15841,15413,428,15413,15413,15852,15247,605,15247
13026,27152,27149,26003,1146,26003,26003,27152,25890,1262,25890
13027,16999,17425,16991,434,16991,16991,17431,16818,613,16818
13028,3314,2725,2864,-139,2725,2725,2724,2639,85,2639
13029,3309,2923,3035,-112,2923,2923,2923,2911,12,2911
13030,58037,57287,57995,-708,57287,57287,57317,56372,945,56372
13031,19569,19105,18569,536,18569,18569,19101,18442,659,18442
13032,9113,8568,8643,-75,8568,8568,8565,8448,117,8448
13033,17861,17858,17630,228,17630,17630,17861,17397,464,17397
13034,59234,58322,56785,1537,56785,56785,58340,56491,1849,56491
13035,7813,7435,7308,127,7308,7308,7439,7168,271,7168
13036,11713,360,594,-234,360,360,360,370,-10,370
13037,78343,77457,74050,3407,74050,74050,77512,73867,3645,73867
13038,4068,4020,4069,-49,4020,4020,4020,3839,181,3839
13039,157051,164991,157044,7947,157044,157044,164942,156670,8272,156670
13040,5703,5702,5886,-184,5702,5702,5703,5251,452,5251
13041,199820,189341,183116,6225,183116,183116,189394,181686,7708,181686
13042,84926,67414,71927,-4513,67414,67414,67420,64939,2481,64939
13043,28458,27650,26064,1586,26064,26064,27645,25875,1770,25875
13044,4855,4854,4835,19,4835,4835,4855,4432,423,4432
13045,7648,7208,7271,-63,7208,7208,7204,7118,86,7118
13046,31376,29471,27529,1942,27529,27529,29463,27381,2082,27381
13047,197617,196581,190939,5642,190939,190939,196550,189076,7474,189076
13048,9874,9865,10262,-397,9865,9865,9874,9867,7,9867
13049,96513,98935,97275,1660,97275,96513,98944,96513,2431,96513
13050,20251,20918,20545,373,20545,20251,20926,20293,633,20251
13051,59393,61144,59878,1266,59878,59393,61154,59393,1761,59393
13052,81482,80599,76382,4217,76382,76382,80601,72969,7632,72969
13053,99092,75181,72738,2443,72738,72738,75187,71899,3288,71899
13054,145020,123624,118856,4768,118856,118856,123633,115848,7785,115848
13055,155848,154917,148747,6170,148747,148747,154996,148399,6597,148399
13056,38779,38803,37893,910,37893,37893,38797,37364,1433,37364
13057,184931,192250,184896,7354,184896,184896,192272,184570,7702,184570
13058,41649,40701,39507,1194,39507,39507,40708,37148,3560,37148
13059,91242,91243,86779,4464,86779,86779,91242,86309,4933,86309
13060,12149,11974,12406,-432,11974,11974,11972,12042,-70,12042
13061,6729,5825,6173,-348,5825,5825,5825,5858,-33,5858
13062,4480,3521,3676,-155,3521,3521,3520,3350,170,3350
13063,2582,2093,2297,-204,2093,2093,2094,2072,22,2072
13064,3925,3555,3685,-130,3555,3555,3552,3541,11,3541
13065,1543,1560,1826,-266,1560,1543,1559,1612,-53,1543
13066,27636,28633,27571,1062,27571,27571,28627,27180,1447,27180
13067,89946,89902,86690,3212,86690,86690,89959,85833,4126,85833
13068,76799,76268,73009,3259,73009,73009,76233,72610,3623,72610
13069,114433,113631,108231,5400,108231,108231,113573,106631,6942,106631
13070,13092,12681,12436,245,12436,12436,12687,12219,468,12219
13071,114312,110645,107474,3171,107474,107474,110684,106313,4371,106313
13072,802865,801779,776503,25276,776503,776503,802188,771801,30387,771801
13073,280617,280567,271892,8675,271892,271892,280618,268748,11870,268748
13074,244973,232689,227701,4988,227701,227701,232713,221242,11471,221242
13075,100335,100306,99152,1154,99152,99152,100335,97813,2522,97813
13076,36846,33870,32225,1645,32225,32225,33862,32098,1764,32098
13077,5528,5103,5320,-217,5103,5103,5105,5099,6,5099
13078,2724,2414,2589,-175,2414,2414,2414,2426,-12,2426
13079,34726,36440,34727,1713,34727,34726,36457,34697,1760,34697
13080,228643,225131,213057,12074,213057,213057,225045,212309,12736,212309
13081,15863,8067,8038,29,8038,8038,8071,7682,389,7682
13082,3319,2893,3082,-189,2893,2893,2894,2850,44,2850
13083,46687,45346,44566,780,44566,44566,45371,44252,1119,44252
13084,8924,8775,8858,-83,8775,8775,8776,8583,193,8583
13085,12038,12230,11969,261,11969,11969,12232,11631,601,11631
13086,6968,6190,6165,25,6165,6165,6193,5868,325,5868
13087,112850,111887,107732,4155,107732,107732,111916,106707,5209,106707
13088,31767,31748,29849,1899,29849,29849,31741,28266,3475,28266
13089,11636,9824,9393,431,9393,9393,9813,9035,778,9035
13090,60390,57225,56268,957,56268,56268,57254,55662,1592,55662
13091,8335,8334,8328,6,8328,8328,8335,8101,234,8101
13092,29605,28809,28459,350,28459,28459,28811,27960,851,27960
13093,5481,5481,5525,-44,5481,5481,5481,5403,78,5403
13094,11031,10967,11257,-290,10967,10967,10965,11020,-55,11020
13095,93020,98056,92984,5072,92984,92984,98022,92752,5270,92752
13096,10416,9804,9357,447,9357,9357,9799,9317,482,9317
13097,56358,58848,56876,1972,56876,56358,58871,56358,2513,56358
13098,17895,16965,16436,529,16436,16436,16966,16411,555,16411
13099,1394,1017,1210,-193,1017,1017,1017,1058,-41,1058
13100,19209,10018,10112,-94,10018,10018,10020,9625,395,9625
13101,9269,8521,8308,213,8308,8308,8519,8022,497,8022
13102,24824,15566,15320,246,15320,15320,15572,14870,702,14870
13103,94111,94013,90270,3743,90270,90270,94068,89904,4164,89904
13104,28012,28013,27601,412,27601,27601,28012,27334,678,27334
13105,7602,7540,7507,33,7507,7507,7541,7214,327,7214
13106,128075,117760,111655,6105,111655,111655,117737,111560,6177,111560
13107,91931,95066,97728,-2662,95066,91931,95075,91881,3194,91881
13108,28590,25230,24131,1099,24131,24131,25240,23981,1259,23981
13109,854,418,670,-252,418,418,418,457,-39,457
13110,14237,13802,13675,127,13675,13675,13798,13525,273,13525
13111,265955,214571,205028,9543,205028,205028,214645,202416,12229,202416
13112,10499,10196,10398,-202,10196,10196,10204,9940,264,9940
13113,50888,53481,50824,2657,50824,50824,53493,49812,3681,49812
13114,2420,1580,1810,-230,1580,1580,1582,1577,5,1577
13115,492532,83539,81107,2432,81107,81107,83540,79212,4328,79212
13116,275604,272697,266611,6086,266611,266611,272823,263949,8874,263949
13117,27255,29018,27248,1770,27248,27248,29021,25968,3053,25968
13118,6202,6083,6222,-139,6083,6083,6080,5993,87,5993
13119,432345,438042,414125,23917,414125,414125,438049,409319,28730,409319
13120,234125,216166,206077,10089,206077,206077,216043,204203,11840,204203
13121,158995,165424,158904,6520,158904,158904,165400,158384,7016,158384
13122,19977,19483,19373,110,19373,19373,19479,19159,320,19159
13123,7811,7848,7793,55,7793,7793,7851,7189,662,7189
13124,5355,5261,5293,-32,5261,5261,5259,5083,176,5083
13125,4049,4047,4205,-158,4047,4047,4049,4025,24,4025
13126,13103,13173,13099,74,13099,13099,13163,12868,295,12868
13127,12204,4572,4619,-47,4572,4572,4574,4432,142,4432
13128,33595,29464,27660,1804,27660,27660,29484,27451,2033,27451
13129,17938,16737,16360,377,16360,16360,16758,15697,1061,15697
13130,26065,26696,26216,480,26216,26065,26702,26065,637,26065
13131,2889,2546,2827,-281,2546,2546,2546,2597,-51,2597
13132,111686,114866,114102,764,114102,111686,114850,111635,3215,111635
13133,18845,19063,19089,-26,19063,18845,19056,18774,282,18774
13134,17237,18016,17238,778,17238,17237,18021,16886,1135,16886
13135,278207,276123,270992,5131,270992,270992,276107,269216,6891,269216
13136,175911,175960,164985,10975,164985,164985,175911,164128,11783,164128
13137,163204,168111,164679,3432,164679,163204,168203,163202,5001,163202
13138,786,699,929,-230,699,699,699,749,-50,749
13139,55517,56203,57082,-879,56203,55517,56214,53967,2247,53967
13140,38982,35690,33798,1892,33798,33798,35689,33527,2162,33527
13141,24652,25519,24924,595,24924,24652,25539,24630,909,24630
13142,159264,159140,148477,10663,148477,148477,159202,147390,11812,147390
13143,34680,34680,34733,-53,34680,34680,34673,28458,6215,28458
13144,32117,32856,32033,823,32033,32033,32861,31832,1029,31832
13145,212779,219470,212179,7291,212179,212179,219529,211521,8008,211521
13146,8532,8517,8246,271,8246,8246,8517,7863,654,7863
13147,26364,19179,19284,-105,19179,19179,19186,18731,455,18731
13148,48202,31033,30741,292,30741,30741,31038,30448,590,30448
13149,29149,28244,27356,888,27356,27356,28254,27241,1013,27241
13150,6566,5750,5787,-37,5750,5750,5752,5382,370,5382
13151,26887,25371,24726,645,24726,24726,25377,24379,998,24379
13152,95907,92003,90918,1085,90918,90918,92053,90259,1794,90259
13153,105419,104489,101036,3453,101036,101036,104549,100022,4527,100022
13154,150505,151317,151922,-605,151317,150505,151370,150497,873,150497
13155,30038,29202,28238,964,28238,28238,29215,28087,1128,28087
13156,11630,11701,11363,338,11363,11363,11707,11008,699,11008
13157,108187,105224,100489,4735,100489,100489,105256,99136,6120,99136
13158,161497,161367,155425,5942,155425,155425,161406,154711,6695,154711
13159,30884,31665,32460,-795,31665,30884,31675,30876,799,30876
13160,9797,9154,8902,252,8902,8902,9165,8710,455,8710
13161,40057,39213,38226,987,38226,38226,39241,37986,1255,37986
13162,39341,39335,37704,1631,37704,37704,39341,37441,1900,37441
13163,15043,14618,14411,207,14411,14411,14614,14247,367,14247
13164,105014,97887,91938,5949,91938,91938,97859,91641,6218,91641
13165,18330,18306,18115,191,18115,18115,18314,17952,362,17952
13166,24962,24801,24957,-156,24801,24801,24826,24525,301,24525
13167,4699,4650,4671,-21,4650,4650,4654,4544,110,4544
13168,10448,10689,10447,242,10447,10447,10687,10330,357,10330
13169,130213,129273,128672,601,128672,128672,129279,121324,7955,121324
13170,68100,56363,56546,-183,56363,56363,56386,55348,1038,55348
13171,40381,40400,38998,1402,38998,38998,40399,38624,1775,38624
13172,98771,101716,100603,1113,100603,98771,101710,99390,2320,98771
13173,60913,56567,55753,814,55753,55753,56547,54597,1950,54597
13174,6327,6412,6328,84,6328,6327,6414,6041,373,6041
13175,20609,20484,19891,593,19891,19891,20487,19817,670,19817
13176,81109,80186,77629,2557,77629,77629,80203,77342,2861,77342
13177,90627,90369,87029,3340,87029,87029,90387,86802,3585,86802
13178,18580,8037,7968,69,7968,7968,8038,7781,257,7781
13179,170092,163717,155171,8546,155171,155171,163807,150195,13612,150195
13180,28378,28112,27060,1052,27060,27060,28107,27019,1088,27019
13181,374624,374581,359906,14675,359906,359906,374545,357322,17223,357322
13182,4707764,4693011,4403926,289085,4403926,4403926,4692646,4329027,363619,4329027
13183,70667,67295,64918,2377,64918,64918,67314,64688,2626,64688
13184,16940,16086,16297,-211,16086,16086,16084,16006,78,16006
13185,340257,339324,324150,15174,324150,324150,339399,320804,18595,320804
13186,14675,13940,13863,77,13863,13863,13942,13724,218,13724
13187,7331,7324,7273,51,7273,7273,7331,7021,310,7021
13188,90585,90809,86702,4107,86702,86702,90826,85934,4892,85934
13189,151539,151497,145063,6434,145063,145063,151483,142985,8498,142985
13190,3442,2614,2865,-251,2614,2614,2614,2656,-42,2656
13191,525382,506148,491690,14458,491690,491690,506234,489727,16507,489727
13192,5843,2677,2894,-217,2677,2677,2681,2742,-61,2742
13193,1033112,994714,1013997,-19283,994714,994714,995222,938028,57194,938028
13194,47779,50432,49837,595,49837,47779,50459,48446,2013,47779
13195,138818,116141,111278,4863,111278,111278,116177,110773,5404,110773
13196,12287,12138,12460,-322,12138,12138,12142,12179,-37,12179
13197,16997,16814,16775,39,16775,16775,16818,16482,336,16482
13198,70748,68946,65944,3002,65944,65944,68982,65739,3243,65739
13199,52718,51856,49447,2409,49447,49447,51869,49071,2798,49071
13200,25120,17117,17083,34,17083,17083,17113,16720,393,16720
13201,12655,12611,12526,85,12526,12526,12609,12279,330,12279
13202,5223,5222,5314,-92,5222,5222,5223,5191,32,5191
13203,2097,1773,1946,-173,1773,1773,1773,1792,-19,1792
13204,102068,101225,99885,1340,99885,99885,101199,98896,2303,98896
13205,17732,17084,16372,712,16372,16372,17084,16281,803,16281
13206,2590,2124,2257,-133,2124,2124,2122,2062,60,2062
13207,118227,91630,90330,1300,90330,90330,91633,89274,2359,89274
13208,1630405,1631661,1533702,97959,1533702,1533702,1631322,1510648,120674,1510648
13209,2087,1712,1980,-268,1712,1712,1711,1782,-71,1782
13210,13580,13579,13128,451,13128,13128,13580,13100,480,13100
13211,200282,199353,193137,6216,193137,193137,199359,192229,7130,192229
13212,17482,17445,17033,412,17033,17033,17449,16828,621,16828
13213,17210,17212,16953,259,16953,16953,17210,16846,364,16846
13214,11708,4466,4470,-4,4466,4466,4463,4365,98,4365
13215,29034,28088,27074,1014,27074,27074,28096,26777,1319,26777
13216,110362,108953,110188,-1235,108953,108953,109011,108226,785,108226
13217,3964,3490,3542,-52,3490,3490,3492,3275,217,3275
13218,81967,81097,77171,3926,77171,77171,81126,76925,4201,76925
13219,167356,166212,158666,7546,158666,158666,166251,157597,8654,157597
13220,48550,51119,48483,2636,48483,48483,51150,48441,2709,48441
13221,2358,2104,2296,-192,2104,2104,2104,2139,-35,2139
13222,232169,227602,223484,4118,223484,223484,227598,222180,5418,222180
13223,18225,18242,17786,456,17786,17786,18243,16554,1689,16554
13224,27505,25906,24848,1058,24848,24848,25908,24656,1252,24656
13225,167121,163184,157035,6149,157035,157035,163236,156421,6815,156421
13226,3630,3195,3354,-159,3195,3195,3197,3143,54,3143
13227,34673,36439,34594,1845,34594,34594,36446,34460,1986,34460
13228,8116,6852,7044,-192,6852,6852,6852,6495,357,6495
13229,10935,9994,9808,186,9808,9808,9996,9381,615,9381
13230,58273,55184,52978,2206,52978,52978,55179,50702,4477,50702
13231,2909,2918,2967,-49,2918,2909,2909,2867,42,2867
13232,19746,19753,19728,25,19728,19728,19746,19459,287,19459
13233,3544,3520,3826,-306,3520,3520,3525,3488,37,3488
13234,5863,5319,5450,-131,5319,5319,5321,5302,19,5302
13235,8056,7235,7249,-14,7235,7235,7236,7126,110,7126
13236,8463,7684,7663,21,7663,7663,7688,7288,400,7288
13237,15563,15724,15487,237,15487,15487,15722,15387,335,15387
13238,199481,176838,171937,4901,171937,171937,176855,169829,7026,169829
13239,154474,140032,137322,2710,137322,137322,140061,136571,3490,136571
13240,60844,49648,47660,1988,47660,47660,49660,47315,2345,47315
13241,90839,90816,88546,2270,88546,88546,90839,87617,3222,87617
13242,248107,245082,237537,7545,237537,237537,245099,236261,8838,236261
13243,75913,74204,70654,3550,70654,70654,74255,69843,4412,69843
13244,259374,233706,220520,13186,220520,220520,233724,217880,15844,217880
13245,3884,3441,3533,-92,3441,3441,3439,3414,25,3414
13246,259741,240637,233419,7218,233419,233419,240649,232808,7841,232808
13247,5625,5130,5164,-34,5130,5130,5130,4918,212,4918
13248,3206,2989,3146,-157,2989,2989,2989,3001,-12,3001
13249,4264,4262,4383,-121,4262,4262,4264,4225,39,4225
13250,149534,148343,144812,3531,144812,144812,148508,144324,4184,144324
13251,327338,323163,310854,12309,310854,310854,323230,303607,19623,303607
13252,26639,26932,26626,306,26626,26626,26940,25752,1188,25752
13253,169618,149323,145785,3538,145785,145785,149329,144916,4413,144916
13254,1655,662,907,-245,662,662,663,706,-43,706
13255,1039398,1038311,981057,57254,981057,981057,1038443,972180,66263,972180
13256,18671,17005,16214,791,16214,16214,17002,15766,1236,15766
13257,4690756,4454329,4198649,255680,4198649,4198649,4455415,4172425,282990,4172425
13258,175078,174206,175910,-1704,174206,174206,174215,172826,1389,172826
13259,3681,3622,3838,-216,3622,3622,3620,3318,302,3318
13260,75018,75055,70447,4608,70447,70447,75018,70385,4633,70385
13261,260072,238718,229590,9128,229590,229590,238777,227814,10963,227814
13262,81424,60829,59698,1131,59698,59698,60841,59090,1751,59090
13263,70738,69541,66921,2620,66921,66921,69551,65491,4060,65491
13264,6933,6876,6900,-24,6876,6876,6873,6701,172,6701
13265,3789,3310,3478,-168,3310,3310,3310,3259,51,3259
13266,3794,3792,3746,46,3746,3746,3794,3577,217,3577
13267,22019,22963,22011,952,22011,22011,22967,21929,1038,21929
13268,26280,26271,26352,-81,26271,26271,26280,25865,415,25865
13269,1506,665,920,-255,665,665,665,716,-51,716
13270,19220,15414,15589,-175,15414,15414,15416,15181,235,15181
13271,15811,15807,15383,424,15383,15383,15811,15247,564,15247
13272,29169,29586,29163,423,29163,29163,29604,28815,789,28815
13273,7783,7729,7798,-69,7729,7729,7731,7623,108,7623
13274,16626,17125,16556,569,16556,16556,17149,16231,918,16231
13275,1358,935,1199,-264,935,935,935,979,-44,979
13276,42972,43278,42966,312,42966,42966,43320,42446,874,42446
13277,8960,8231,8013,218,8013,8013,8239,7951,288,7951
13278,23415,23372,23314,58,23314,23314,23393,23022,371,23022
13279,5254,5323,5256,67,5256,5254,5323,5114,209,5114
13280,34890,34121,32540,1581,32540,32540,34110,32285,1825,32285
13281,4999,3973,4274,-301,3973,3973,3973,3856,117,3856
13282,10601,10597,10527,70,10527,10527,10601,10416,185,10416
13283,36545,36457,36543,-86,36457,36457,36436,36249,187,36249
13284,20536,20061,18917,1144,18917,18917,20070,18840,1230,18840
13285,446144,472425,446117,26308,446117,446117,472433,443955,28478,443955
13286,47802,46872,46905,-33,46872,46872,46875,46488,387,46488
13287,14208,12801,12910,-109,12801,12801,12807,12803,4,12803
13288,827511,805133,789563,15570,789563,789563,805126,779941,25185,779941
13289,75722,75555,72175,3380,72175,72175,75583,71489,4094,71489
13290,9301,9308,9775,-467,9308,9301,9307,8679,628,8679
13291,91750,80658,80364,294,80364,80364,80655,79445,1210,79445
13292,10309,10227,10243,-16,10227,10227,10226,10030,196,10030
13293,322957,349142,329687,19455,329687,322957,349172,322949,26223,322949
13294,145543,145512,137707,7805,137707,137707,145543,135571,9972,135571
13295,190394,189554,181736,7818,181736,181736,189452,179722,9730,179722
13296,4247,4232,4538,-306,4232,4232,4232,4197,35,4197
13297,112052,93191,90573,2618,90573,90573,93181,89968,3213,89968
13298,156001,154999,155560,-561,154999,154999,155029,148856,6173,148856
13299,475719,475752,453427,22325,453427,453427,475719,445314,30405,445314
13300,7892,8056,7829,227,7829,7829,8056,7416,640,7416
13301,265597,239387,240626,-1239,239387,239387,239542,235869,3673,235869
13302,2035,1081,1322,-241,1081,1081,1080,1135,-55,1135
13303,21310,22379,21246,1133,21246,21246,22375,20866,1509,20866
13304,140655,108149,107026,1123,107026,107026,108130,105494,2636,105494
13305,30584,28934,27690,1244,27690,27690,28928,27659,1269,27659
13306,12399,8658,8681,-23,8658,8658,8651,8494,157,8494
13307,426873,424878,405232,19646,405232,405232,425024,402531,22493,402531
13308,12010,10493,11302,-809,10493,10493,10499,9657,842,9657
13309,35801,34696,33269,1427,33269,33269,34691,33074,1617,33074
13310,7614,7118,7112,6,7112,7112,7115,6853,262,6853
13311,30161,30419,30157,262,30157,30157,30439,29335,1104,29335
13312,35730,34941,33921,1020,33921,33921,34933,33871,1062,33871
13313,237920,237022,234265,2757,234265,234265,237077,230195,6882,230195
13314,10626,9813,9860,-47,9813,9813,9820,9660,160,9660
13315,232549,198179,190933,7246,190933,190933,198095,190216,7879,190216
13316,8111,4121,4209,-88,4121,4121,4122,4082,40,4082
13317,16395,15489,15381,108,15381,15381,15489,15161,328,15161
13318,163461,172180,163352,8828,163352,163352,172246,161418,10828,161418
13319,98512,98384,97472,912,97472,97472,98416,95180,3236,95180
13320,306181,294779,289837,4942,289837,289837,294790,287189,7601,287189
13321,31540,30439,29174,1265,29174,29174,30441,29080,1361,29080
13322,82580,73527,71764,1763,71764,71764,73536,71330,2206,71330
13323,1541040,1506274,1412426,93848,1412426,1412426,1506636,1405764,100872,1405764
13324,17017,15652,15137,515,15137,15137,15653,14859,794,14859
13325,13777,5570,5629,-59,5570,5570,5570,5387,183,5387
13326,103965,107286,103879,3407,103879,103879,107293,102276,5017,102276
13327,17297,15919,14947,972,14947,14947,15931,14509,1422,14509
13328,2055,1802,1993,-191,1802,1802,1802,1782,20,1782
13329,93384,93439,89362,4077,89362,89362,93384,88022,5362,88022
13330,39131,39129,37855,1274,37855,37855,39131,37669,1462,37669
13331,308843,224886,231727,-6841,224886,224886,224929,216406,8523,216406
13332,672620,692404,672294,20110,672294,672294,692388,662247,30141,662247
13333,8224,7382,6981,401,6981,6981,7382,6608,774,6608
13334,5403,4909,5018,-109,4909,4909,4913,4888,25,4888
13335,2509,2237,2449,-212,2237,2237,2237,2224,13,2224
13336,87995,87388,83917,3471,83917,83917,87394,83545,3849,83545
13337,324583,251921,245033,6888,245033,245033,251937,242866,9071,242866
13338,10873,10194,10023,171,10023,10023,10192,9764,428,9764
13339,131667,129701,127392,2309,127392,127392,129779,127025,2754,127025
13340,30260,27099,27128,-29,27099,27099,27098,26789,309,26789
13341,76270,78083,76453,1630,76453,76270,78096,76228,1868,76228
13342,44220,44210,42033,2177,42033,42033,44220,41573,2647,41573
13343,342708,339209,326078,13131,326078,326078,339292,325968,13324,325968
13344,11974,11979,11781,198,11781,11781,11974,11573,401,11573
13345,21097,18230,17683,547,17683,17683,18227,17540,687,17540
13346,55470,46156,44609,1547,44609,44609,46146,44096,2050,44096
13347,12446,2184,2419,-235,2184,2184,2184,2194,-10,2194
13348,33847,33231,31920,1311,31920,31920,33222,31858,1364,31858
13349,18783,17943,17593,350,17593,17593,17942,17244,698,17244
13350,10272,9709,9652,57,9652,9652,9718,9346,372,9346
13351,729192,728427,689697,38730,689697,689697,728304,686517,41787,686517
13352,40878,42730,40596,2134,40596,40596,42736,40256,2480,40256
13353,10935,10474,10320,154,10320,10320,10480,10197,283,10197
13354,73510,65250,65224,26,65224,65224,65225,64333,892,64333
13355,43807,44622,45612,-990,44622,43807,44643,43799,844,43799
13356,15920,12311,12306,5,12306,12306,12318,12079,239,12079
13357,4746,4513,4686,-173,4513,4513,4517,4464,53,4464
13358,65824,68922,67166,1756,67166,65824,68916,65968,2948,65824
13359,12385,11247,11146,101,11146,11146,11250,9632,1618,9632
13360,33281,31572,31216,356,31216,31216,31593,30029,1564,30029
13361,41736,43121,41684,1437,41684,41684,43146,41115,2031,41115
13362,45115,44298,42551,1747,42551,42551,44318,42440,1878,42440
13363,14785,14785,14287,498,14287,14287,14785,13791,994,13791
13364,439077,447936,448397,-461,447936,439077,448009,439069,8940,439069
13365,6654,6657,6607,50,6607,6607,6654,6536,118,6536
13366,134870,134724,127839,6885,127839,127839,134744,126780,7964,126780
13367,449318,430356,414540,15816,414540,414540,430450,406733,23717,406733
13368,29895,29256,28435,821,28435,28435,29239,28169,1070,28169
13369,8646,8618,8869,-251,8618,8618,8619,8653,-34,8646
13370,2824,3256,3693,-437,3256,2824,3256,2816,440,2816
13371,18960,17007,16494,513,16494,16494,17006,15679,1327,15679
13372,3891,3892,4075,-183,3892,3891,3891,3906,-15,3891
13373,14074,13565,13244,321,13244,13244,13552,13058,494,13058
13374,7753,7741,7443,298,7443,7443,7741,7066,675,7066
13375,32591,31965,31234,731,31234,31234,31965,31028,937,31028
13376,7583,7656,7520,136,7520,7520,7656,7163,493,7163
13377,11326,10894,10878,16,10878,10878,10900,10736,164,10736
13378,78260,78235,77085,1150,77085,77085,78278,76091,2187,76091
13379,18841,7905,7916,-11,7905,7905,7908,7780,128,7780
13380,15453,15178,15393,-215,15178,15178,15179,14980,199,14980
13381,13478,13069,12932,137,12932,12932,13072,12746,326,12746
13382,36105,35172,36198,-1026,35172,35172,35179,34723,456,34723
13383,14106,13650,13368,282,13368,13368,13651,13168,483,13168
13384,4366,3825,3888,-63,3825,3825,3824,3745,79,3745
13385,52508,40054,39213,841,39213,39213,40073,38590,1483,38590
13386,2035,1100,1305,-205,1100,1100,1100,1145,-45,1145
13387,49725,49735,47093,2642,47093,47093,49725,46537,3188,46537
13388,47338,46404,46179,225,46179,46179,46434,45500,934,45500
13389,2450,1812,2016,-204,1812,1812,1812,1828,-16,1828
13390,650628,666057,650553,15504,650553,650553,665947,640912,25035,640912
13391,6905,6881,6880,1,6880,6880,6883,6780,103,6780
13392,4056,4004,3996,8,3996,3996,4005,3860,145,3860
13393,92341,68153,63548,4605,63548,63548,68161,62430,5731,62430
13394,3324,2384,2617,-233,2384,2384,2386,2332,54,2332
13395,38770,11944,11595,349,11595,11595,11948,11679,269,11679
13396,222902,221136,222010,-874,221136,221136,221144,219681,1463,219681
13397,162941,167856,165329,2527,165329,162941,167949,160928,7021,160928
13398,36745,38148,36745,1403,36745,36745,38170,36602,1568,36602
13399,677,305,539,-234,305,305,305,343,-38,343
13400,91226,99000,94816,4184,94816,91226,99038,91954,7084,91226
13401,33708,33713,32189,1524,32189,32189,33724,31999,1725,31999
13402,1454,1235,1454,-219,1235,1235,1235,1274,-39,1274
13403,125928,125822,119476,6346,119476,119476,125928,118876,7052,118876
13404,16677,15953,15504,449,15504,15504,15967,15399,568,15399
13405,10203,9555,9514,41,9514,9514,9559,9398,161,9398
13406,140116,147942,141335,6607,141335,140116,147888,140107,7781,140107
13407,5596,5182,5247,-65,5182,5182,5186,5126,60,5126
13408,33665,30199,29745,454,29745,29745,30200,29080,1120,29080
13409,1222274,1195077,1136306,58771,1136306,1136306,1195323,1118272,77051,1118272
13410,782402,716808,675186,41622,675186,675186,716865,666895,49970,666895
13411,3679,497,743,-246,497,497,497,546,-49,546
13412,75417,77724,76771,953,76771,75417,77773,74795,2978,74795
13413,42374,43717,42701,1016,42701,42374,43713,42465,1248,42374
13414,36892,16732,16379,353,16379,16379,16726,16342,384,16342
13415,1687,1685,1871,-186,1685,1685,1687,1723,-36,1687
13416,12902,12890,13119,-229,12890,12890,12902,12772,130,12772
13417,14695,13973,13453,520,13453,13453,13978,13400,578,13400
13418,7519,7510,7824,-314,7510,7510,7519,7399,120,7399
13419,30472,30489,29241,1248,29241,29241,30488,29130,1358,29130
13420,607477,644022,611903,32119,611903,607477,643891,607469,36422,607469
13421,1557,1250,1496,-246,1250,1250,1251,1265,-14,1265
13422,26449,25512,24501,1011,24501,24501,25526,23506,2020,23506
13423,29010,15121,14679,442,14679,14679,15127,14528,599,14528
13424,70832,69561,69345,216,69345,69345,69552,68489,1063,68489
13425,21022,20317,19346,971,19346,19346,20341,19273,1068,19273
13426,46324,43508,42247,1261,42247,42247,43535,41261,2274,41261
13427,86348,90370,84121,6249,84121,84121,90384,81247,9137,81247
13428,39834,39107,37891,1216,37891,37891,39124,37547,1577,37547
13429,19370,19318,19309,9,19309,19309,19318,19029,289,19029
13430,60624,60602,58970,1632,58970,58970,60624,58595,2029,58595
13431,91191,90319,91602,-1283,90319,90319,90365,85549,4816,85549
13432,28558,25953,25215,738,25215,25215,25942,25146,796,25146
13433,96398,98478,99448,-970,98478,96398,98480,96744,1736,96398
13434,18169,17986,18106,-120,17986,17986,17998,17820,178,17820
13435,1673640,1663261,1582223,81038,1582223,1582223,1662999,1567814,95185,1567814
13436,78910,83248,78907,4341,78907,78907,83210,78612,4598,78612
13437,3485,3500,3818,-318,3500,3485,3501,3538,-37,3485
13438,96203,95279,93720,1559,93720,93720,95228,92671,2557,92671
13439,35553,13938,13870,68,13870,13870,13938,13186,752,13186
13440,17437,16081,16111,-30,16081,16081,16081,15933,148,15933
13441,11995,11477,11459,18,11459,11459,11474,11271,203,11271
13442,51375,51956,51299,657,51299,51299,51976,50450,1526,50450
13443,110715,113904,113832,72,113832,110715,114025,110671,3354,110671
13444,50601,53640,50591,3049,50591,50591,53641,50351,3290,50351
13445,1465,1357,1608,-251,1357,1357,1356,1420,-64,1420
13446,836462,886192,836435,49757,836435,836435,886164,835157,51007,835157
13447,123560,100193,95856,4337,95856,95856,100216,94237,5979,94237
13448,237315,249304,245895,3409,245895,237315,249274,237307,11967,237307
13449,299789,292889,278574,14315,278574,278574,292956,277753,15203,277753
13450,2405,2200,2407,-207,2200,2200,2200,2234,-34,2234
13451,185773,161835,154238,7597,154238,154238,161853,151261,10592,151261
13452,90752,63984,59897,4087,59897,59897,63973,58722,5251,58722
13453,91260,78545,75667,2878,75667,75667,78537,75431,3106,75431
13454,2654,2603,2593,10,2593,2593,2605,2251,354,2251
13455,54989,54983,53228,1755,53228,53228,54989,52966,2023,52966
13456,54691,53330,51478,1852,51478,51478,53329,51355,1974,51355
13457,106511,104546,103624,922,103624,103624,104538,103397,1141,103397
13458,14729,14033,13513,520,13513,13513,14031,13311,720,13311
13459,86784,81472,80082,1390,80082,80082,81540,79013,2527,79013
13460,88012,90440,88926,1514,88926,88012,90464,88127,2337,88012
13461,178688,181865,179767,2098,179767,178688,181888,178680,3208,178680
13462,53572,47101,44861,2240,44861,44861,47093,44505,2588,44505
13463,65469,68576,65475,3101,65475,65469,68535,65395,3140,65395
13464,62388,58776,57078,1698,57078,57078,58770,56363,2407,56363
13465,4835,4515,4774,-259,4515,4515,4516,4457,59,4457
13466,78005,74646,71802,2844,71802,71802,74657,71526,3131,71526
13467,10786,10809,10784,25,10784,10784,10814,10596,218,10596
13468,55668,47764,46611,1153,46611,46611,47761,46295,1466,46295
13469,184557,196363,185055,11308,185055,184557,196178,184557,11621,184557
13470,54121,53244,52204,1040,52204,52204,53249,51743,1506,51743
13471,36686,12228,12383,-155,12228,12228,12232,12142,90,12142
13472,2636,1936,2141,-205,1936,1936,1936,1969,-33,1969
13473,20158,24546,23888,658,23888,20158,24546,19822,4724,19822
13474,710413,703451,693164,10287,693164,693164,703620,680325,23295,680325
13475,16062,2735,2923,-188,2735,2735,2735,2771,-36,2771
13476,47255,46321,44789,1532,44789,44789,46328,44519,1809,44519
13477,137634,116818,112557,4261,112557,112557,116812,111442,5370,111442
13478,127307,143310,132432,10878,132432,127307,143353,126685,16668,126685
13479,20889,20874,20986,-112,20874,20874,20889,20546,343,20546
13480,131953,143160,134564,8596,134564,131953,143168,132008,11160,131953
13481,8949,9122,8945,177,8945,8945,9113,8835,278,8835
13482,13119,12669,12600,69,12600,12600,12665,12347,318,12347
13483,183275,181965,174501,7464,174501,174501,181912,173888,8024,173888
13484,30697,29130,28796,334,28796,28796,29151,28336,815,28336
13485,6903,6899,7159,-260,6899,6899,6903,6942,-39,6903
13486,117763,111488,105973,5515,105973,105973,111535,105325,6210,105325
13487,42279,40959,38548,2411,38548,38548,40897,38406,2491,38406
13488,18185,18977,18172,805,18172,18172,18986,17737,1249,17737
13489,25496,25452,25273,179,25273,25273,25464,24555,909,24555
13490,33744,20465,20372,93,20372,20372,20480,19419,1061,19419
13491,14747,13913,13678,235,13678,13678,13919,13424,495,13424
13492,11266,11416,11200,216,11200,11200,11413,11009,404,11009
13493,133386,136143,137513,-1370,136143,133386,136234,134196,2038,133386
13494,51397,52069,53059,-990,52069,51397,52095,51764,331,51397
13495,29645,29626,28399,1227,28399,28399,29645,27404,2241,27404
13496,23676,24120,23615,505,23615,23615,24121,23472,649,23472
13497,17241,16482,16280,202,16280,16280,16483,15980,503,15980
13498,11684,11009,10772,237,10772,10772,11008,9987,1021,9987
13499,566496,566462,550001,16461,550001,550001,566496,546316,20180,546316
13500,145611,145634,140984,4650,140984,140984,145611,140418,5193,140418
13501,8119,7975,8189,-214,7975,7975,7978,7925,53,7925
13502,14109,13205,12828,377,12828,12828,13211,12697,514,12697
13503,56034,28437,28265,172,28265,28265,28436,27948,488,27948
13504,3854,3446,3557,-111,3446,3446,3442,3428,14,3428
13505,36590,36172,34993,1179,34993,34993,36175,34734,1441,34734
13506,80513,79561,75988,3573,75988,75988,79518,75413,4105,75413
13507,243475,239312,235536,3776,235536,235536,239500,233870,5630,233870
13508,44861,44087,44059,28,44059,44059,44099,43422,677,43422
13509,1716,1698,1967,-269,1698,1698,1699,1750,-51,1716
13510,103405,89777,89550,227,89550,89550,89819,87866,1953,87866
13511,77862,74403,70922,3481,70922,70922,74423,70110,4313,70110
13512,45748,49439,47078,2361,47078,45748,49468,45740,3728,45740
13513,13315,12548,12372,176,12372,12372,12556,12041,515,12041
13514,26866,25960,25526,434,25526,25526,25956,25323,633,25323
13515,118935,87264,82400,4864,82400,82400,87320,80173,7147,80173
13516,429314,428392,403856,24536,403856,403856,428510,398236,30274,398236
13517,46931,46926,45111,1815,45111,45111,46931,44848,2083,44848
13518,8289,7902,8084,-182,7902,7902,7902,7851,51,7851
13519,85105,36538,34757,1781,34757,34757,36568,34100,2468,34100
13520,41235,40387,39201,1186,39201,39201,40371,38653,1718,38653
13521,2950,2492,2653,-161,2492,2492,2493,2455,38,2455
13522,186737,183621,170850,12771,170850,170850,183575,170650,12925,170650
13523,10972,10918,11161,-243,10918,10918,10922,10832,90,10832
13524,23589,24270,23724,546,23724,23589,24271,23615,656,23589
13525,517582,505642,485287,20355,485287,485287,505520,482701,22819,482701
13526,2819,2835,2926,-91,2835,2819,2837,2725,112,2725
13527,116685,123085,116672,6413,116672,116672,123051,115623,7428,115623
13528,29521,14524,14082,442,14082,14082,14527,13696,831,13696
13529,44177,45474,45667,-193,45474,44177,45488,44355,1133,44177
13530,160058,156557,154035,2522,154035,154035,156629,150440,6189,150440
13531,11874,7055,7385,-330,7055,7055,7055,6903,152,6903
13532,14277,13720,13390,330,13390,13390,13723,13199,524,13199
13533,182292,182172,178738,3434,178738,178738,182156,177156,5000,177156
13534,8601,8440,8678,-238,8440,8440,8442,8378,64,8378
13535,29435,29438,29119,319,29119,29119,29435,28814,621,28814
13536,2469,2467,2641,-174,2467,2467,2468,2461,7,2461
13537,255205,231163,219124,12039,219124,219124,231290,217755,13535,217755
13538,7507,6365,6452,-87,6365,6365,6362,6354,8,6354
13539,123875,113120,112210,910,112210,112210,113193,110855,2338,110855
13540,12258,12737,12798,-61,12737,12258,12741,12258,483,12258
13541,162356,135377,130798,4579,130798,130798,135376,130152,5224,130152
13542,6652,6649,6467,182,6467,6467,6652,6173,479,6173
13543,9191,9325,9186,139,9186,9186,9330,8749,581,8749
13544,88977,89007,84439,4568,84439,84439,88977,84095,4882,84095
13545,47330,48689,47304,1385,47304,47304,48689,46448,2241,46448
13546,127198,132920,127070,5850,127070,127070,132897,126458,6439,126458
13547,19924,20122,19918,204,19918,19918,20123,19702,421,19702
13548,14967,14945,15323,-378,14945,14945,14967,14819,148,14819
13549,36061,17494,17433,61,17433,17433,17496,17135,361,17135
13550,134054,131863,130417,1446,130417,130417,131883,129210,2673,129210
13551,5643,5256,5379,-123,5256,5256,5252,5203,49,5203
13552,109218,113207,109186,4021,109186,109186,113222,108363,4859,108363
13553,1610,1608,1891,-283,1608,1608,1610,1610,0,1610
13554,80507,79696,76958,2738,76958,76958,79695,75991,3704,75991
13555,26515,22793,22561,232,22561,22561,22811,22400,411,22400
13556,27337,23556,22728,828,22728,22728,23550,22321,1229,22321
13557,12769,12167,11897,270,11897,11897,12175,11622,553,11622
13558,18307,4275,4280,-5,4275,4275,4279,4019,260,4019
13559,5610,5609,5655,-46,5609,5609,5610,5540,70,5540
13560,46639,47960,46579,1381,46579,46579,47968,46346,1622,46346
13561,13125,294,526,-232,294,294,294,340,-46,340
13562,5777,5747,5774,-27,5747,5747,5749,5624,125,5624
13563,83113,81863,80302,1561,80302,80302,81917,79726,2191,79726
13564,57197,58713,58090,623,58090,57197,58700,57291,1409,57197
13565,36937,36029,34852,1177,34852,34852,36027,34766,1261,34766
13566,1738,1738,1976,-238,1738,1738,1738,1773,-35,1738
13567,369652,366591,343163,23428,343163,343163,366490,339822,26668,339822
13568,5469,5401,5470,-69,5401,5401,5397,5343,54,5343
13569,169659,144216,139415,4801,139415,139415,144237,136767,7470,136767
13570,2547,2550,2697,-147,2550,2547,2547,2555,-8,2547
13571,6263,5711,5708,3,5708,5708,5709,5581,128,5581
13572,72944,72047,71431,616,71431,71431,72033,67761,4272,67761
13573,162239,121049,113279,7770,113279,113279,121068,108978,12090,108978
13574,17483,307,540,-233,307,307,307,353,-46,353
13575,578573,574457,555440,19017,555440,555440,574866,553130,21736,553130
13576,65830,64442,62104,2338,62104,62104,64439,61777,2662,61777
13577,464046,463013,442481,20532,442481,442481,463236,435823,27413,435823
13578,58039,53027,49466,3561,49466,49466,53036,48561,4475,48561
13579,9651,9431,9649,-218,9431,9431,9435,9372,63,9372
13580,9923,9913,9948,-35,9913,9913,9923,9577,346,9577
13581,23945,22705,22655,50,22655,22655,22713,21910,803,21910
13582,62754,55720,53136,2584,53136,53136,55747,52777,2970,52777
13583,41314,40470,38186,2284,38186,38186,40482,36541,3941,36541
13584,8948,8414,8451,-37,8414,8414,8414,8265,149,8265
13585,5857,5447,5657,-210,5447,5447,5449,5453,-4,5453
13586,75225,76721,76417,304,76417,75225,76777,75217,1560,75217
13587,14020,14344,14302,42,14302,14020,14351,14056,295,14020
13588,138254,145702,146569,-867,145702,138254,145693,139869,5824,138254
13589,29357,29805,29097,708,29097,29097,29818,28735,1083,28735
13590,42410,44776,42401,2375,42401,42401,44796,42269,2527,42269
13591,592603,583290,561971,21319,561971,561971,583242,556860,26382,556860
13592,69658,22893,22411,482,22411,22411,22890,22255,635,22255
13593,22294,9228,9241,-13,9228,9228,9234,9061,173,9061
13594,101181,100180,96552,3628,96552,96552,100232,96477,3755,96477
13595,10924,9599,9173,426,9173,9173,9607,9047,560,9047
13596,507214,537121,511065,26056,511065,507214,537081,507602,29479,507214
13597,4103,4102,4331,-229,4102,4102,4103,4126,-23,4103
13598,11455,9935,9823,112,9823,9823,9929,9661,268,9661
13599,28004,26899,26022,877,26022,26022,26907,25885,1022,25885
13600,5297,5262,5273,-11,5262,5262,5261,5098,163,5098
13601,1599,1180,1427,-247,1180,1180,1180,1219,-39,1219
13602,23244,22313,21665,648,21665,21665,22321,21570,751,21570
13603,120701,119909,116030,3879,116030,116030,119893,115142,4751,115142
13604,2118,2120,2347,-227,2120,2118,2118,2154,-36,2118
13605,328918,341879,331091,10788,331091,328918,341735,328314,13421,328314
13606,10160,9306,9192,114,9192,9192,9308,9155,153,9155
13607,6823,6837,6788,49,6788,6788,6836,6513,323,6513
13608,132021,136612,132007,4605,132007,132007,136602,131223,5379,131223
13609,32769,18752,18814,-62,18752,18752,18754,18580,174,18580
13610,6447,6219,6444,-225,6219,6219,6221,6215,6,6215
13611,129179,134675,130283,4392,130283,129179,134648,129470,5178,129179
13612,26036,26138,25772,366,25772,25772,26143,25414,729,25414
13613,97817,97762,97772,-10,97762,97762,97817,96308,1509,96308
13614,27320,27183,26496,687,26496,26496,27190,26387,803,26387
13615,24953,24398,23347,1051,23347,23347,24399,23204,1195,23204
13616,15464,11386,11324,62,11324,11324,11387,11162,225,11162
13617,11001,10374,10613,-239,10374,10374,10372,10331,41,10331
13618,23092,20738,19867,871,19867,19867,20747,19288,1459,19288
13619,11566,10720,10670,50,10670,10670,10720,10408,312,10408
13620,29720,19819,19544,275,19544,19544,19836,18221,1615,18221
13621,17469,16879,16425,454,16425,16425,16880,16384,496,16384
13622,122841,124223,124882,-659,124223,122841,124229,117500,6729,117500
13623,3054,3054,3137,-83,3054,3054,3054,2798,256,2798
13624,6609,5305,5374,-69,5305,5305,5307,5199,108,5199
13625,21484,4210,4378,-168,4210,4210,4213,4079,134,4079
13626,33988,33339,33032,307,33032,33032,33331,32686,645,32686
13627,16493,16028,15648,380,15648,15648,16030,15490,540,15490
13628,26379,23859,23523,336,23523,23523,23864,23123,741,23123
13629,143766,143612,140749,2863,140749,140749,143645,139236,4409,139236
13630,262051,274565,277199,-2634,274565,262051,274539,262043,12496,262043
13631,3849,3415,3649,-234,3415,3415,3416,3406,10,3406
13632,82858,77540,70792,6748,70792,70792,77563,70199,7364,70199
13633,1263622,977524,949804,27720,949804,949804,978361,932353,46008,932353
13634,17272,17276,17545,-269,17276,17272,17291,17272,19,17272
13635,54791,54786,52441,2345,52441,52441,54791,52332,2459,52332
13636,280728,275513,268573,6940,268573,268573,275506,267338,8168,267338
13637,48011,29835,28022,1813,28022,28022,29845,26609,3236,26609
13638,12173,12169,12193,-24,12169,12169,12173,11942,231,11942
13639,11885,11043,11584,-541,11043,11043,11053,11122,-69,11122
13640,25187,25892,25186,706,25186,25186,25894,25018,876,25018
13641,71071,70215,67976,2239,67976,67976,70193,67662,2531,67662
13642,133163,133157,128770,4387,128770,128770,133163,128680,4483,128680
13643,11214,10648,10173,475,10173,10173,10650,10136,514,10136
13644,293927,247600,238637,8963,238637,238637,247700,235697,12003,235697
13645,8195,8198,8202,-4,8198,8195,8195,8007,188,8007
13646,12863,12119,12388,-269,12119,12119,12132,12146,-14,12146
13647,35985,36010,33622,2388,33622,33622,35985,33425,2560,33425
13648,26192,25289,24316,973,24316,24316,25291,24319,972,24319
13649,2035,1110,1331,-221,1110,1110,1110,1162,-52,1162
13650,30557,34138,34881,-743,34138,30557,34146,30549,3597,30549
13651,15851,14907,14517,390,14517,14517,14898,14311,587,14311
13652,369268,369152,349768,19384,349768,349768,369284,335494,33790,335494
13653,18524,18540,17691,849,17691,17691,18542,17551,991,17551
13654,64684,45180,43407,1773,43407,43407,45196,43002,2194,43002
13655,7631886,7668507,7197319,471188,7197319,7197319,7665346,7090409,574937,7090409
13656,68503,69013,68359,654,68359,68359,69029,67881,1148,67881
13657,15843,15414,15243,171,15243,15243,15404,14997,407,14997
13658,9316,9567,9601,-34,9567,9316,9564,9336,228,9316
13659,6118,5696,5805,-109,5696,5696,5695,5648,47,5648
13660,7532,7524,7761,-237,7524,7524,7532,7437,95,7437
13661,14163,13300,12969,331,12969,12969,13310,12822,488,12822
13662,57320,56753,53110,3643,53110,53110,56766,52649,4117,52649
13663,155331,152690,150583,2107,150583,150583,152703,148018,4685,148018
13664,120459,122494,125787,-3293,122494,120459,122462,120451,2011,120451
13665,5290,4718,4833,-115,4718,4718,4712,4577,135,4577
13666,15005,15003,14835,168,14835,14835,15005,14595,410,14595
13667,253469,256409,253333,3076,253333,253333,256392,252033,4359,252033
13668,171906,143870,137821,6049,137821,137821,143847,136204,7643,136204
13669,56755,58083,56760,1323,56760,56755,58108,55703,2405,55703
13670,2058,1687,1902,-215,1687,1687,1689,1737,-48,1737
13671,6547,6035,6097,-62,6035,6035,6034,5800,234,5800
13672,22457,21455,21017,438,21017,21017,21457,20418,1039,20418
13673,9160,9175,9155,20,9155,9155,9179,9008,171,9008
13674,57678,54057,51323,2734,51323,51323,54061,50479,3582,50479
13675,4860,4681,4863,-182,4681,4681,4682,4466,216,4466
13676,3719,3239,3430,-191,3239,3239,3243,3256,-13,3256
13677,351280,288523,276991,11532,276991,276991,288584,275073,13511,275073
13678,44052,44944,43692,1252,43692,43692,44952,43430,1522,43430
13679,100751,48955,48637,318,48637,48637,48963,48111,852,48111
13680,90566,86950,82121,4829,82121,82121,86988,81688,5300,81688
13681,74069,77735,74053,3682,74053,74053,77736,73061,4675,73061
13682,30805,14420,13880,540,13880,13880,14411,13757,654,13757
13683,57176,57160,55323,1837,55323,55323,57176,54750,2426,54750
13684,1682,1683,1771,-88,1683,1682,1682,1665,17,1665
13685,84475,86227,84872,1355,84872,84475,86228,84050,2178,84050
13686,25431,25394,25148,246,25148,25148,25394,24828,566,24828
13687,390811,389836,377770,12066,377770,377770,390009,366139,23870,366139
13688,84981,83281,80380,2901,80380,80380,83288,79865,3423,79865
13689,45633,45630,44623,1007,44623,44623,45633,44207,1426,44207
13690,14795,13746,13385,361,13385,13385,13750,13177,573,13177
13691,35627,37106,38442,-1336,37106,35627,37123,35619,1504,35619
13692,828515,766469,738669,27800,738669,738669,766667,728633,38034,728633
13693,32810,32744,31169,1575,31169,31169,32749,31029,1720,31029
13694,9257,8597,8511,86,8511,8511,8607,8258,349,8258
13695,48555,32605,31849,756,31849,31849,32615,30913,1702,30913
13696,48135,33371,32059,1312,32059,32059,33394,31955,1439,31955
13697,13944,14273,14265,8,14265,13944,14269,13897,372,13897
13698,23991,23601,23243,358,23243,23243,23600,23037,563,23037
13699,56669,45820,44716,1104,44716,44716,45825,44543,1282,44543
13700,291479,294199,288293,5906,288293,288293,294316,286748,7568,286748
13701,41081,24521,23549,972,23549,23549,24530,22942,1588,22942
13702,234411,202778,190653,12125,190653,190653,202847,188891,13956,188891
13703,80846,68170,65965,2205,65965,65965,68204,66019,2185,66019
13704,1958688,1910507,1805927,104580,1805927,1805927,1910141,1797601,112540,1797601
13705,5655,5654,5798,-144,5654,5654,5655,5623,32,5623
13706,106597,100628,99774,854,99774,99774,100654,99008,1646,99008
13707,26306,10771,10644,127,10644,10644,10764,10270,494,10270
13708,1237,840,1086,-246,840,840,839,896,-57,896
13709,6643,3086,3294,-208,3086,3086,3084,2877,207,2877
13710,44177,45399,44399,1000,44399,44177,45439,44169,1270,44169
13711,63879,60493,57590,2903,57590,57590,60505,55660,4845,55660
13712,165289,164414,161180,3234,161180,161180,164426,159601,4825,159601
13713,19264,18015,17734,281,17734,17734,18019,17487,532,17487
13714,45470,45466,43927,1539,43927,43927,45470,43589,1881,43589
13715,21238,21238,20810,428,20810,20810,21241,20586,655,20586
13716,203978,187156,180782,6374,180782,180782,187291,178734,8557,178734
13717,30267,15808,15838,-30,15808,15808,15809,15585,224,15585
13718,4267,3950,4075,-125,3950,3950,3952,3921,31,3921
13719,2930,2085,2328,-243,2085,2085,2084,2144,-60,2144
13720,27536,27859,28721,-862,27859,27536,27853,27528,325,27528
13721,2454,2214,2394,-180,2214,2214,2213,2252,-39,2252
13722,4939,4862,4937,-75,4862,4862,4878,4537,341,4537
13723,9547,9430,9418,12,9418,9418,9430,9273,157,9273
13724,79221,82071,82066,5,82066,79221,82113,79213,2900,79213
13725,80431,79833,79131,702,79131,79131,79877,78406,1471,78406
13726,127502,126632,125603,1029,125603,125603,126652,123817,2835,123817
13727,50509,50505,49204,1301,49204,49204,50509,48826,1683,48826
13728,87668,82948,78891,4057,78891,78891,82951,78260,4691,78260
13729,23187,23187,22920,267,22920,22920,23187,22619,568,22619
13730,46602,44069,43216,853,43216,43216,44061,42418,1643,42418
13731,7457,6937,6844,93,6844,6844,6939,6590,349,6590
13732,1735,1330,1537,-207,1330,1330,1330,1381,-51,1381
13733,28975,26988,25628,1360,25628,25628,26996,25301,1695,25301
13734,34700,33899,33755,144,33755,33755,33903,33188,715,33188
13735,12629,12156,12090,66,12090,12090,12158,11918,240,11918
13736,122329,97479,92538,4941,92538,92538,97522,90982,6540,90982
13737,92981,95881,92952,2929,92952,92952,95939,92457,3482,92457
13738,912064,847872,797265,50607,797265,797265,847843,790363,57480,790363
13739,15042,15220,15140,80,15140,15042,15222,14989,233,14989
13740,7068,6401,7069,-668,6401,6401,6403,6534,-131,6534
13741,87519,81917,76532,5385,76532,76532,81936,75787,6149,75787
13742,22080,22036,21564,472,21564,21564,22037,21484,553,21484
13743,93280,92395,89043,3352,89043,89043,92417,76972,15445,76972
13744,2125,2107,2324,-217,2107,2107,2109,2135,-26,2125
13745,7941,7324,7387,-63,7324,7324,7322,7319,3,7319
13746,97626,88934,83977,4957,83977,83977,88966,83200,5766,83200
13747,35676,35680,35416,264,35416,35416,35676,35029,647,35029
13748,144975,135802,128910,6892,128910,128910,135741,127801,7940,127801
13749,16242,16610,17065,-455,16610,16242,16607,16450,157,16242
13750,246403,246264,235190,11074,235190,235190,246155,234101,12054,234101
13751,31573,31560,30445,1115,30445,30445,31573,30214,1359,30214
13752,50053,36137,35089,1048,35089,35089,36139,35061,1078,35061
13753,14540,14462,13643,819,13643,13643,14459,13311,1148,13311
13754,308228,282165,271005,11160,271005,271005,282116,266957,15159,266957
13755,10958,10267,10507,-240,10267,10267,10270,10278,-8,10278
13756,1540,702,962,-260,702,702,702,760,-58,760
13757,85393,89659,84547,5112,84547,84547,89650,84523,5127,84523
13758,17772,7462,7711,-249,7462,7462,7463,7448,15,7448
13759,38889,39396,39782,-386,39396,38889,39401,39090,311,38889
13760,7869,11406,12093,-687,11406,7869,11410,7861,3549,7861
13761,19453,18779,18579,200,18579,18579,18789,18316,473,18316
13762,61539,44570,44021,549,44021,44021,44571,43593,978,43593
13763,177677,175572,171689,3883,171689,171689,175649,170701,4948,170701
13764,64886,62157,61927,230,61927,61927,62212,61033,1179,61033
13765,70381,69216,67605,1611,67605,67605,69209,67335,1874,67335
13766,3188,2937,3123,-186,2937,2937,2937,2960,-23,2960
13767,42218,42952,42185,767,42185,42185,43001,41596,1405,41596
13768,245916,250838,243028,7810,243028,243028,250826,238021,12805,238021
13769,2478910,2618547,2483920,134627,2483920,2478910,2618786,2451137,167649,2451137
13770,49357,51622,49449,2173,49449,49357,51638,48865,2773,48865
13771,1569363,1567890,1480141,87749,1480141,1480141,1568406,1468473,99933,1468473
13772,27937,28832,27869,963,27869,27869,28846,27689,1157,27689
13773,49530,50563,49527,1036,49527,49527,50562,48887,1675,48887
13774,83061,63558,61370,2188,61370,61370,63533,60773,2760,60773
13775,10839,10839,10791,48,10791,10791,10839,10627,212,10627
13776,261931,243950,240932,3018,240932,240932,243996,237719,6277,237719
13777,14400,14394,14194,200,14194,14194,14396,13888,508,13888
13778,54197,29060,29092,-32,29060,29060,29070,27702,1368,27702
13779,54524,37908,37089,819,37089,37089,37915,36873,1042,36873
13780,409451,428092,415616,12476,415616,409451,428240,409451,18789,409451
13781,2014,2029,2307,-278,2029,2014,2030,2045,-15,2014
13782,639788,612843,578809,34034,578809,578809,612833,574243,38590,574243
13783,41843,40936,39629,1307,39629,39629,40934,39255,1679,39255
13784,39102,38286,37210,1076,37210,37210,38289,37000,1289,37000
13785,9422,8229,8009,220,8009,8009,8233,7821,412,7821
13786,548338,58095,58055,40,58055,58055,58127,56907,1220,56907
13787,4296,3607,3875,-268,3607,3607,3607,3644,-37,3644
13788,1667,1314,1534,-220,1314,1314,1316,1337,-21,1337
13789,5368,4522,4704,-182,4522,4522,4523,4525,-2,4525
13790,156420,133725,132976,749,132976,132976,133735,131861,1874,131861
13791,1900,1878,2157,-279,1878,1878,1878,1892,-14,1892
13792,2152087,2084788,1959240,125548,1959240,1959240,2084639,1939756,144883,1939756
13793,2037,2038,2328,-290,2038,2037,2037,1633,404,1633
13794,392562,403115,381789,21326,381789,381789,403164,380191,22973,380191
13795,29889,29855,29820,35,29820,29820,29871,29312,559,29312
13796,399905,417088,401040,16048,401040,399905,417112,395908,21204,395908
13797,83076,78137,74358,3779,74358,74358,78145,73957,4188,73957
13798,25753,24722,24832,-110,24722,24722,24731,24438,293,24438
13799,1249,880,1135,-255,880,880,880,933,-53,933
13800,191611,164015,156027,7988,156027,156027,164072,155486,8586,155486
13801,41883,43633,41866,1767,41866,41866,43633,41796,1837,41796
13802,22985,22155,22008,147,22008,22008,22153,21685,468,21685
13803,81677,79649,76177,3472,76177,76177,79603,75986,3617,75986
13804,2828,2007,2244,-237,2007,2007,2007,2063,-56,2063
13805,1619144,1596261,1546505,49756,1546505,1546505,1596722,1521323,75399,1521323
13806,18629,18624,18299,325,18299,18299,18629,18212,417,18212
13807,1325,1241,1501,-260,1241,1241,1241,1287,-46,1287
13808,2131,1744,1943,-199,1744,1744,1743,1769,-26,1769
13809,6306,6259,6305,-46,6259,6259,6259,6152,107,6152
13810,21053,22196,21051,1145,21051,21051,22201,20962,1239,20962
13811,38888,37947,36917,1030,36917,36917,37952,36367,1585,36367
13812,217278,204931,192243,12688,192243,192243,204924,190798,14126,190798
13813,23608,23610,22631,979,22631,22631,23626,20167,3459,20167
13814,10483,10488,10258,230,10258,10258,10483,10233,250,10233
13815,52441,36605,35601,1004,35601,35601,36604,34801,1803,34801
13816,6275,5570,5596,-26,5570,5570,5571,5388,183,5388
13817,7803,7645,7744,-99,7645,7645,7647,7415,232,7415
13818,31121,30504,30215,289,30215,30215,30515,29853,662,29853
13819,8651,8729,8648,81,8648,8648,8729,8352,377,8352
13820,8175,8172,8120,52,8120,8120,8175,7939,236,7939
13821,38612,46350,45852,498,45852,38612,46356,38534,7822,38534
13822,542107,536683,525952,10731,525952,525952,536707,521024,15683,521024
13823,7530,7068,6901,167,6901,6901,7068,6749,319,6749
13824,52330,51409,49280,2129,49280,49280,51403,49087,2316,49087
13825,47072,48243,47056,1187,47056,47056,48247,46816,1431,46816
13826,12369,12015,12123,-108,12015,12015,12017,11924,93,11924
13827,2187,1276,1477,-201,1276,1276,1275,1328,-53,1328
13828,177024,157919,149457,8462,149457,149457,157984,148925,9059,148925
13829,6925,6288,6395,-107,6288,6288,6289,6210,79,6210
13830,163419,167075,160227,6848,160227,160227,167013,158110,8903,158110
13831,73996,74861,73952,909,73952,73952,74896,73252,1644,73252
13832,26891,26895,26001,894,26001,26001,26891,25809,1082,25809
13833,448231,422806,400593,22213,400593,400593,422638,393712,28926,393712
13834,10482,10487,10508,-21,10487,10482,10482,10323,159,10323
13835,2032,2031,2239,-208,2031,2031,2032,2055,-23,2032
13836,293059,262501,250020,12481,250020,250020,262484,247411,15073,247411
13837,3222134,3164032,3024736,139296,3024736,3024736,3164263,3000473,163790,3000473
13838,3383,3229,3385,-156,3229,3229,3226,3225,1,3225
13839,272786,269080,253596,15484,253596,253596,269129,250984,18145,250984
13840,41190,42228,40642,1586,40642,40642,42234,40645,1589,40645
13841,61901,61077,58400,2677,58400,58400,61061,57995,3066,57995
13842,4521,4396,4459,-63,4396,4396,4395,4338,57,4338
13843,4872,4836,5052,-216,4836,4836,4833,4869,-36,4869
13844,514147,504962,480371,24591,480371,480371,505069,477733,27336,477733
13845,1019975,930129,894948,35181,894948,894948,930348,885495,44853,885495
13846,11287,11626,11280,346,11280,11280,11638,10836,802,10836
13847,31891,30980,31550,-570,30980,30980,30981,30716,265,30716
13848,1461,1052,1272,-220,1052,1052,1052,1105,-53,1105
13849,12935,11532,11271,261,11271,11271,11527,11017,510,11017
13850,3446,3444,3520,-76,3444,3444,3446,3392,54,3392
13851,19968,19956,18776,1180,18776,18776,19968,17766,2202,17766
13852,91603,93262,93885,-623,93262,91603,93301,91567,1734,91567
13853,64242,39849,40039,-190,39849,39849,39862,37121,2741,37121
13854,3378,3160,3315,-155,3160,3160,3162,3128,34,3128
13855,19597,18958,19142,-184,18958,18958,18969,18861,108,18861
13856,5000,4379,4284,95,4284,4284,4380,4044,336,4044
13857,2384,2381,2601,-220,2381,2381,2384,2431,-47,2384
13858,462860,479142,465868,13274,465868,462860,479070,464128,14942,462860
13859,19314,19308,17994,1314,17994,17994,19320,17437,1883,17437
13860,92092,91175,93311,-2136,91175,91175,91171,83087,8084,83087
13861,243104,204423,191767,12656,191767,191767,204412,189633,14779,189633
13862,70809,70752,69099,1653,69099,69099,70774,68705,2069,68705
13863,35923,34982,33286,1696,33286,33286,34982,33242,1740,33242
13864,45328,44344,43884,460,43884,43884,44358,43441,917,43441
13865,10036,9678,9603,75,9603,9603,9681,9414,267,9414
13866,102318,102322,99223,3099,99223,99223,102318,98606,3712,98606
13867,11278,10560,10360,200,10360,10360,10554,10160,394,10160
13868,56415,55113,53558,1555,53558,53558,55099,53333,1766,53333
13869,7582,6876,6860,16,6860,6860,6878,6439,439,6439
13870,120956,120915,120251,664,120251,120251,120956,116920,4036,116920
13871,9403,9559,9399,160,9399,9399,9557,9234,323,9234
13872,17530,17057,16567,490,16567,16567,17041,16436,605,16436
13873,19526,19352,19010,342,19010,19010,19354,18578,776,18578
13874,620200,608539,566997,41542,566997,566997,608733,565843,42890,565843
13875,86884,64698,65105,-407,64698,64698,64724,63821,903,63821
13876,7686,7043,7147,-104,7043,7043,7047,6840,207,6840
13877,5198,4388,4738,-350,4388,4388,4389,4459,-70,4459
13878,26333,25777,24910,867,24910,24910,25791,24792,999,24792
13879,12200,14216,14714,-498,14216,12200,14222,11910,2312,11910
13880,36266,36479,35915,564,35915,35915,36502,35644,858,35644
13881,18682,18692,18490,202,18490,18490,18682,18166,516,18166
13882,72475,65327,63127,2200,63127,63127,65314,62120,3194,62120
13883,3169,2799,3016,-217,2799,2799,2798,2843,-45,2843
13884,42841,43651,43839,-188,43651,42841,43670,42833,837,42833
13885,816,434,671,-237,434,434,433,478,-45,478
13886,3284,3179,3282,-103,3179,3179,3181,3060,121,3060
13887,724160,720577,711907,8670,711907,711907,720556,709473,11083,709473
13888,26736,26739,26019,720,26019,26019,26736,25810,926,25810
13889,5690,4829,5060,-231,4829,4829,4828,4819,9,4819
13890,45788,39532,37495,2037,37495,37495,39530,37290,2240,37290
13891,9880,9356,9416,-60,9356,9356,9356,9258,98,9258
13892,19055,18557,17928,629,17928,17928,18557,17769,788,17769
13893,2263,1346,1540,-194,1346,1346,1347,1386,-39,1386
13894,17480,17716,17477,239,17477,17477,17718,17322,396,17322
13895,69517,68454,64929,3525,64929,64929,68427,64845,3582,64845
13896,13572,13526,13045,481,13045,13045,13533,12679,854,12679
13897,28018,29583,28010,1573,28010,28010,29591,27396,2195,27396
13898,83755,83650,80666,2984,80666,80666,83651,80449,3202,80449
13899,24085,24007,23138,869,23138,23138,24024,23053,971,23053
13900,121779,125091,121692,3399,121692,121692,125127,120993,4134,120993
13901,3569,3552,3721,-169,3552,3552,3553,3588,-35,3569
13902,10619,10623,10656,-33,10623,10619,10619,10320,299,10320
13903,14593,11526,11102,424,11102,11102,11527,10880,647,10880
13904,203045,185948,178170,7778,178170,178170,186053,171491,14562,171491
13905,5406,4889,5082,-193,4889,4889,4890,4784,106,4784
13906,45931,34151,34941,-790,34151,34151,34159,31477,2682,31477
13907,16100,16080,16015,65,16015,16015,16084,15792,292,15792
13908,31783,14578,14238,340,14238,14238,14576,13820,756,13820
13909,15740,15734,15951,-217,15734,15734,15740,15721,19,15721
13910,48938,22148,21852,296,21852,21852,22144,21546,598,21546
13911,4466,4406,4643,-237,4406,4406,4405,4450,-45,4450
13912,37222,37251,36587,664,36587,36587,37222,36269,953,36269
13913,17622,16799,15972,827,15972,15972,16811,15657,1154,15657
13914,8463,8065,8088,-23,8065,8065,8062,7909,153,7909
13915,18909,19668,18848,820,18848,18848,19674,18722,952,18722
13916,13904,13749,13795,-46,13749,13749,13744,13282,462,13282
13917,30909,30787,30490,297,30490,30490,30799,30268,531,30268
13918,37236,38266,37407,859,37407,37236,38273,37189,1084,37189
13919,6898,6728,6848,-120,6728,6728,6726,6698,28,6698
13920,9777,9181,9138,43,9138,9138,9180,9065,115,9065
13921,81692,81655,78452,3203,78452,78452,81665,78239,3426,78239
13922,84113,87497,86799,698,86799,84113,87509,84113,3396,84113
13923,87965,87925,87207,718,87207,87207,87965,85947,2018,85947
13924,44983,44218,43287,931,43287,43287,44216,42973,1243,42973
13925,19626,20297,19565,732,19565,19565,20302,19359,943,19359
13926,427,408,658,-250,408,408,408,466,-58,427
13927,282373,249146,238386,10760,238386,238386,249224,235551,13673,235551
13928,28600,26362,25439,923,25439,25439,26372,25265,1107,25265
13929,139647,132900,126222,6678,126222,126222,132887,125189,7698,125189
13930,1959,1041,1263,-222,1041,1041,1041,1098,-57,1098
13931,2187,1240,1452,-212,1240,1240,1239,1296,-57,1296
13932,88862,85253,84402,851,84402,84402,85254,82532,2722,82532
13933,121242,125830,121630,4200,121630,121242,125878,121242,4636,121242
13934,13921,13925,13910,15,13910,13910,13931,13485,446,13485
13935,18516,17839,17980,-141,17839,17839,17830,17531,299,17531
13936,162397,162211,153433,8778,153433,153433,162244,151850,10394,151850
13937,8081,7689,7616,73,7616,7616,7693,7465,228,7465
13938,952,284,520,-236,284,284,284,330,-46,330
13939,45952,44225,43943,282,43943,43943,44219,43171,1048,43171
13940,77120,77086,73531,3555,73531,73531,77120,72998,4122,72998
13941,40271,40762,41393,-631,40762,40271,40779,40389,390,40271
13942,8072,7556,7745,-189,7556,7556,7553,7394,159,7394
13943,58962,54888,52747,2141,52747,52747,54909,52106,2803,52106
13944,25673,24800,23894,906,23894,23894,24799,23831,968,23831
13945,190499,191801,204400,-12599,191801,190499,191813,190491,1322,190491
13946,72710,71496,72632,-1136,71496,71496,71536,70098,1438,70098
13947,22639,21907,21062,845,21062,21062,21905,21023,882,21023
13948,72845,76668,72827,3841,72827,72827,76681,72521,4160,72521
13949,15816,14152,14093,59,14093,14093,14150,14027,123,14027
13950,28641,26414,26441,-27,26414,26414,26417,25796,621,25796
13951,302057,302304,302070,234,302070,302057,302478,298270,4208,298270
13952,27763,27754,26567,1187,26567,26567,27763,25473,2290,25473
13953,13285,13097,12702,395,12702,12702,13097,12587,510,12587
13954,3342,2498,2708,-210,2498,2498,2499,2528,-29,2528
13955,2436,2074,2278,-204,2074,2074,2073,2136,-63,2136
13956,75576,62011,60623,1388,60623,60623,61981,59944,2037,59944
13957,126844,126248,122955,3293,122955,122955,126290,122385,3905,122385
13958,62266,60652,57909,2743,57909,57909,60651,57580,3071,57580
13959,561,560,801,-241,560,560,561,604,-43,561
13960,15738,15830,15960,-130,15830,15738,15828,15736,92,15736
13961,80731,79736,79022,714,79022,79022,79769,77872,1897,77872
13962,365997,365763,353260,12503,353260,353260,365997,349763,16234,349763
13963,97179,97168,94595,2573,94595,94595,97171,92957,4214,92957
13964,48934,50865,49094,1771,49094,48934,50858,49014,1844,48934
13965,69418,64737,61802,2935,61802,61802,64738,61176,3562,61176
13966,89281,88198,85209,2989,85209,85209,88208,84923,3285,84923
13967,13316,12845,12670,175,12670,12670,12843,12537,306,12537
13968,30753,30438,29866,572,29866,29866,30452,29557,895,29557
13969,62528,61974,60237,1737,60237,60237,61974,59976,1998,59976
13970,117277,120175,122688,-2513,120175,117277,120203,117269,2934,117269
13971,20397,19593,19171,422,19171,19171,19593,19125,468,19125
13972,55923,57431,56528,903,56528,55923,57452,56129,1323,55923
13973,25233,12611,12474,137,12474,12474,12616,12222,394,12222
13974,3842,3290,3516,-226,3290,3290,3288,3263,25,3263
13975,250958,215445,215498,-53,215445,215445,215481,208788,6693,208788
13976,15375,14570,14582,-12,14570,14570,14569,14322,247,14322
13977,8342,8337,8646,-309,8337,8337,8342,8395,-53,8342
13978,16147,15632,15118,514,15118,15118,15645,14941,704,14941
13979,17144,17094,17299,-205,17094,17094,17095,16892,203,16892
13980,60405,60363,59323,1040,59323,59323,60402,57035,3367,57035
13981,32819,32251,32129,122,32129,32129,32241,31714,527,31714
13982,15138,14584,14538,46,14538,14538,14584,14357,227,14357
13983,3290,3266,3464,-198,3266,3266,3270,3225,45,3225
13984,30606,31381,30598,783,30598,30598,31381,29744,1637,29744
13985,137499,115359,109215,6144,109215,109215,115371,108467,6904,108467
13986,819568,797716,769034,28682,769034,769034,797761,762508,35253,762508
13987,38589,36290,34595,1695,34595,34595,36306,34114,2192,34114
13988,11114,11088,11312,-224,11088,11088,11087,11001,86,11001
13989,11827,11795,11723,72,11723,11723,11794,11591,203,11591
13990,7100,7145,7096,49,7096,7096,7144,6979,165,6979
13991,6916,6921,7043,-122,6921,6916,6916,6637,279,6637
13992,8975,9053,8911,142,8911,8911,9056,8750,306,8750
13993,3149,3167,3311,-144,3167,3149,3167,3166,1,3149
13994,38288,36962,35068,1894,35068,35068,36965,34800,2165,34800
13995,37266,37264,36515,749,36515,36515,37266,34976,2290,34976
13996,19718,7208,7107,101,7107,7107,7209,6780,429,6780
13997,25227,26299,25169,1130,25169,25169,26296,25016,1280,25016
13998,184163,191031,184363,6668,184363,184163,191005,184163,6842,184163
13999,6180,5886,6178,-292,5886,5886,5897,5843,54,5843
14000,23085,23069,22645,424,22645,22645,23083,21972,1111,21972
14001,34964,34915,33144,1771,33144,33144,34903,33072,1831,33072
14002,12092,13316,13178,138,13178,12092,13315,12084,1231,12084
14003,33897,33897,33951,-54,33897,33897,33897,33490,407,33490
14004,17338,16366,16276,90,16276,16276,16365,15894,471,15894
14005,103808,105689,104770,919,104770,103808,105707,103800,1907,103800
14006,3691,3221,3691,-470,3221,3221,3221,3597,-376,3597
14007,10538,10461,10309,152,10309,10309,10452,10172,280,10172
14008,17396,17776,17329,447,17329,17329,17790,17115,675,17115
14009,4526,5277,4981,296,4981,4526,5277,4511,766,4511
14010,197423,196505,194486,2019,194486,194486,196519,191661,4858,191661
14011,26319,26332,25758,574,25758,25758,26337,25528,809,25528
14012,2035,1117,1354,-237,1117,1117,1116,1177,-61,1177
14013,546820,546949,517253,29696,517253,517253,546820,511715,35105,511715
14014,18326,17473,17129,344,17129,17129,17481,15595,1886,15595
14015,73227,70087,65460,4627,65460,65460,70070,65166,4904,65166
14016,35162,30296,28862,1434,28862,28862,30301,28517,1784,28517
14017,2187,1270,1473,-203,1270,1270,1270,1321,-51,1321
14018,13311,13797,13303,494,13303,13303,13803,13076,727,13076
14019,33666,35329,34110,1219,34110,33666,35349,33743,1606,33666
14020,2150,2110,2290,-180,2110,2110,2111,2133,-22,2133
14021,17415,17198,17132,66,17132,17132,17204,16793,411,16793
14022,6189,6652,7017,-365,6652,6189,6648,6181,467,6181
14023,52956,51970,51235,735,51235,51235,51972,50422,1550,50422
14024,31497,31456,30301,1155,30301,30301,31468,23358,8110,23358
14025,20392,8911,8825,86,8825,8825,8909,8464,445,8464
14026,1021,686,899,-213,686,686,686,730,-44,730
14027,109987,109942,109850,92,109850,109850,109987,107936,2051,107936
14028,30960,27422,26743,679,26743,26743,27427,26548,879,26548
14029,3098,2717,2912,-195,2717,2717,2717,2764,-47,2764
14030,21961,19881,18813,1068,18813,18813,19886,18216,1670,18216
14031,901,516,763,-247,516,516,516,566,-50,566
14032,45526,48083,46206,1877,46206,45526,48111,44904,3207,44904
14033,65091,64108,62016,2092,62016,62016,64115,61477,2638,61477
14034,45962,45275,43141,2134,43141,43141,45272,42222,3050,42222
14035,109586,108671,110109,-1438,108671,108671,108693,107906,787,107906
14036,4942,4386,4605,-219,4386,4386,4393,4366,27,4366
14037,185699,203126,185638,17488,185638,185638,203232,184335,18897,184335
14038,26277,24645,23422,1223,23422,23422,24653,23005,1648,23005
14039,38086,35946,34683,1263,34683,34683,35949,34531,1418,34531
14040,21008,21019,19640,1379,19640,19640,21019,18601,2418,18601
14041,85917,78218,73245,4973,73245,73245,78257,71850,6407,71850
14042,137443,111979,110508,1471,110508,110508,112001,109343,2658,109343
14043,51476,51419,49740,1679,49740,49740,51476,49285,2191,49285
14044,12061,11785,11813,-28,11785,11785,11789,11279,510,11279
14045,7307,7286,7379,-93,7286,7286,7293,7143,150,7143
14046,3143,2721,2903,-182,2721,2721,2719,2746,-27,2746
14047,8885,8975,8887,88,8887,8885,8981,8651,330,8651
14048,18373,18394,17469,925,17469,17469,18391,16911,1480,16911
14049,26177,24346,23306,1040,23306,23306,24352,22986,1366,22986
14050,61712,60821,58789,2032,58789,58789,60816,58180,2636,58180
14051,240534,222124,217335,4789,217335,217335,222154,214337,7817,214337
14052,64017,38692,37248,1444,37248,37248,38685,33761,4924,33761
14053,53169,52228,50538,1690,50538,50538,52231,50192,2039,50192
14054,29324,29313,28573,740,28573,28573,29317,28048,1269,28048
14055,67762,60016,56167,3849,56167,56167,60023,52468,7555,52468
14056,50288,29256,28473,783,28473,28473,29261,28343,918,28343
14057,149102,153680,149066,4614,149066,149066,153746,147954,5792,147954
14058,11007,288,523,-235,288,288,288,332,-44,332
14059,129309,127052,122685,4367,122685,122685,127064,121466,5598,121466
14060,2488,2485,2698,-213,2485,2485,2488,2467,21,2467
14061,24269,24923,23576,1347,23576,23576,24919,23261,1658,23261
14062,32823,34535,32818,1717,32818,32818,34528,32413,2115,32413
14063,10976,10074,10022,52,10022,10022,10076,9860,216,9860
14064,19461,17618,16740,878,16740,16740,17630,16177,1453,16177
14065,5341,4887,4889,-2,4887,4887,4885,4781,104,4781
14066,148146,147084,145719,1365,145719,145719,147121,144329,2792,144329
14067,435420,359950,343756,16194,343756,343756,359967,340825,19142,340825
14068,33392,32527,32316,211,32316,32316,32538,31885,653,31885
14069,136991,139523,137675,1848,137675,136991,139579,136935,2644,136935
14070,14881,14033,14024,9,14024,14024,14038,13795,243,13795
14071,6356,6357,6504,-147,6357,6356,6356,6215,141,6215
14072,10283,1490,1679,-189,1490,1490,1491,1523,-32,1523
14073,19865,18597,18099,498,18099,18099,18602,17925,677,17925
14074,15291,15556,15292,264,15292,15291,15559,14998,561,14998
14075,46118,46058,45264,794,45264,45264,46066,44553,1513,44553
14076,32507,29499,28640,859,28640,28640,29499,27977,1522,27977
14077,35850,35761,34757,1004,34757,34757,35766,34586,1180,34586
14078,19963,19960,19223,737,19223,19223,19963,18436,1527,18436
14079,315189,314658,306596,8062,306596,306596,314647,288680,25967,288680
14080,3645,3088,3291,-203,3088,3088,3091,3013,78,3013
14081,58241,54115,52446,1669,52446,52446,54109,51844,2265,51844
14082,24545,25171,24544,627,24544,24544,25183,24415,768,24415
14083,15009,14250,14087,163,14087,14087,14255,13838,417,13838
14084,8278,8342,8274,68,8274,8274,8341,8111,230,8111
14085,517906,516977,490182,26795,490182,490182,516832,484245,32587,484245
14086,4119,3576,3648,-72,3576,3576,3577,3407,170,3407
14087,30089,21966,21045,921,21045,21045,21971,20765,1206,20765
14088,8906,8488,8494,-6,8488,8488,8496,8310,186,8310
14089,75503,46511,45154,1357,45154,45154,46477,45016,1461,45016
14090,20996,21848,20831,1017,20831,20831,21847,20614,1233,20614
14091,6372,5529,5590,-61,5529,5529,5535,5285,250,5285
14092,31589,32593,31573,1020,31573,31573,32574,31103,1471,31103
14093,18287,18470,18285,185,18285,18285,18466,18069,397,18069
14094,5398,5377,5501,-124,5377,5377,5377,5358,19,5358
14095,47348,48132,48306,-174,48132,47348,48144,47340,804,47340
14096,54476,54993,54459,534,54459,54459,54971,52657,2314,52657
14097,194005,193029,184368,8661,184368,184368,193018,180175,12843,180175
14098,6716,6231,6294,-63,6231,6231,6227,6060,167,6060
14099,32433,31844,30844,1000,30844,30844,31852,30636,1216,30636
14100,32433,31844,30844,1000,30844,30844,31852,30636,1216,30636
14101,21980,18238,18461,-223,18238,18238,18243,17935,308,17935
14102,25191,3218,3460,-242,3218,3218,3218,1801,1417,1801
14103,115927,117482,115916,1566,115916,115916,117502,114509,2993,114509
14104,1999,1949,2168,-219,1949,1949,1951,1957,-6,1957
14105,5380,5356,5630,-274,5356,5356,5356,3646,1710,3646
14106,182919,191813,185261,6552,185261,182919,191842,182907,8935,182907
14107,4056,3516,3720,-204,3516,3516,3517,3434,83,3434
14108,56074,53094,52344,750,52344,52344,53091,51260,1831,51260
14109,225911,225929,212301,13628,212301,212301,225911,211997,13914,211997
14110,157514,156616,151512,5104,151512,151512,156621,149750,6871,149750
14111,18924,18013,18378,-365,18013,18013,18026,18007,19,18007
14112,22487,22486,21594,892,21594,21594,22487,21517,970,21517
14113,31916,28436,27260,1176,27260,27260,28450,26579,1871,26579
14114,59782,41462,40771,691,40771,40771,41481,40450,1031,40450
14115,23264,23663,23774,-111,23663,23264,23664,23264,400,23264
14116,22974,22955,22244,711,22244,22244,22975,21704,1271,21704
14117,670995,670765,639938,30827,639938,639938,670737,636050,34687,636050
14118,8161,8165,8182,-17,8165,8161,8161,7879,282,7879
14119,17650,16552,16560,-8,16552,16552,16554,16029,525,16029
14120,11669,10822,10961,-139,10822,10822,10827,10755,72,10755
14121,117355,83233,79779,3454,79779,79779,83197,78313,4884,78313
14122,87891,92412,88490,3922,88490,87891,92455,87862,4593,87862
14123,7982,7572,7468,104,7468,7468,7564,7363,201,7363
14124,30524,29916,28824,1092,28824,28824,29901,28753,1148,28753
14125,17973,16739,16690,49,16690,16690,16738,16109,629,16109
